dep;jour;n_dose1;n_complet;n_cum_dose1;n_cum_complet;couv_dose1;couv_complet
01;2020-12-27;1;0;1;0;0.0;0.0
01;2020-12-28;0;0;1;0;0.0;0.0
01;2020-12-29;0;0;1;0;0.0;0.0
01;2020-12-30;0;0;1;0;0.0;0.0
01;2020-12-31;0;0;1;0;0.0;0.0
01;2021-01-01;2;0;3;0;0.0;0.0
01;2021-01-02;0;0;3;0;0.0;0.0
01;2021-01-03;0;0;3;0;0.0;0.0
01;2021-01-04;2;0;5;0;0.0;0.0
01;2021-01-05;2;0;7;0;0.0;0.0
01;2021-01-06;1;0;8;0;0.0;0.0
01;2021-01-07;67;0;75;0;0.0;0.0
01;2021-01-08;159;0;234;0;0.0;0.0
01;2021-01-09;2;1;236;1;0.0;0.0
01;2021-01-10;1;0;237;1;0.0;0.0
01;2021-01-11;148;0;385;1;0.1;0.0
01;2021-01-12;318;2;703;3;0.1;0.0
01;2021-01-13;445;1;1148;4;0.2;0.0
01;2021-01-14;530;3;1678;7;0.3;0.0
01;2021-01-15;398;3;2076;10;0.3;0.0
01;2021-01-16;202;0;2278;10;0.3;0.0
01;2021-01-17;128;0;2406;10;0.4;0.0
01;2021-01-18;379;1;2785;11;0.4;0.0
01;2021-01-19;1041;1;3826;12;0.6;0.0
01;2021-01-20;1262;2;5088;14;0.8;0.0
01;2021-01-21;1101;4;6189;18;0.9;0.0
01;2021-01-22;649;0;6838;18;1.0;0.0
01;2021-01-23;223;0;7061;18;1.1;0.0
01;2021-01-24;70;1;7131;19;1.1;0.0
01;2021-01-25;485;1;7616;20;1.2;0.0
01;2021-01-26;743;3;8359;23;1.3;0.0
01;2021-01-27;516;3;8875;26;1.4;0.0
01;2021-01-28;681;51;9556;77;1.5;0.0
01;2021-01-29;640;98;10196;175;1.6;0.0
01;2021-01-30;237;15;10433;190;1.6;0.0
01;2021-01-31;62;0;10495;190;1.6;0.0
01;2021-02-01;459;70;10954;260;1.7;0.0
01;2021-02-02;519;171;11473;431;1.7;0.1
01;2021-02-03;376;232;11849;663;1.8;0.1
01;2021-02-04;480;372;12329;1035;1.9;0.2
01;2021-02-05;441;237;12770;1272;1.9;0.2
01;2021-02-06;264;105;13034;1377;2.0;0.2
01;2021-02-07;2;93;13036;1470;2.0;0.2
01;2021-02-08;506;325;13542;1795;2.1;0.3
01;2021-02-09;776;733;14318;2528;2.2;0.4
01;2021-02-10;957;622;15275;3150;2.3;0.5
01;2021-02-11;795;685;16070;3835;2.4;0.6
01;2021-02-12;640;481;16710;4316;2.5;0.7
01;2021-02-13;161;99;16871;4415;2.6;0.7
01;2021-02-14;0;9;16871;4424;2.6;0.7
01;2021-02-15;437;377;17308;4801;2.6;0.7
01;2021-02-16;658;340;17966;5141;2.7;0.8
01;2021-02-17;524;228;18490;5369;2.8;0.8
01;2021-02-18;592;498;19082;5867;2.9;0.9
01;2021-02-19;580;203;19662;6070;3.0;0.9
01;2021-02-20;201;124;19863;6194;3.0;0.9
01;2021-02-21;1;1;19864;6195;3.0;0.9
01;2021-02-22;429;448;20293;6643;3.1;1.0
01;2021-02-23;483;421;20776;7064;3.2;1.1
01;2021-02-24;434;367;21210;7431;3.2;1.1
01;2021-02-25;827;514;22037;7945;3.4;1.2
01;2021-02-26;873;435;22910;8380;3.5;1.3
01;2021-02-27;480;102;23390;8482;3.6;1.3
01;2021-02-28;20;3;23410;8485;3.6;1.3
01;2021-03-01;633;382;24043;8867;3.7;1.3
01;2021-03-02;964;479;25007;9346;3.8;1.4
01;2021-03-03;942;596;25949;9942;3.9;1.5
01;2021-03-04;1198;554;27147;10496;4.1;1.6
01;2021-03-05;1356;436;28503;10932;4.3;1.7
01;2021-03-06;781;91;29284;11023;4.5;1.7
01;2021-03-07;44;1;29328;11024;4.5;1.7
01;2021-03-08;669;571;29997;11595;4.6;1.8
01;2021-03-09;1340;537;31337;12132;4.8;1.8
01;2021-03-10;1163;537;32500;12669;4.9;1.9
01;2021-03-11;1686;603;34186;13272;5.2;2.0
01;2021-03-12;2006;605;36192;13877;5.5;2.1
01;2021-03-13;1502;95;37694;13972;5.7;2.1
01;2021-03-14;134;59;37828;14031;5.8;2.1
01;2021-03-15;1154;393;38982;14424;5.9;2.2
01;2021-03-16;1012;549;39994;14973;6.1;2.3
01;2021-03-17;839;337;40833;15310;6.2;2.3
01;2021-03-18;1295;463;42128;15773;6.4;2.4
01;2021-03-19;1750;529;43878;16302;6.7;2.5
01;2021-03-20;1447;133;45325;16435;6.9;2.5
01;2021-03-21;97;11;45422;16446;6.9;2.5
01;2021-03-22;1576;486;46998;16932;7.2;2.6
01;2021-03-23;2197;643;49195;17575;7.5;2.7
01;2021-03-24;1616;417;50811;17992;7.7;2.7
01;2021-03-25;2910;634;53721;18626;8.2;2.8
01;2021-03-26;2871;613;56592;19239;8.6;2.9
01;2021-03-27;1311;158;57903;19397;8.8;3.0
01;2021-03-28;22;1;57925;19398;8.8;3.0
01;2021-03-29;1930;537;59855;19935;9.1;3.0
01;2021-03-30;2514;770;62369;20705;9.5;3.2
01;2021-03-31;1869;623;64238;21328;9.8;3.2
01;2021-04-01;2569;851;66807;22179;10.2;3.4
01;2021-04-02;2818;724;69625;22903;10.6;3.5
01;2021-04-03;1256;135;70881;23038;10.8;3.5
01;2021-04-04;3;0;70884;23038;10.8;3.5
01;2021-04-05;1261;65;72145;23103;11.0;3.5
01;2021-04-06;2824;794;74969;23897;11.4;3.6
01;2021-04-07;2741;707;77710;24604;11.8;3.7
01;2021-04-08;3245;997;80955;25601;12.3;3.9
01;2021-04-09;3983;1332;84938;26933;12.9;4.1
01;2021-04-10;1823;301;86761;27234;13.2;4.1
01;2021-04-11;44;22;86805;27256;13.2;4.1
01;2021-04-12;2716;1223;89521;28479;13.6;4.3
01;2021-04-13;2944;1325;92465;29804;14.1;4.5
01;2021-04-14;3126;1082;95591;30886;14.6;4.7
01;2021-04-15;3075;1475;98666;32361;15.0;4.9
01;2021-04-16;2861;1577;101527;33938;15.5;5.2
01;2021-04-17;1654;681;103181;34619;15.7;5.3
01;2021-04-18;13;0;103194;34619;15.7;5.3
01;2021-04-19;2039;1521;105233;36140;16.0;5.5
01;2021-04-20;2667;1571;107900;37711;16.4;5.7
01;2021-04-21;2689;1349;110589;39060;16.8;5.9
01;2021-04-22;2835;1530;113424;40590;17.3;6.2
01;2021-04-23;2765;1532;116189;42122;17.7;6.4
01;2021-04-24;1448;653;117637;42775;17.9;6.5
01;2021-04-25;9;0;117646;42775;17.9;6.5
01;2021-04-26;1970;1730;119616;44505;18.2;6.8
01;2021-04-27;2572;1553;122188;46058;18.6;7.0
01;2021-04-28;2500;1568;124688;47626;19.0;7.2
01;2021-04-29;2716;1758;127404;49384;19.4;7.5
01;2021-04-30;2982;2242;130386;51626;19.8;7.9
01;2021-05-01;1473;856;131859;52482;20.1;8.0
01;2021-05-02;545;76;132404;52558;20.2;8.0
01;2021-05-03;2295;2477;134699;55035;20.5;8.4
01;2021-05-04;2539;2635;137238;57670;20.9;8.8
01;2021-05-05;2527;2496;139765;60166;21.3;9.2
01;2021-05-06;2994;2525;142759;62691;21.7;9.5
01;2021-05-07;3216;2774;145975;65465;22.2;10.0
01;2021-05-08;1645;922;147620;66387;22.5;10.1
01;2021-05-09;1022;162;148642;66549;22.6;10.1
01;2021-05-10;2499;3067;151141;69616;23.0;10.6
01;2021-05-11;3580;3053;154721;72669;23.6;11.1
01;2021-05-12;3652;3002;158373;75671;24.1;11.5
01;2021-05-13;4088;1503;162461;77174;24.7;11.7
01;2021-05-14;4271;2344;166732;79518;25.4;12.1
01;2021-05-15;3159;1435;169891;80953;25.9;12.3
01;2021-05-16;1413;150;171304;81103;26.1;12.3
01;2021-05-17;3445;2469;174749;83572;26.6;12.7
01;2021-05-18;4075;1959;178824;85531;27.2;13.0
01;2021-05-19;3974;1900;182798;87431;27.8;13.3
01;2021-05-20;4526;2010;187324;89441;28.5;13.6
01;2021-05-21;4621;2194;191945;91635;29.2;13.9
01;2021-05-22;3368;953;195313;92588;29.7;14.1
01;2021-05-23;834;83;196147;92671;29.9;14.1
01;2021-05-24;2765;500;198912;93171;30.3;14.2
01;2021-05-25;3559;2428;202471;95599;30.8;14.6
01;2021-05-26;3570;2249;206041;97848;31.4;14.9
01;2021-05-27;3853;2093;209894;99941;31.9;15.2
01;2021-05-28;3664;2631;213558;102572;32.5;15.6
01;2021-05-29;3054;1297;216612;103869;33.0;15.8
01;2021-05-30;613;88;217225;103957;33.1;15.8
01;2021-05-31;2406;2516;219631;106473;33.4;16.2
01;2021-06-01;2771;2583;222402;109056;33.9;16.6
01;2021-06-02;2883;2200;225285;111256;34.3;16.9
01;2021-06-03;3365;2440;228650;113696;34.8;17.3
01;2021-06-04;4500;3368;233150;117064;35.5;17.8
01;2021-06-05;3252;1733;236402;118797;36.0;18.1
01;2021-06-06;670;78;237072;118875;36.1;18.1
01;2021-06-07;3388;2875;240460;121750;36.6;18.5
01;2021-06-08;3649;2718;244109;124468;37.2;18.9
01;2021-06-09;2948;2635;247057;127103;37.6;19.3
01;2021-06-10;2767;2037;249824;129140;38.0;19.7
01;2021-06-11;3072;3365;252896;132505;38.5;20.2
01;2021-06-12;2401;2195;255297;134700;38.9;20.5
01;2021-06-13;201;479;255498;135179;38.9;20.6
01;2021-06-14;2119;3162;257617;138341;39.2;21.1
01;2021-06-15;2004;3367;259621;141708;39.5;21.6
01;2021-06-16;2176;3287;261797;144995;39.9;22.1
01;2021-06-17;1959;3171;263756;148166;40.1;22.6
01;2021-06-18;2634;4159;266390;152325;40.5;23.2
01;2021-06-19;1727;2555;268117;154880;40.8;23.6
01;2021-06-20;159;498;268276;155378;40.8;23.7
01;2021-06-21;1798;3703;270074;159081;41.1;24.2
01;2021-06-22;1551;4001;271625;163082;41.3;24.8
01;2021-06-23;1583;3754;273208;166836;41.6;25.4
01;2021-06-24;1471;3564;274679;170400;41.8;25.9
01;2021-06-25;1889;4564;276568;174964;42.1;26.6
01;2021-06-26;1209;2946;277777;177910;42.3;27.1
01;2021-06-27;171;339;277948;178249;42.3;27.1
01;2021-06-28;1382;4024;279330;182273;42.5;27.7
01;2021-06-29;1409;3849;280739;186122;42.7;28.3
01;2021-06-30;1381;4157;282120;190279;42.9;29.0
01;2021-07-01;1430;4086;283550;194365;43.2;29.6
01;2021-07-02;1587;4985;285137;199350;43.4;30.3
01;2021-07-03;858;3373;285995;202723;43.5;30.9
01;2021-07-04;105;499;286100;203222;43.5;30.9
01;2021-07-05;1486;4082;287586;207304;43.8;31.6
01;2021-07-06;1105;4275;288691;211579;43.9;32.2
01;2021-07-07;1757;3696;290448;215275;44.2;32.8
01;2021-07-08;1474;3676;291922;218951;44.4;33.3
01;2021-07-09;1885;4364;293807;223315;44.7;34.0
01;2021-07-10;1119;3438;294926;226753;44.9;34.5
01;2021-07-11;104;418;295030;227171;44.9;34.6
01;2021-07-12;1421;3843;296451;231014;45.1;35.2
01;2021-07-13;2058;4116;298509;235130;45.4;35.8
01;2021-07-14;148;179;298657;235309;45.5;35.8
01;2021-07-15;3104;4189;301761;239498;45.9;36.5
01;2021-07-16;3745;4838;305506;244336;46.5;37.2
01;2021-07-17;2202;3044;307708;247380;46.8;37.7
01;2021-07-18;290;551;307998;247931;46.9;37.7
01;2021-07-19;2915;3869;310913;251800;47.3;38.3
01;2021-07-20;3297;3691;314210;255491;47.8;38.9
01;2021-07-21;3935;3566;318145;259057;48.4;39.4
01;2021-07-22;4218;3493;322363;262550;49.1;40.0
01;2021-07-23;3940;4221;326303;266771;49.7;40.6
01;2021-07-24;2731;2712;329034;269483;50.1;41.0
01;2021-07-25;61;60;329095;269543;50.1;41.0
01;2021-07-26;3346;3240;332441;272783;50.6;41.5
01;2021-07-27;4102;2787;336543;275570;51.2;41.9
01;2021-07-28;3990;2651;340533;278221;51.8;42.4
01;2021-07-29;4696;2437;345229;280658;52.5;42.7
01;2021-07-30;4457;3429;349686;284087;53.2;43.2
01;2021-07-31;3641;1773;353327;285860;53.8;43.5
01;2021-08-01;397;75;353724;285935;53.8;43.5
01;2021-08-02;3078;2455;356802;288390;54.3;43.9
01;2021-08-03;3069;2453;359871;290843;54.8;44.3
01;2021-08-04;2542;1736;362413;292579;55.2;44.5
01;2021-08-05;2246;2363;364659;294942;55.5;44.9
01;2021-08-06;2748;3112;367407;298054;55.9;45.4
01;2021-08-07;2071;1837;369478;299891;56.2;45.6
01;2021-08-08;248;258;369726;300149;56.3;45.7
01;2021-08-09;1136;2633;370862;302782;56.5;46.1
01;2021-08-10;1445;2411;372307;305193;56.7;46.5
01;2021-08-11;1472;2596;373779;307789;56.9;46.9
01;2021-08-12;1626;2824;375405;310613;57.1;47.3
01;2021-08-13;1814;2728;377219;313341;57.4;47.7
01;2021-08-14;1392;2233;378611;315574;57.6;48.0
01;2021-08-15;18;21;378629;315595;57.6;48.0
01;2021-08-16;982;3011;379611;318606;57.8;48.5
01;2021-08-17;1355;2761;380966;321367;58.0;48.9
01;2021-08-18;1257;2907;382223;324274;58.2;49.4
01;2021-08-19;1300;2425;383523;326699;58.4;49.7
01;2021-08-20;1458;3951;384981;330650;58.6;50.3
01;2021-08-21;883;2848;385864;333498;58.7;50.8
01;2021-08-22;19;20;385883;333518;58.7;50.8
01;2021-08-23;1116;3018;386999;336536;58.9;51.2
01;2021-08-24;1228;3153;388227;339689;59.1;51.7
01;2021-08-25;1124;2992;389351;342681;59.3;52.2
01;2021-08-26;1647;2736;390998;345417;59.5;52.6
01;2021-08-27;1641;3652;392639;349069;59.8;53.1
01;2021-08-28;1044;2590;393683;351659;59.9;53.5
01;2021-08-29;16;31;393699;351690;59.9;53.5
01;2021-08-30;1187;2737;394886;354427;60.1;53.9
01;2021-08-31;1089;1946;395975;356373;60.3;54.2
01;2021-09-01;916;1871;396891;358244;60.4;54.5
01;2021-09-02;804;1763;397695;360007;60.5;54.8
01;2021-09-03;1130;2404;398825;362411;60.7;55.2
01;2021-09-04;796;2004;399621;364415;60.8;55.5
01;2021-09-05;97;82;399718;364497;60.8;55.5
01;2021-09-06;650;1399;400368;365896;60.9;55.7
01;2021-09-07;577;1204;400945;367100;61.0;55.9
01;2021-09-08;815;1582;401760;368682;61.2;56.1
01;2021-09-09;764;1282;402524;369964;61.3;56.3
01;2021-09-10;1044;1821;403568;371785;61.4;56.6
01;2021-09-11;736;1496;404304;373281;61.5;56.8
01;2021-09-12;23;41;404327;373322;61.5;56.8
01;2021-09-13;573;1343;404900;374665;61.6;57.0
01;2021-09-14;617;1412;405517;376077;61.7;57.2
01;2021-09-15;719;1443;406236;377520;61.8;57.5
01;2021-09-16;489;921;406725;378441;61.9;57.6
01;2021-09-17;755;1389;407480;379830;62.0;57.8
01;2021-09-18;376;1205;407856;381035;62.1;58.0
01;2021-09-19;7;10;407863;381045;62.1;58.0
01;2021-09-20;372;633;408235;381678;62.1;58.1
01;2021-09-21;384;701;408619;382379;62.2;58.2
01;2021-09-22;347;899;408966;383278;62.3;58.3
01;2021-09-23;295;658;409261;383936;62.3;58.4
01;2021-09-24;402;943;409663;384879;62.4;58.6
01;2021-09-25;307;955;409970;385834;62.4;58.7
01;2021-09-26;2;24;409972;385858;62.4;58.7
01;2021-09-27;174;556;410146;386414;62.4;58.8
01;2021-09-28;310;1194;410456;387608;62.5;59.0
01;2021-09-29;464;1281;410920;388889;62.5;59.2
01;2021-09-30;342;828;411262;389717;62.6;59.3
01;2021-10-01;462;1074;411724;390791;62.7;59.5
01;2021-10-02;395;1302;412119;392093;62.7;59.7
01;2021-10-03;0;0;412119;392093;62.7;59.7
02;2020-12-27;0;0;0;0;0.0;0.0
02;2020-12-28;0;0;0;0;0.0;0.0
02;2020-12-29;0;0;0;0;0.0;0.0
02;2020-12-30;0;0;0;0;0.0;0.0
02;2020-12-31;0;0;0;0;0.0;0.0
02;2021-01-01;0;0;0;0;0.0;0.0
02;2021-01-02;0;0;0;0;0.0;0.0
02;2021-01-03;0;0;0;0;0.0;0.0
02;2021-01-04;0;0;0;0;0.0;0.0
02;2021-01-05;0;0;0;0;0.0;0.0
02;2021-01-06;22;0;22;0;0.0;0.0
02;2021-01-07;261;1;283;1;0.1;0.0
02;2021-01-08;489;3;772;4;0.1;0.0
02;2021-01-09;74;0;846;4;0.2;0.0
02;2021-01-10;49;0;895;4;0.2;0.0
02;2021-01-11;267;0;1162;4;0.2;0.0
02;2021-01-12;354;1;1516;5;0.3;0.0
02;2021-01-13;469;4;1985;9;0.4;0.0
02;2021-01-14;652;11;2637;20;0.5;0.0
02;2021-01-15;630;6;3267;26;0.6;0.0
02;2021-01-16;333;4;3600;30;0.7;0.0
02;2021-01-17;62;0;3662;30;0.7;0.0
02;2021-01-18;811;8;4473;38;0.9;0.0
02;2021-01-19;941;6;5414;44;1.0;0.0
02;2021-01-20;1431;5;6845;49;1.3;0.0
02;2021-01-21;2604;5;9449;54;1.8;0.0
02;2021-01-22;1420;5;10869;59;2.1;0.0
02;2021-01-23;290;1;11159;60;2.1;0.0
02;2021-01-24;67;0;11226;60;2.1;0.0
02;2021-01-25;432;8;11658;68;2.2;0.0
02;2021-01-26;704;15;12362;83;2.3;0.0
02;2021-01-27;162;2;12524;85;2.4;0.0
02;2021-01-28;69;226;12593;311;2.4;0.1
02;2021-01-29;119;376;12712;687;2.4;0.1
02;2021-01-30;4;13;12716;700;2.4;0.1
02;2021-01-31;0;10;12716;710;2.4;0.1
02;2021-02-01;11;202;12727;912;2.4;0.2
02;2021-02-02;45;314;12772;1226;2.4;0.2
02;2021-02-03;124;307;12896;1533;2.5;0.3
02;2021-02-04;226;325;13122;1858;2.5;0.4
02;2021-02-05;179;371;13301;2229;2.5;0.4
02;2021-02-06;69;149;13370;2378;2.5;0.5
02;2021-02-07;9;0;13379;2378;2.5;0.5
02;2021-02-08;306;398;13685;2776;2.6;0.5
02;2021-02-09;322;607;14007;3383;2.7;0.6
02;2021-02-10;485;939;14492;4322;2.8;0.8
02;2021-02-11;936;1727;15428;6049;2.9;1.1
02;2021-02-12;885;1017;16313;7066;3.1;1.3
02;2021-02-13;290;111;16603;7177;3.2;1.4
02;2021-02-14;1;5;16604;7182;3.2;1.4
02;2021-02-15;344;518;16948;7700;3.2;1.5
02;2021-02-16;414;425;17362;8125;3.3;1.5
02;2021-02-17;499;490;17861;8615;3.4;1.6
02;2021-02-18;507;356;18368;8971;3.5;1.7
02;2021-02-19;444;465;18812;9436;3.6;1.8
02;2021-02-20;372;194;19184;9630;3.6;1.8
02;2021-02-21;39;17;19223;9647;3.7;1.8
02;2021-02-22;377;255;19600;9902;3.7;1.9
02;2021-02-23;432;296;20032;10198;3.8;1.9
02;2021-02-24;600;126;20632;10324;3.9;2.0
02;2021-02-25;870;122;21502;10446;4.1;2.0
02;2021-02-26;808;72;22310;10518;4.2;2.0
02;2021-02-27;444;14;22754;10532;4.3;2.0
02;2021-02-28;55;2;22809;10534;4.3;2.0
02;2021-03-01;638;23;23447;10557;4.5;2.0
02;2021-03-02;1031;122;24478;10679;4.7;2.0
02;2021-03-03;754;198;25232;10877;4.8;2.1
02;2021-03-04;1161;608;26393;11485;5.0;2.2
02;2021-03-05;1048;494;27441;11979;5.2;2.3
02;2021-03-06;2141;95;29582;12074;5.6;2.3
02;2021-03-07;1505;51;31087;12125;5.9;2.3
02;2021-03-08;574;337;31661;12462;6.0;2.4
02;2021-03-09;997;375;32658;12837;6.2;2.4
02;2021-03-10;895;434;33553;13271;6.4;2.5
02;2021-03-11;1294;380;34847;13651;6.6;2.6
02;2021-03-12;1706;388;36553;14039;6.9;2.7
02;2021-03-13;2592;243;39145;14282;7.4;2.7
02;2021-03-14;1458;44;40603;14326;7.7;2.7
02;2021-03-15;612;442;41215;14768;7.8;2.8
02;2021-03-16;862;399;42077;15167;8.0;2.9
02;2021-03-17;759;436;42836;15603;8.1;3.0
02;2021-03-18;609;609;43445;16212;8.3;3.1
02;2021-03-19;1171;294;44616;16506;8.5;3.1
02;2021-03-20;2429;157;47045;16663;8.9;3.2
02;2021-03-21;1488;84;48533;16747;9.2;3.2
02;2021-03-22;762;486;49295;17233;9.4;3.3
02;2021-03-23;1195;541;50490;17774;9.6;3.4
02;2021-03-24;1582;499;52072;18273;9.9;3.5
02;2021-03-25;1693;591;53765;18864;10.2;3.6
02;2021-03-26;2412;491;56177;19355;10.7;3.7
02;2021-03-27;2494;141;58671;19496;11.2;3.7
02;2021-03-28;638;14;59309;19510;11.3;3.7
02;2021-03-29;1038;850;60347;20360;11.5;3.9
02;2021-03-30;1553;839;61900;21199;11.8;4.0
02;2021-03-31;1298;712;63198;21911;12.0;4.2
02;2021-04-01;1290;861;64488;22772;12.3;4.3
02;2021-04-02;1183;1222;65671;23994;12.5;4.6
02;2021-04-03;2644;848;68315;24842;13.0;4.7
02;2021-04-04;727;240;69042;25082;13.1;4.8
02;2021-04-05;1509;134;70551;25216;13.4;4.8
02;2021-04-06;1539;852;72090;26068;13.7;5.0
02;2021-04-07;1872;777;73962;26845;14.1;5.1
02;2021-04-08;1919;1105;75881;27950;14.4;5.3
02;2021-04-09;2432;1093;78313;29043;14.9;5.5
02;2021-04-10;2430;1211;80743;30254;15.3;5.8
02;2021-04-11;476;416;81219;30670;15.4;5.8
02;2021-04-12;1823;619;83042;31289;15.8;5.9
02;2021-04-13;1601;923;84643;32212;16.1;6.1
02;2021-04-14;2583;977;87226;33189;16.6;6.3
02;2021-04-15;2494;777;89720;33966;17.1;6.5
02;2021-04-16;2439;1131;92159;35097;17.5;6.7
02;2021-04-17;1890;2141;94049;37238;17.9;7.1
02;2021-04-18;270;811;94319;38049;17.9;7.2
02;2021-04-19;1158;632;95477;38681;18.1;7.4
02;2021-04-20;1674;765;97151;39446;18.5;7.5
02;2021-04-21;1550;994;98701;40440;18.8;7.7
02;2021-04-22;1748;705;100449;41145;19.1;7.8
02;2021-04-23;1930;1408;102379;42553;19.5;8.1
02;2021-04-24;1714;1638;104093;44191;19.8;8.4
02;2021-04-25;462;235;104555;44426;19.9;8.4
02;2021-04-26;1339;562;105894;44988;20.1;8.6
02;2021-04-27;1627;1092;107521;46080;20.4;8.8
02;2021-04-28;1592;1429;109113;47509;20.7;9.0
02;2021-04-29;1889;1170;111002;48679;21.1;9.3
02;2021-04-30;2716;1651;113718;50330;21.6;9.6
02;2021-05-01;1991;1228;115709;51558;22.0;9.8
02;2021-05-02;1982;422;117691;51980;22.4;9.9
02;2021-05-03;2224;981;119915;52961;22.8;10.1
02;2021-05-04;1522;1306;121437;54267;23.1;10.3
02;2021-05-05;2327;1842;123764;56109;23.5;10.7
02;2021-05-06;2122;1737;125886;57846;23.9;11.0
02;2021-05-07;2358;2171;128244;60017;24.4;11.4
02;2021-05-08;2917;950;131161;60967;24.9;11.6
02;2021-05-09;1823;423;132984;61390;25.3;11.7
02;2021-05-10;2375;1481;135359;62871;25.7;12.0
02;2021-05-11;2877;1569;138236;64440;26.3;12.2
02;2021-05-12;2675;1607;140911;66047;26.8;12.6
02;2021-05-13;2990;1039;143901;67086;27.4;12.8
02;2021-05-14;3381;1198;147282;68284;28.0;13.0
02;2021-05-15;4374;1082;151656;69366;28.8;13.2
02;2021-05-16;2795;212;154451;69578;29.4;13.2
02;2021-05-17;2147;664;156598;70242;29.8;13.4
02;2021-05-18;2634;971;159232;71213;30.3;13.5
02;2021-05-19;2852;999;162084;72212;30.8;13.7
02;2021-05-20;3553;1230;165637;73442;31.5;14.0
02;2021-05-21;3818;1067;169455;74509;32.2;14.2
02;2021-05-22;5845;969;175300;75478;33.3;14.3
02;2021-05-23;2658;240;177958;75718;33.8;14.4
02;2021-05-24;3541;544;181499;76262;34.5;14.5
02;2021-05-25;2257;1164;183756;77426;34.9;14.7
02;2021-05-26;3079;1498;186835;78924;35.5;15.0
02;2021-05-27;3649;1487;190484;80411;36.2;15.3
02;2021-05-28;3515;1576;193999;81987;36.9;15.6
02;2021-05-29;4079;1561;198078;83548;37.7;15.9
02;2021-05-30;1449;177;199527;83725;37.9;15.9
02;2021-05-31;2575;1187;202102;84912;38.4;16.1
02;2021-06-01;2870;1867;204972;86779;39.0;16.5
02;2021-06-02;3159;1652;208131;88431;39.6;16.8
02;2021-06-03;2854;1835;210985;90266;40.1;17.2
02;2021-06-04;3142;2054;214127;92320;40.7;17.5
02;2021-06-05;3441;1733;217568;94053;41.4;17.9
02;2021-06-06;1736;259;219304;94312;41.7;17.9
02;2021-06-07;1613;1500;220917;95812;42.0;18.2
02;2021-06-08;2061;1839;222978;97651;42.4;18.6
02;2021-06-09;2057;1646;225035;99297;42.8;18.9
02;2021-06-10;2011;1842;227046;101139;43.2;19.2
02;2021-06-11;2193;3073;229239;104212;43.6;19.8
02;2021-06-12;2311;2592;231550;106804;44.0;20.3
02;2021-06-13;683;1387;232233;108191;44.1;20.6
02;2021-06-14;1049;2392;233282;110583;44.3;21.0
02;2021-06-15;1518;2458;234800;113041;44.6;21.5
02;2021-06-16;1534;2749;236334;115790;44.9;22.0
02;2021-06-17;1782;2854;238116;118644;45.3;22.6
02;2021-06-18;2312;3570;240428;122214;45.7;23.2
02;2021-06-19;1841;3820;242269;126034;46.1;24.0
02;2021-06-20;644;1522;242913;127556;46.2;24.2
02;2021-06-21;806;3190;243719;130746;46.3;24.9
02;2021-06-22;1155;3667;244874;134413;46.5;25.6
02;2021-06-23;1226;3587;246100;138000;46.8;26.2
02;2021-06-24;1327;3149;247427;141149;47.0;26.8
02;2021-06-25;1399;4545;248826;145694;47.3;27.7
02;2021-06-26;1345;4228;250171;149922;47.6;28.5
02;2021-06-27;600;2333;250771;152255;47.7;28.9
02;2021-06-28;877;3021;251648;155276;47.8;29.5
02;2021-06-29;919;2929;252567;158205;48.0;30.1
02;2021-06-30;1509;3161;254076;161366;48.3;30.7
02;2021-07-01;1193;3591;255269;164957;48.5;31.4
02;2021-07-02;1358;5132;256627;170089;48.8;32.3
02;2021-07-03;999;5989;257626;176078;49.0;33.5
02;2021-07-04;509;2370;258135;178448;49.1;33.9
02;2021-07-05;661;3935;258796;182383;49.2;34.7
02;2021-07-06;675;3045;259471;185428;49.3;35.2
02;2021-07-07;1322;3727;260793;189155;49.6;36.0
02;2021-07-08;1393;3869;262186;193024;49.8;36.7
02;2021-07-09;1283;4216;263469;197240;50.1;37.5
02;2021-07-10;1332;4604;264801;201844;50.3;38.4
02;2021-07-11;480;1967;265281;203811;50.4;38.7
02;2021-07-12;1415;3726;266696;207537;50.7;39.5
02;2021-07-13;2065;3662;268761;211199;51.1;40.1
02;2021-07-14;1753;1599;270514;212798;51.4;40.5
02;2021-07-15;2727;3560;273241;216358;51.9;41.1
02;2021-07-16;3164;4217;276405;220575;52.5;41.9
02;2021-07-17;3561;4230;279966;224805;53.2;42.7
02;2021-07-18;2037;1616;282003;226421;53.6;43.0
02;2021-07-19;3440;3033;285443;229454;54.3;43.6
02;2021-07-20;3501;3303;288944;232757;54.9;44.2
02;2021-07-21;3910;2952;292854;235709;55.7;44.8
02;2021-07-22;3324;2801;296178;238510;56.3;45.3
02;2021-07-23;3205;3554;299383;242064;56.9;46.0
02;2021-07-24;4447;3724;303830;245788;57.8;46.7
02;2021-07-25;2191;1089;306021;246877;58.2;46.9
02;2021-07-26;3874;2252;309895;249129;58.9;47.4
02;2021-07-27;3660;2147;313555;251276;59.6;47.8
02;2021-07-28;3279;2096;316834;253372;60.2;48.2
02;2021-07-29;2583;2224;319417;255596;60.7;48.6
02;2021-07-30;3313;2306;322730;257902;61.3;49.0
02;2021-07-31;4183;2280;326913;260182;62.1;49.5
02;2021-08-01;1475;692;328388;260874;62.4;49.6
02;2021-08-02;2042;1601;330430;262475;62.8;49.9
02;2021-08-03;2530;1897;332960;264372;63.3;50.3
02;2021-08-04;2576;1711;335536;266083;63.8;50.6
02;2021-08-05;1849;2264;337385;268347;64.1;51.0
02;2021-08-06;2101;2741;339486;271088;64.5;51.5
02;2021-08-07;2522;2785;342008;273873;65.0;52.1
02;2021-08-08;1026;1572;343034;275445;65.2;52.4
02;2021-08-09;1909;2749;344943;278194;65.6;52.9
02;2021-08-10;1766;2462;346709;280656;65.9;53.4
02;2021-08-11;1481;2109;348190;282765;66.2;53.8
02;2021-08-12;1205;2332;349395;285097;66.4;54.2
02;2021-08-13;1611;2908;351006;288005;66.7;54.7
02;2021-08-14;1666;3696;352672;291701;67.0;55.5
02;2021-08-15;161;572;352833;292273;67.1;55.6
02;2021-08-16;1282;3755;354115;296028;67.3;56.3
02;2021-08-17;1421;2840;355536;298868;67.6;56.8
02;2021-08-18;1578;3182;357114;302050;67.9;57.4
02;2021-08-19;1134;3218;358248;305268;68.1;58.0
02;2021-08-20;1205;2950;359453;308218;68.3;58.6
02;2021-08-21;1449;4082;360902;312300;68.6;59.4
02;2021-08-22;407;1656;361309;313956;68.7;59.7
02;2021-08-23;1157;3080;362466;317036;68.9;60.3
02;2021-08-24;907;2184;363373;319220;69.1;60.7
02;2021-08-25;1021;2596;364394;321816;69.3;61.2
02;2021-08-26;913;2333;365307;324149;69.4;61.6
02;2021-08-27;965;2615;366272;326764;69.6;62.1
02;2021-08-28;1301;3429;367573;330193;69.9;62.8
02;2021-08-29;328;1170;367901;331363;69.9;63.0
02;2021-08-30;996;2473;368897;333836;70.1;63.5
02;2021-08-31;865;2259;369762;336095;70.3;63.9
02;2021-09-01;707;1551;370469;337646;70.4;64.2
02;2021-09-02;650;1726;371119;339372;70.5;64.5
02;2021-09-03;695;1947;371814;341319;70.7;64.9
02;2021-09-04;856;2836;372670;344155;70.8;65.4
02;2021-09-05;226;520;372896;344675;70.9;65.5
02;2021-09-06;405;1037;373301;345712;71.0;65.7
02;2021-09-07;453;1404;373754;347116;71.0;66.0
02;2021-09-08;516;1872;374270;348988;71.1;66.3
02;2021-09-09;441;1327;374711;350315;71.2;66.6
02;2021-09-10;563;1549;375274;351864;71.3;66.9
02;2021-09-11;722;2275;375996;354139;71.5;67.3
02;2021-09-12;91;286;376087;354425;71.5;67.4
02;2021-09-13;423;1208;376510;355633;71.6;67.6
02;2021-09-14;412;1169;376922;356802;71.7;67.8
02;2021-09-15;446;1306;377368;358108;71.7;68.1
02;2021-09-16;454;833;377822;358941;71.8;68.2
02;2021-09-17;581;932;378403;359873;71.9;68.4
02;2021-09-18;564;2029;378967;361902;72.0;68.8
02;2021-09-19;78;259;379045;362161;72.1;68.8
02;2021-09-20;296;651;379341;362812;72.1;69.0
02;2021-09-21;277;625;379618;363437;72.2;69.1
02;2021-09-22;361;906;379979;364343;72.2;69.3
02;2021-09-23;260;563;380239;364906;72.3;69.4
02;2021-09-24;296;762;380535;365668;72.3;69.5
02;2021-09-25;316;1207;380851;366875;72.4;69.7
02;2021-09-26;33;158;380884;367033;72.4;69.8
02;2021-09-27;138;367;381022;367400;72.4;69.8
02;2021-09-28;156;392;381178;367792;72.5;69.9
02;2021-09-29;228;418;381406;368210;72.5;70.0
02;2021-09-30;233;476;381639;368686;72.5;70.1
02;2021-10-01;349;654;381988;369340;72.6;70.2
02;2021-10-02;388;849;382376;370189;72.7;70.4
02;2021-10-03;35;59;382411;370248;72.7;70.4
03;2020-12-27;0;0;0;0;0.0;0.0
03;2020-12-28;1;0;1;0;0.0;0.0
03;2020-12-29;0;0;1;0;0.0;0.0
03;2020-12-30;1;0;2;0;0.0;0.0
03;2020-12-31;0;0;2;0;0.0;0.0
03;2021-01-01;0;0;2;0;0.0;0.0
03;2021-01-02;0;0;2;0;0.0;0.0
03;2021-01-03;0;0;2;0;0.0;0.0
03;2021-01-04;0;0;2;0;0.0;0.0
03;2021-01-05;0;0;2;0;0.0;0.0
03;2021-01-06;10;0;12;0;0.0;0.0
03;2021-01-07;61;0;73;0;0.0;0.0
03;2021-01-08;146;1;219;1;0.1;0.0
03;2021-01-09;122;0;341;1;0.1;0.0
03;2021-01-10;6;0;347;1;0.1;0.0
03;2021-01-11;412;1;759;2;0.2;0.0
03;2021-01-12;631;0;1390;2;0.4;0.0
03;2021-01-13;669;2;2059;4;0.6;0.0
03;2021-01-14;861;4;2920;8;0.9;0.0
03;2021-01-15;387;2;3307;10;1.0;0.0
03;2021-01-16;278;0;3585;10;1.1;0.0
03;2021-01-17;42;0;3627;10;1.1;0.0
03;2021-01-18;878;0;4505;10;1.4;0.0
03;2021-01-19;1151;2;5656;12;1.7;0.0
03;2021-01-20;1292;3;6948;15;2.1;0.0
03;2021-01-21;1200;5;8148;20;2.5;0.0
03;2021-01-22;1117;4;9265;24;2.8;0.0
03;2021-01-23;465;0;9730;24;2.9;0.0
03;2021-01-24;0;0;9730;24;2.9;0.0
03;2021-01-25;187;0;9917;24;3.0;0.0
03;2021-01-26;680;7;10597;31;3.2;0.0
03;2021-01-27;696;10;11293;41;3.4;0.0
03;2021-01-28;1020;40;12313;81;3.7;0.0
03;2021-01-29;856;77;13169;158;4.0;0.0
03;2021-01-30;600;1;13769;159;4.2;0.0
03;2021-01-31;0;0;13769;159;4.2;0.0
03;2021-02-01;160;67;13929;226;4.2;0.1
03;2021-02-02;767;226;14696;452;4.4;0.1
03;2021-02-03;1056;422;15752;874;4.8;0.3
03;2021-02-04;1557;596;17309;1470;5.2;0.4
03;2021-02-05;948;297;18257;1767;5.5;0.5
03;2021-02-06;152;13;18409;1780;5.6;0.5
03;2021-02-07;5;0;18414;1780;5.6;0.5
03;2021-02-08;128;51;18542;1831;5.6;0.6
03;2021-02-09;612;420;19154;2251;5.8;0.7
03;2021-02-10;485;331;19639;2582;5.9;0.8
03;2021-02-11;1027;555;20666;3137;6.2;0.9
03;2021-02-12;1078;511;21744;3648;6.6;1.1
03;2021-02-13;126;151;21870;3799;6.6;1.1
03;2021-02-14;0;1;21870;3800;6.6;1.1
03;2021-02-15;309;606;22179;4406;6.7;1.3
03;2021-02-16;548;914;22727;5320;6.9;1.6
03;2021-02-17;452;1057;23179;6377;7.0;1.9
03;2021-02-18;368;1003;23547;7380;7.1;2.2
03;2021-02-19;497;658;24044;8038;7.3;2.4
03;2021-02-20;128;143;24172;8181;7.3;2.5
03;2021-02-21;2;1;24174;8182;7.3;2.5
03;2021-02-22;158;160;24332;8342;7.3;2.5
03;2021-02-23;720;767;25052;9109;7.6;2.7
03;2021-02-24;610;867;25662;9976;7.7;3.0
03;2021-02-25;1093;1560;26755;11536;8.1;3.5
03;2021-02-26;822;1215;27577;12751;8.3;3.8
03;2021-02-27;96;212;27673;12963;8.4;3.9
03;2021-02-28;0;14;27673;12977;8.4;3.9
03;2021-03-01;178;217;27851;13194;8.4;4.0
03;2021-03-02;818;586;28669;13780;8.7;4.2
03;2021-03-03;904;396;29573;14176;8.9;4.3
03;2021-03-04;1541;533;31114;14709;9.4;4.4
03;2021-03-05;1121;656;32235;15365;9.7;4.6
03;2021-03-06;915;107;33150;15472;10.0;4.7
03;2021-03-07;2;0;33152;15472;10.0;4.7
03;2021-03-08;240;232;33392;15704;10.1;4.7
03;2021-03-09;1016;419;34408;16123;10.4;4.9
03;2021-03-10;941;506;35349;16629;10.7;5.0
03;2021-03-11;1675;619;37024;17248;11.2;5.2
03;2021-03-12;1303;798;38327;18046;11.6;5.4
03;2021-03-13;864;113;39191;18159;11.8;5.5
03;2021-03-14;2;5;39193;18164;11.8;5.5
03;2021-03-15;250;194;39443;18358;11.9;5.5
03;2021-03-16;650;396;40093;18754;12.1;5.7
03;2021-03-17;1304;429;41397;19183;12.5;5.8
03;2021-03-18;1720;393;43117;19576;13.0;5.9
03;2021-03-19;1728;361;44845;19937;13.5;6.0
03;2021-03-20;301;27;45146;19964;13.6;6.0
03;2021-03-21;1;0;45147;19964;13.6;6.0
03;2021-03-22;222;387;45369;20351;13.7;6.1
03;2021-03-23;1355;351;46724;20702;14.1;6.2
03;2021-03-24;1824;349;48548;21051;14.7;6.4
03;2021-03-25;2367;565;50915;21616;15.4;6.5
03;2021-03-26;2240;443;53155;22059;16.0;6.7
03;2021-03-27;817;22;53972;22081;16.3;6.7
03;2021-03-28;1;39;53973;22120;16.3;6.7
03;2021-03-29;659;175;54632;22295;16.5;6.7
03;2021-03-30;1908;450;56540;22745;17.1;6.9
03;2021-03-31;1014;982;57554;23727;17.4;7.2
03;2021-04-01;1375;1093;58929;24820;17.8;7.5
03;2021-04-02;1705;614;60634;25434;18.3;7.7
03;2021-04-03;365;99;60999;25533;18.4;7.7
03;2021-04-04;3;0;61002;25533;18.4;7.7
03;2021-04-05;18;14;61020;25547;18.4;7.7
03;2021-04-06;1073;410;62093;25957;18.7;7.8
03;2021-04-07;1562;523;63655;26480;19.2;8.0
03;2021-04-08;2121;486;65776;26966;19.9;8.1
03;2021-04-09;2056;1160;67832;28126;20.5;8.5
03;2021-04-10;1013;73;68845;28199;20.8;8.5
03;2021-04-11;478;9;69323;28208;20.9;8.5
03;2021-04-12;986;227;70309;28435;21.2;8.6
03;2021-04-13;1873;986;72182;29421;21.8;8.9
03;2021-04-14;2334;1222;74516;30643;22.5;9.2
03;2021-04-15;2621;1400;77137;32043;23.3;9.7
03;2021-04-16;2835;1184;79972;33227;24.1;10.0
03;2021-04-17;1083;441;81055;33668;24.5;10.2
03;2021-04-18;0;0;81055;33668;24.5;10.2
03;2021-04-19;1191;586;82246;34254;24.8;10.3
03;2021-04-20;1747;1274;83993;35528;25.4;10.7
03;2021-04-21;1122;1293;85115;36821;25.7;11.1
03;2021-04-22;1675;1000;86790;37821;26.2;11.4
03;2021-04-23;2478;1273;89268;39094;26.9;11.8
03;2021-04-24;1301;922;90569;40016;27.3;12.1
03;2021-04-25;350;16;90919;40032;27.4;12.1
03;2021-04-26;1332;466;92251;40498;27.8;12.2
03;2021-04-27;1766;1522;94017;42020;28.4;12.7
03;2021-04-28;1930;1119;95947;43139;29.0;13.0
03;2021-04-29;2370;1238;98317;44377;29.7;13.4
03;2021-04-30;1931;807;100248;45184;30.3;13.6
03;2021-05-01;438;493;100686;45677;30.4;13.8
03;2021-05-02;2;1;100688;45678;30.4;13.8
03;2021-05-03;1912;773;102600;46451;31.0;14.0
03;2021-05-04;2845;1634;105445;48085;31.8;14.5
03;2021-05-05;2604;1332;108049;49417;32.6;14.9
03;2021-05-06;3095;2007;111144;51424;33.5;15.5
03;2021-05-07;4729;1791;115873;53215;35.0;16.1
03;2021-05-08;661;381;116534;53596;35.2;16.2
03;2021-05-09;49;511;116583;54107;35.2;16.3
03;2021-05-10;1892;1480;118475;55587;35.8;16.8
03;2021-05-11;3900;1838;122375;57425;36.9;17.3
03;2021-05-12;2972;1521;125347;58946;37.8;17.8
03;2021-05-13;4384;410;129731;59356;39.2;17.9
03;2021-05-14;3655;1698;133386;61054;40.3;18.4
03;2021-05-15;1943;490;135329;61544;40.8;18.6
03;2021-05-16;522;57;135851;61601;41.0;18.6
03;2021-05-17;1277;862;137128;62463;41.4;18.9
03;2021-05-18;3068;1505;140196;63968;42.3;19.3
03;2021-05-19;2623;967;142819;64935;43.1;19.6
03;2021-05-20;3334;1143;146153;66078;44.1;19.9
03;2021-05-21;4194;1281;150347;67359;45.4;20.3
03;2021-05-22;2012;359;152359;67718;46.0;20.4
03;2021-05-23;641;73;153000;67791;46.2;20.5
03;2021-05-24;2654;216;155654;68007;47.0;20.5
03;2021-05-25;3068;1689;158722;69696;47.9;21.0
03;2021-05-26;2336;1041;161058;70737;48.6;21.4
03;2021-05-27;2945;1126;164003;71863;49.5;21.7
03;2021-05-28;3848;2280;167851;74143;50.7;22.4
03;2021-05-29;1748;603;169599;74746;51.2;22.6
03;2021-05-30;242;23;169841;74769;51.3;22.6
03;2021-05-31;697;570;170538;75339;51.5;22.7
03;2021-06-01;2302;2346;172840;77685;52.2;23.4
03;2021-06-02;1534;1748;174374;79433;52.6;24.0
03;2021-06-03;2060;2753;176434;82186;53.3;24.8
03;2021-06-04;1698;2508;178132;84694;53.8;25.6
03;2021-06-05;1076;1143;179208;85837;54.1;25.9
03;2021-06-06;59;7;179267;85844;54.1;25.9
03;2021-06-07;785;1815;180052;87659;54.3;26.5
03;2021-06-08;1458;2557;181510;90216;54.8;27.2
03;2021-06-09;1267;1877;182777;92093;55.2;27.8
03;2021-06-10;1381;2124;184158;94217;55.6;28.4
03;2021-06-11;1503;3450;185661;97667;56.0;29.5
03;2021-06-12;831;823;186492;98490;56.3;29.7
03;2021-06-13;20;10;186512;98500;56.3;29.7
03;2021-06-14;381;2175;186893;100675;56.4;30.4
03;2021-06-15;1317;3835;188210;104510;56.8;31.5
03;2021-06-16;788;2890;188998;107400;57.0;32.4
03;2021-06-17;1083;3333;190081;110733;57.4;33.4
03;2021-06-18;1107;3979;191188;114712;57.7;34.6
03;2021-06-19;641;1618;191829;116330;57.9;35.1
03;2021-06-20;20;8;191849;116338;57.9;35.1
03;2021-06-21;461;2636;192310;118974;58.0;35.9
03;2021-06-22;1027;4003;193337;122977;58.4;37.1
03;2021-06-23;716;3285;194053;126262;58.6;38.1
03;2021-06-24;982;3862;195035;130124;58.9;39.3
03;2021-06-25;1016;3892;196051;134016;59.2;40.4
03;2021-06-26;513;2040;196564;136056;59.3;41.1
03;2021-06-27;65;486;196629;136542;59.3;41.2
03;2021-06-28;642;2097;197271;138639;59.5;41.8
03;2021-06-29;1028;3330;198299;141969;59.9;42.9
03;2021-06-30;831;3120;199130;145089;60.1;43.8
03;2021-07-01;987;2936;200117;148025;60.4;44.7
03;2021-07-02;920;4094;201037;152119;60.7;45.9
03;2021-07-03;487;1884;201524;154003;60.8;46.5
03;2021-07-04;20;332;201544;154335;60.8;46.6
03;2021-07-05;817;2381;202361;156716;61.1;47.3
03;2021-07-06;1171;3462;203532;160178;61.4;48.3
03;2021-07-07;804;2617;204336;162795;61.7;49.1
03;2021-07-08;1060;3042;205396;165837;62.0;50.1
03;2021-07-09;1470;3626;206866;169463;62.4;51.1
03;2021-07-10;508;1925;207374;171388;62.6;51.7
03;2021-07-11;61;492;207435;171880;62.6;51.9
03;2021-07-12;939;1148;208374;173028;62.9;52.2
03;2021-07-13;2612;3152;210986;176180;63.7;53.2
03;2021-07-14;195;25;211181;176205;63.7;53.2
03;2021-07-15;2613;2454;213794;178659;64.5;53.9
03;2021-07-16;2737;2274;216531;180933;65.4;54.6
03;2021-07-17;1032;1626;217563;182559;65.7;55.1
03;2021-07-18;33;6;217596;182565;65.7;55.1
03;2021-07-19;2392;1276;219988;183841;66.4;55.5
03;2021-07-20;3074;3033;223062;186874;67.3;56.4
03;2021-07-21;3213;1439;226275;188313;68.3;56.8
03;2021-07-22;2851;1885;229126;190198;69.2;57.4
03;2021-07-23;3205;1306;232331;191504;70.1;57.8
03;2021-07-24;590;581;232921;192085;70.3;58.0
03;2021-07-25;18;5;232939;192090;70.3;58.0
03;2021-07-26;2044;1576;234983;193666;70.9;58.5
03;2021-07-27;3321;2230;238304;195896;71.9;59.1
03;2021-07-28;2718;1118;241022;197014;72.7;59.5
03;2021-07-29;2549;1662;243571;198676;73.5;60.0
03;2021-07-30;2136;1454;245707;200130;74.2;60.4
03;2021-07-31;964;893;246671;201023;74.5;60.7
03;2021-08-01;13;20;246684;201043;74.5;60.7
03;2021-08-02;1680;1605;248364;202648;75.0;61.2
03;2021-08-03;2223;2774;250587;205422;75.6;62.0
03;2021-08-04;2195;893;252782;206315;76.3;62.3
03;2021-08-05;1266;1939;254048;208254;76.7;62.9
03;2021-08-06;1281;1024;255329;209278;77.1;63.2
03;2021-08-07;614;496;255943;209774;77.3;63.3
03;2021-08-08;66;29;256009;209803;77.3;63.3
03;2021-08-09;597;1304;256606;211107;77.5;63.7
03;2021-08-10;1676;3471;258282;214578;78.0;64.8
03;2021-08-11;1335;2530;259617;217108;78.4;65.5
03;2021-08-12;1137;3514;260754;220622;78.7;66.6
03;2021-08-13;776;1052;261530;221674;78.9;66.9
03;2021-08-14;379;566;261909;222240;79.1;67.1
03;2021-08-15;9;61;261918;222301;79.1;67.1
03;2021-08-16;725;2693;262643;224994;79.3;67.9
03;2021-08-17;1076;3218;263719;228212;79.6;68.9
03;2021-08-18;1164;2156;264883;230368;79.9;69.5
03;2021-08-19;1010;3049;265893;233417;80.3;70.5
03;2021-08-20;718;1138;266611;234555;80.5;70.8
03;2021-08-21;418;727;267029;235282;80.6;71.0
03;2021-08-22;8;6;267037;235288;80.6;71.0
03;2021-08-23;784;2289;267821;237577;80.8;71.7
03;2021-08-24;893;2406;268714;239983;81.1;72.4
03;2021-08-25;934;2029;269648;242012;81.4;73.0
03;2021-08-26;574;1436;270222;243448;81.6;73.5
03;2021-08-27;457;1581;270679;245029;81.7;74.0
03;2021-08-28;219;674;270898;245703;81.8;74.2
03;2021-08-29;4;0;270902;245703;81.8;74.2
03;2021-08-30;768;1469;271670;247172;82.0;74.6
03;2021-08-31;706;2055;272376;249227;82.2;75.2
03;2021-09-01;605;1513;272981;250740;82.4;75.7
03;2021-09-02;478;1238;273459;251978;82.5;76.1
03;2021-09-03;492;1186;273951;253164;82.7;76.4
03;2021-09-04;251;630;274202;253794;82.8;76.6
03;2021-09-05;7;14;274209;253808;82.8;76.6
03;2021-09-06;320;1097;274529;254905;82.9;76.9
03;2021-09-07;577;1597;275106;256502;83.0;77.4
03;2021-09-08;424;1545;275530;258047;83.2;77.9
03;2021-09-09;275;948;275805;258995;83.2;78.2
03;2021-09-10;414;1246;276219;260241;83.4;78.5
03;2021-09-11;209;688;276428;260929;83.4;78.8
03;2021-09-12;2;20;276430;260949;83.4;78.8
03;2021-09-13;285;943;276715;261892;83.5;79.0
03;2021-09-14;440;1422;277155;263314;83.7;79.5
03;2021-09-15;356;996;277511;264310;83.8;79.8
03;2021-09-16;219;556;277730;264866;83.8;79.9
03;2021-09-17;159;356;277889;265222;83.9;80.1
03;2021-09-18;132;311;278021;265533;83.9;80.1
03;2021-09-19;0;11;278021;265544;83.9;80.1
03;2021-09-20;187;424;278208;265968;84.0;80.3
03;2021-09-21;248;721;278456;266689;84.0;80.5
03;2021-09-22;267;684;278723;267373;84.1;80.7
03;2021-09-23;178;460;278901;267833;84.2;80.8
03;2021-09-24;147;321;279048;268154;84.2;80.9
03;2021-09-25;51;257;279099;268411;84.2;81.0
03;2021-09-26;3;0;279102;268411;84.2;81.0
03;2021-09-27;116;326;279218;268737;84.3;81.1
03;2021-09-28;192;614;279410;269351;84.3;81.3
03;2021-09-29;212;506;279622;269857;84.4;81.5
03;2021-09-30;119;251;279741;270108;84.4;81.5
03;2021-10-01;153;487;279894;270595;84.5;81.7
03;2021-10-02;79;175;279973;270770;84.5;81.7
03;2021-10-03;0;0;279973;270770;84.5;81.7
04;2020-12-27;0;0;0;0;0.0;0.0
04;2020-12-28;1;0;1;0;0.0;0.0
04;2020-12-29;0;0;1;0;0.0;0.0
04;2020-12-30;0;0;1;0;0.0;0.0
04;2020-12-31;0;0;1;0;0.0;0.0
04;2021-01-01;0;0;1;0;0.0;0.0
04;2021-01-02;0;0;1;0;0.0;0.0
04;2021-01-03;0;0;1;0;0.0;0.0
04;2021-01-04;0;0;1;0;0.0;0.0
04;2021-01-05;4;0;5;0;0.0;0.0
04;2021-01-06;0;0;5;0;0.0;0.0
04;2021-01-07;61;0;66;0;0.0;0.0
04;2021-01-08;88;0;154;0;0.1;0.0
04;2021-01-09;57;0;211;0;0.1;0.0
04;2021-01-10;0;0;211;0;0.1;0.0
04;2021-01-11;77;0;288;0;0.2;0.0
04;2021-01-12;421;0;709;0;0.4;0.0
04;2021-01-13;244;2;953;2;0.6;0.0
04;2021-01-14;90;2;1043;4;0.6;0.0
04;2021-01-15;165;4;1208;8;0.7;0.0
04;2021-01-16;106;2;1314;10;0.8;0.0
04;2021-01-17;14;0;1328;10;0.8;0.0
04;2021-01-18;236;9;1564;19;0.9;0.0
04;2021-01-19;469;3;2033;22;1.2;0.0
04;2021-01-20;574;9;2607;31;1.6;0.0
04;2021-01-21;614;3;3221;34;1.9;0.0
04;2021-01-22;639;0;3860;34;2.3;0.0
04;2021-01-23;111;0;3971;34;2.4;0.0
04;2021-01-24;0;0;3971;34;2.4;0.0
04;2021-01-25;240;0;4211;34;2.5;0.0
04;2021-01-26;656;1;4867;35;2.9;0.0
04;2021-01-27;480;0;5347;35;3.2;0.0
04;2021-01-28;665;20;6012;55;3.6;0.0
04;2021-01-29;368;41;6380;96;3.9;0.1
04;2021-01-30;65;41;6445;137;3.9;0.1
04;2021-01-31;1;5;6446;142;3.9;0.1
04;2021-02-01;268;136;6714;278;4.1;0.2
04;2021-02-02;562;173;7276;451;4.4;0.3
04;2021-02-03;367;159;7643;610;4.6;0.4
04;2021-02-04;359;52;8002;662;4.8;0.4
04;2021-02-05;379;201;8381;863;5.1;0.5
04;2021-02-06;50;85;8431;948;5.1;0.6
04;2021-02-07;2;22;8433;970;5.1;0.6
04;2021-02-08;163;61;8596;1031;5.2;0.6
04;2021-02-09;196;112;8792;1143;5.3;0.7
04;2021-02-10;253;153;9045;1296;5.5;0.8
04;2021-02-11;363;244;9408;1540;5.7;0.9
04;2021-02-12;293;283;9701;1823;5.9;1.1
04;2021-02-13;27;86;9728;1909;5.9;1.2
04;2021-02-14;0;0;9728;1909;5.9;1.2
04;2021-02-15;31;135;9759;2044;5.9;1.2
04;2021-02-16;81;412;9840;2456;6.0;1.5
04;2021-02-17;67;365;9907;2821;6.0;1.7
04;2021-02-18;45;522;9952;3343;6.0;2.0
04;2021-02-19;53;306;10005;3649;6.1;2.2
04;2021-02-20;5;65;10010;3714;6.1;2.2
04;2021-02-21;0;0;10010;3714;6.1;2.2
04;2021-02-22;7;247;10017;3961;6.1;2.4
04;2021-02-23;19;500;10036;4461;6.1;2.7
04;2021-02-24;38;366;10074;4827;6.1;2.9
04;2021-02-25;73;323;10147;5150;6.1;3.1
04;2021-02-26;216;274;10363;5424;6.3;3.3
04;2021-02-27;179;66;10542;5490;6.4;3.3
04;2021-02-28;1;0;10543;5490;6.4;3.3
04;2021-03-01;18;64;10561;5554;6.4;3.4
04;2021-03-02;135;37;10696;5591;6.5;3.4
04;2021-03-03;375;557;11071;6148;6.7;3.7
04;2021-03-04;208;417;11279;6565;6.8;4.0
04;2021-03-05;236;318;11515;6883;7.0;4.2
04;2021-03-06;912;71;12427;6954;7.5;4.2
04;2021-03-07;498;25;12925;6979;7.8;4.2
04;2021-03-08;45;69;12970;7048;7.9;4.3
04;2021-03-09;215;229;13185;7277;8.0;4.4
04;2021-03-10;401;338;13586;7615;8.2;4.6
04;2021-03-11;495;314;14081;7929;8.5;4.8
04;2021-03-12;697;190;14778;8119;8.9;4.9
04;2021-03-13;1088;63;15866;8182;9.6;5.0
04;2021-03-14;460;3;16326;8185;9.9;5.0
04;2021-03-15;93;14;16419;8199;9.9;5.0
04;2021-03-16;74;8;16493;8207;10.0;5.0
04;2021-03-17;534;81;17027;8288;10.3;5.0
04;2021-03-18;815;24;17842;8312;10.8;5.0
04;2021-03-19;723;33;18565;8345;11.2;5.1
04;2021-03-20;159;3;18724;8348;11.3;5.1
04;2021-03-21;0;0;18724;8348;11.3;5.1
04;2021-03-22;105;13;18829;8361;11.4;5.1
04;2021-03-23;245;7;19074;8368;11.5;5.1
04;2021-03-24;1024;51;20098;8419;12.2;5.1
04;2021-03-25;1326;45;21424;8464;13.0;5.1
04;2021-03-26;1448;66;22872;8530;13.8;5.2
04;2021-03-27;266;19;23138;8549;14.0;5.2
04;2021-03-28;2;0;23140;8549;14.0;5.2
04;2021-03-29;680;13;23820;8562;14.4;5.2
04;2021-03-30;1086;142;24906;8704;15.1;5.3
04;2021-03-31;1327;107;26233;8811;15.9;5.3
04;2021-04-01;1133;133;27366;8944;16.6;5.4
04;2021-04-02;1185;113;28551;9057;17.3;5.5
04;2021-04-03;250;20;28801;9077;17.4;5.5
04;2021-04-04;1;0;28802;9077;17.4;5.5
04;2021-04-05;36;1;28838;9078;17.5;5.5
04;2021-04-06;929;150;29767;9228;18.0;5.6
04;2021-04-07;881;435;30648;9663;18.6;5.8
04;2021-04-08;926;696;31574;10359;19.1;6.3
04;2021-04-09;678;421;32252;10780;19.5;6.5
04;2021-04-10;231;191;32483;10971;19.7;6.6
04;2021-04-11;153;65;32636;11036;19.8;6.7
04;2021-04-12;593;101;33229;11137;20.1;6.7
04;2021-04-13;1189;240;34418;11377;20.8;6.9
04;2021-04-14;994;496;35412;11873;21.4;7.2
04;2021-04-15;921;672;36333;12545;22.0;7.6
04;2021-04-16;819;456;37152;13001;22.5;7.9
04;2021-04-17;209;69;37361;13070;22.6;7.9
04;2021-04-18;0;13;37361;13083;22.6;7.9
04;2021-04-19;338;287;37699;13370;22.8;8.1
04;2021-04-20;1003;446;38702;13816;23.4;8.4
04;2021-04-21;656;743;39358;14559;23.8;8.8
04;2021-04-22;758;853;40116;15412;24.3;9.3
04;2021-04-23;695;537;40811;15949;24.7;9.7
04;2021-04-24;165;65;40976;16014;24.8;9.7
04;2021-04-25;0;0;40976;16014;24.8;9.7
04;2021-04-26;172;611;41148;16625;24.9;10.1
04;2021-04-27;395;966;41543;17591;25.1;10.6
04;2021-04-28;431;1085;41974;18676;25.4;11.3
04;2021-04-29;688;1127;42662;19803;25.8;12.0
04;2021-04-30;436;847;43098;20650;26.1;12.5
04;2021-05-01;104;22;43202;20672;26.2;12.5
04;2021-05-02;8;131;43210;20803;26.2;12.6
04;2021-05-03;151;550;43361;21353;26.2;12.9
04;2021-05-04;564;835;43925;22188;26.6;13.4
04;2021-05-05;514;924;44439;23112;26.9;14.0
04;2021-05-06;1162;591;45601;23703;27.6;14.3
04;2021-05-07;656;753;46257;24456;28.0;14.8
04;2021-05-08;48;99;46305;24555;28.0;14.9
04;2021-05-09;0;0;46305;24555;28.0;14.9
04;2021-05-10;467;293;46772;24848;28.3;15.0
04;2021-05-11;1198;905;47970;25753;29.0;15.6
04;2021-05-12;1387;741;49357;26494;29.9;16.0
04;2021-05-13;378;131;49735;26625;30.1;16.1
04;2021-05-14;441;295;50176;26920;30.4;16.3
04;2021-05-15;99;161;50275;27081;30.4;16.4
04;2021-05-16;4;6;50279;27087;30.4;16.4
04;2021-05-17;155;297;50434;27384;30.5;16.6
04;2021-05-18;392;974;50826;28358;30.8;17.2
04;2021-05-19;773;688;51599;29046;31.2;17.6
04;2021-05-20;1256;548;52855;29594;32.0;17.9
04;2021-05-21;853;787;53708;30381;32.5;18.4
04;2021-05-22;105;146;53813;30527;32.6;18.5
04;2021-05-23;1;1;53814;30528;32.6;18.5
04;2021-05-24;2;36;53816;30564;32.6;18.5
04;2021-05-25;867;594;54683;31158;33.1;18.9
04;2021-05-26;1048;788;55731;31946;33.7;19.3
04;2021-05-27;1356;632;57087;32578;34.6;19.7
04;2021-05-28;1119;652;58206;33230;35.2;20.1
04;2021-05-29;90;398;58296;33628;35.3;20.4
04;2021-05-30;3;1;58299;33629;35.3;20.4
04;2021-05-31;420;416;58719;34045;35.5;20.6
04;2021-06-01;639;641;59358;34686;35.9;21.0
04;2021-06-02;871;1063;60229;35749;36.5;21.6
04;2021-06-03;1196;850;61425;36599;37.2;22.2
04;2021-06-04;978;777;62403;37376;37.8;22.6
04;2021-06-05;142;200;62545;37576;37.9;22.7
04;2021-06-06;7;13;62552;37589;37.9;22.8
04;2021-06-07;563;316;63115;37905;38.2;22.9
04;2021-06-08;839;594;63954;38499;38.7;23.3
04;2021-06-09;1146;685;65100;39184;39.4;23.7
04;2021-06-10;1142;585;66242;39769;40.1;24.1
04;2021-06-11;944;615;67186;40384;40.7;24.4
04;2021-06-12;212;144;67398;40528;40.8;24.5
04;2021-06-13;1;1;67399;40529;40.8;24.5
04;2021-06-14;478;303;67877;40832;41.1;24.7
04;2021-06-15;644;1003;68521;41835;41.5;25.3
04;2021-06-16;1022;786;69543;42621;42.1;25.8
04;2021-06-17;1001;959;70544;43580;42.7;26.4
04;2021-06-18;760;886;71304;44466;43.2;26.9
04;2021-06-19;40;85;71344;44551;43.2;27.0
04;2021-06-20;7;9;71351;44560;43.2;27.0
04;2021-06-21;305;614;71656;45174;43.4;27.3
04;2021-06-22;361;1308;72017;46482;43.6;28.1
04;2021-06-23;474;1311;72491;47793;43.9;28.9
04;2021-06-24;852;815;73343;48608;44.4;29.4
04;2021-06-25;461;639;73804;49247;44.7;29.8
04;2021-06-26;57;130;73861;49377;44.7;29.9
04;2021-06-27;4;4;73865;49381;44.7;29.9
04;2021-06-28;158;341;74023;49722;44.8;30.1
04;2021-06-29;370;839;74393;50561;45.0;30.6
04;2021-06-30;541;1121;74934;51682;45.4;31.3
04;2021-07-01;578;1219;75512;52901;45.7;32.0
04;2021-07-02;557;1090;76069;53991;46.0;32.7
04;2021-07-03;65;162;76134;54153;46.1;32.8
04;2021-07-04;6;6;76140;54159;46.1;32.8
04;2021-07-05;106;297;76246;54456;46.2;33.0
04;2021-07-06;503;1383;76749;55839;46.5;33.8
04;2021-07-07;494;1341;77243;57180;46.8;34.6
04;2021-07-08;725;1361;77968;58541;47.2;35.4
04;2021-07-09;580;1061;78548;59602;47.5;36.1
04;2021-07-10;92;177;78640;59779;47.6;36.2
04;2021-07-11;0;21;78640;59800;47.6;36.2
04;2021-07-12;128;652;78768;60452;47.7;36.6
04;2021-07-13;881;1540;79649;61992;48.2;37.5
04;2021-07-14;26;43;79675;62035;48.2;37.6
04;2021-07-15;1219;1736;80894;63771;49.0;38.6
04;2021-07-16;1082;1113;81976;64884;49.6;39.3
04;2021-07-17;446;235;82422;65119;49.9;39.4
04;2021-07-18;114;18;82536;65137;50.0;39.4
04;2021-07-19;484;655;83020;65792;50.3;39.8
04;2021-07-20;1313;1467;84333;67259;51.0;40.7
04;2021-07-21;1126;1165;85459;68424;51.7;41.4
04;2021-07-22;1500;1372;86959;69796;52.6;42.3
04;2021-07-23;1150;1140;88109;70936;53.3;42.9
04;2021-07-24;685;214;88794;71150;53.8;43.1
04;2021-07-25;42;16;88836;71166;53.8;43.1
04;2021-07-26;445;639;89281;71805;54.0;43.5
04;2021-07-27;1370;1045;90651;72850;54.9;44.1
04;2021-07-28;1072;1037;91723;73887;55.5;44.7
04;2021-07-29;1561;1301;93284;75188;56.5;45.5
04;2021-07-30;1245;924;94529;76112;57.2;46.1
04;2021-07-31;251;176;94780;76288;57.4;46.2
04;2021-08-01;48;19;94828;76307;57.4;46.2
04;2021-08-02;196;108;95024;76415;57.5;46.3
04;2021-08-03;1348;1116;96372;77531;58.3;46.9
04;2021-08-04;1178;864;97550;78395;59.1;47.5
04;2021-08-05;1194;738;98744;79133;59.8;47.9
04;2021-08-06;516;396;99260;79529;60.1;48.1
04;2021-08-07;162;162;99422;79691;60.2;48.2
04;2021-08-08;25;12;99447;79703;60.2;48.2
04;2021-08-09;103;117;99550;79820;60.3;48.3
04;2021-08-10;654;981;100204;80801;60.7;48.9
04;2021-08-11;1147;1020;101351;81821;61.4;49.5
04;2021-08-12;1124;1308;102475;83129;62.0;50.3
04;2021-08-13;443;386;102918;83515;62.3;50.6
04;2021-08-14;100;73;103018;83588;62.4;50.6
04;2021-08-15;1;0;103019;83588;62.4;50.6
04;2021-08-16;103;138;103122;83726;62.4;50.7
04;2021-08-17;495;1015;103617;84741;62.7;51.3
04;2021-08-18;719;1318;104336;86059;63.2;52.1
04;2021-08-19;740;1413;105076;87472;63.6;53.0
04;2021-08-20;748;1363;105824;88835;64.1;53.8
04;2021-08-21;66;111;105890;88946;64.1;53.8
04;2021-08-22;15;45;105905;88991;64.1;53.9
04;2021-08-23;55;110;105960;89101;64.1;53.9
04;2021-08-24;684;1493;106644;90594;64.6;54.8
04;2021-08-25;656;1182;107300;91776;65.0;55.6
04;2021-08-26;488;1216;107788;92992;65.2;56.3
04;2021-08-27;452;929;108240;93921;65.5;56.9
04;2021-08-28;131;244;108371;94165;65.6;57.0
04;2021-08-29;27;23;108398;94188;65.6;57.0
04;2021-08-30;122;244;108520;94432;65.7;57.2
04;2021-08-31;511;1008;109031;95440;66.0;57.8
04;2021-09-01;509;1253;109540;96693;66.3;58.5
04;2021-09-02;336;932;109876;97625;66.5;59.1
04;2021-09-03;288;819;110164;98444;66.7;59.6
04;2021-09-04;148;240;110312;98684;66.8;59.7
04;2021-09-05;14;9;110326;98693;66.8;59.7
04;2021-09-06;57;106;110383;98799;66.8;59.8
04;2021-09-07;370;1039;110753;99838;67.0;60.4
04;2021-09-08;328;894;111081;100732;67.2;61.0
04;2021-09-09;341;959;111422;101691;67.4;61.6
04;2021-09-10;277;812;111699;102503;67.6;62.0
04;2021-09-11;93;153;111792;102656;67.7;62.1
04;2021-09-12;18;30;111810;102686;67.7;62.2
04;2021-09-13;94;98;111904;102784;67.7;62.2
04;2021-09-14;329;966;112233;103750;67.9;62.8
04;2021-09-15;306;702;112539;104452;68.1;63.2
04;2021-09-16;310;522;112849;104974;68.3;63.5
04;2021-09-17;184;565;113033;105539;68.4;63.9
04;2021-09-18;48;123;113081;105662;68.5;64.0
04;2021-09-19;0;5;113081;105667;68.5;64.0
04;2021-09-20;79;51;113160;105718;68.5;64.0
04;2021-09-21;188;570;113348;106288;68.6;64.3
04;2021-09-22;162;677;113510;106965;68.7;64.7
04;2021-09-23;205;377;113715;107342;68.8;65.0
04;2021-09-24;143;436;113858;107778;68.9;65.2
04;2021-09-25;42;99;113900;107877;68.9;65.3
04;2021-09-26;6;26;113906;107903;69.0;65.3
04;2021-09-27;19;66;113925;107969;69.0;65.4
04;2021-09-28;139;277;114064;108246;69.0;65.5
04;2021-09-29;136;381;114200;108627;69.1;65.8
04;2021-09-30;116;268;114316;108895;69.2;65.9
04;2021-10-01;116;178;114432;109073;69.3;66.0
04;2021-10-02;59;135;114491;109208;69.3;66.1
04;2021-10-03;0;3;114491;109211;69.3;66.1
05;2020-12-27;0;0;0;0;0.0;0.0
05;2020-12-28;1;0;1;0;0.0;0.0
05;2020-12-29;1;0;2;0;0.0;0.0
05;2020-12-30;2;0;4;0;0.0;0.0
05;2020-12-31;0;0;4;0;0.0;0.0
05;2021-01-01;2;0;6;0;0.0;0.0
05;2021-01-02;2;0;8;0;0.0;0.0
05;2021-01-03;1;0;9;0;0.0;0.0
05;2021-01-04;2;0;11;0;0.0;0.0
05;2021-01-05;0;0;11;0;0.0;0.0
05;2021-01-06;22;0;33;0;0.0;0.0
05;2021-01-07;128;0;161;0;0.1;0.0
05;2021-01-08;146;0;307;0;0.2;0.0
05;2021-01-09;11;0;318;0;0.2;0.0
05;2021-01-10;0;0;318;0;0.2;0.0
05;2021-01-11;44;0;362;0;0.3;0.0
05;2021-01-12;105;0;467;0;0.3;0.0
05;2021-01-13;139;0;606;0;0.4;0.0
05;2021-01-14;167;0;773;0;0.5;0.0
05;2021-01-15;127;1;900;1;0.6;0.0
05;2021-01-16;15;0;915;1;0.6;0.0
05;2021-01-17;0;0;915;1;0.6;0.0
05;2021-01-18;226;1;1141;2;0.8;0.0
05;2021-01-19;227;0;1368;2;1.0;0.0
05;2021-01-20;213;0;1581;2;1.1;0.0
05;2021-01-21;255;0;1836;2;1.3;0.0
05;2021-01-22;196;1;2032;3;1.4;0.0
05;2021-01-23;112;0;2144;3;1.5;0.0
05;2021-01-24;0;0;2144;3;1.5;0.0
05;2021-01-25;316;0;2460;3;1.7;0.0
05;2021-01-26;486;0;2946;3;2.1;0.0
05;2021-01-27;389;3;3335;6;2.4;0.0
05;2021-01-28;363;42;3698;48;2.6;0.0
05;2021-01-29;364;109;4062;157;2.9;0.1
05;2021-01-30;97;9;4159;166;2.9;0.1
05;2021-01-31;4;0;4163;166;2.9;0.1
05;2021-02-01;177;20;4340;186;3.1;0.1
05;2021-02-02;187;68;4527;254;3.2;0.2
05;2021-02-03;208;58;4735;312;3.3;0.2
05;2021-02-04;197;113;4932;425;3.5;0.3
05;2021-02-05;183;107;5115;532;3.6;0.4
05;2021-02-06;76;24;5191;556;3.7;0.4
05;2021-02-07;0;5;5191;561;3.7;0.4
05;2021-02-08;84;95;5275;656;3.7;0.5
05;2021-02-09;97;90;5372;746;3.8;0.5
05;2021-02-10;81;147;5453;893;3.8;0.6
05;2021-02-11;87;111;5540;1004;3.9;0.7
05;2021-02-12;85;121;5625;1125;4.0;0.8
05;2021-02-13;75;29;5700;1154;4.0;0.8
05;2021-02-14;0;0;5700;1154;4.0;0.8
05;2021-02-15;98;148;5798;1302;4.1;0.9
05;2021-02-16;111;233;5909;1535;4.2;1.1
05;2021-02-17;136;198;6045;1733;4.3;1.2
05;2021-02-18;154;265;6199;1998;4.4;1.4
05;2021-02-19;158;288;6357;2286;4.5;1.6
05;2021-02-20;31;73;6388;2359;4.5;1.7
05;2021-02-21;0;0;6388;2359;4.5;1.7
05;2021-02-22;70;204;6458;2563;4.6;1.8
05;2021-02-23;18;167;6476;2730;4.6;1.9
05;2021-02-24;20;142;6496;2872;4.6;2.0
05;2021-02-25;56;116;6552;2988;4.6;2.1
05;2021-02-26;145;170;6697;3158;4.7;2.2
05;2021-02-27;65;149;6762;3307;4.8;2.3
05;2021-02-28;11;0;6773;3307;4.8;2.3
05;2021-03-01;92;143;6865;3450;4.8;2.4
05;2021-03-02;92;157;6957;3607;4.9;2.5
05;2021-03-03;112;192;7069;3799;5.0;2.7
05;2021-03-04;242;138;7311;3937;5.2;2.8
05;2021-03-05;578;165;7889;4102;5.6;2.9
05;2021-03-06;668;49;8557;4151;6.0;2.9
05;2021-03-07;516;20;9073;4171;6.4;2.9
05;2021-03-08;556;127;9629;4298;6.8;3.0
05;2021-03-09;520;148;10149;4446;7.2;3.1
05;2021-03-10;498;125;10647;4571;7.5;3.2
05;2021-03-11;377;136;11024;4707;7.8;3.3
05;2021-03-12;435;87;11459;4794;8.1;3.4
05;2021-03-13;797;96;12256;4890;8.6;3.4
05;2021-03-14;670;11;12926;4901;9.1;3.5
05;2021-03-15;354;121;13280;5022;9.4;3.5
05;2021-03-16;149;135;13429;5157;9.5;3.6
05;2021-03-17;262;119;13691;5276;9.7;3.7
05;2021-03-18;364;35;14055;5311;9.9;3.7
05;2021-03-19;450;59;14505;5370;10.2;3.8
05;2021-03-20;167;28;14672;5398;10.4;3.8
05;2021-03-21;1;0;14673;5398;10.4;3.8
05;2021-03-22;718;37;15391;5435;10.9;3.8
05;2021-03-23;805;15;16196;5450;11.4;3.8
05;2021-03-24;788;76;16984;5526;12.0;3.9
05;2021-03-25;901;59;17885;5585;12.6;3.9
05;2021-03-26;1023;49;18908;5634;13.3;4.0
05;2021-03-27;467;33;19375;5667;13.7;4.0
05;2021-03-28;10;0;19385;5667;13.7;4.0
05;2021-03-29;905;63;20290;5730;14.3;4.0
05;2021-03-30;1142;78;21432;5808;15.1;4.1
05;2021-03-31;824;253;22256;6061;15.7;4.3
05;2021-04-01;901;239;23157;6300;16.3;4.4
05;2021-04-02;664;380;23821;6680;16.8;4.7
05;2021-04-03;551;183;24372;6863;17.2;4.8
05;2021-04-04;350;63;24722;6926;17.4;4.9
05;2021-04-05;158;12;24880;6938;17.6;4.9
05;2021-04-06;646;274;25526;7212;18.0;5.1
05;2021-04-07;773;324;26299;7536;18.6;5.3
05;2021-04-08;733;337;27032;7873;19.1;5.6
05;2021-04-09;883;407;27915;8280;19.7;5.8
05;2021-04-10;714;387;28629;8667;20.2;6.1
05;2021-04-11;191;172;28820;8839;20.3;6.2
05;2021-04-12;732;264;29552;9103;20.8;6.4
05;2021-04-13;921;248;30473;9351;21.5;6.6
05;2021-04-14;666;325;31139;9676;22.0;6.8
05;2021-04-15;768;399;31907;10075;22.5;7.1
05;2021-04-16;730;397;32637;10472;23.0;7.4
05;2021-04-17;671;239;33308;10711;23.5;7.6
05;2021-04-18;305;23;33613;10734;23.7;7.6
05;2021-04-19;363;536;33976;11270;24.0;8.0
05;2021-04-20;482;628;34458;11898;24.3;8.4
05;2021-04-21;494;626;34952;12524;24.7;8.8
05;2021-04-22;385;546;35337;13070;24.9;9.2
05;2021-04-23;523;655;35860;13725;25.3;9.7
05;2021-04-24;347;384;36207;14109;25.5;10.0
05;2021-04-25;288;23;36495;14132;25.7;10.0
05;2021-04-26;367;704;36862;14836;26.0;10.5
05;2021-04-27;657;750;37519;15586;26.5;11.0
05;2021-04-28;468;721;37987;16307;26.8;11.5
05;2021-04-29;702;749;38689;17056;27.3;12.0
05;2021-04-30;509;753;39198;17809;27.7;12.6
05;2021-05-01;138;110;39336;17919;27.7;12.6
05;2021-05-02;267;115;39603;18034;27.9;12.7
05;2021-05-03;458;492;40061;18526;28.3;13.1
05;2021-05-04;384;503;40445;19029;28.5;13.4
05;2021-05-05;461;670;40906;19699;28.9;13.9
05;2021-05-06;644;725;41550;20424;29.3;14.4
05;2021-05-07;595;799;42145;21223;29.7;15.0
05;2021-05-08;481;177;42626;21400;30.1;15.1
05;2021-05-09;208;57;42834;21457;30.2;15.1
05;2021-05-10;500;696;43334;22153;30.6;15.6
05;2021-05-11;669;905;44003;23058;31.0;16.3
05;2021-05-12;647;733;44650;23791;31.5;16.8
05;2021-05-13;960;116;45610;23907;32.2;16.9
05;2021-05-14;826;495;46436;24402;32.8;17.2
05;2021-05-15;1044;353;47480;24755;33.5;17.5
05;2021-05-16;235;52;47715;24807;33.7;17.5
05;2021-05-17;484;430;48199;25237;34.0;17.8
05;2021-05-18;519;419;48718;25656;34.4;18.1
05;2021-05-19;727;459;49445;26115;34.9;18.4
05;2021-05-20;747;434;50192;26549;35.4;18.7
05;2021-05-21;706;512;50898;27061;35.9;19.1
05;2021-05-22;607;239;51505;27300;36.3;19.3
05;2021-05-23;277;59;51782;27359;36.5;19.3
05;2021-05-24;510;157;52292;27516;36.9;19.4
05;2021-05-25;515;483;52807;27999;37.3;19.8
05;2021-05-26;695;362;53502;28361;37.7;20.0
05;2021-05-27;799;572;54301;28933;38.3;20.4
05;2021-05-28;666;648;54967;29581;38.8;20.9
05;2021-05-29;566;544;55533;30125;39.2;21.3
05;2021-05-30;212;82;55745;30207;39.3;21.3
05;2021-05-31;576;495;56321;30702;39.7;21.7
05;2021-06-01;590;586;56911;31288;40.1;22.1
05;2021-06-02;684;703;57595;31991;40.6;22.6
05;2021-06-03;716;649;58311;32640;41.1;23.0
05;2021-06-04;1017;815;59328;33455;41.9;23.6
05;2021-06-05;807;507;60135;33962;42.4;24.0
05;2021-06-06;202;89;60337;34051;42.6;24.0
05;2021-06-07;605;833;60942;34884;43.0;24.6
05;2021-06-08;702;661;61644;35545;43.5;25.1
05;2021-06-09;648;782;62292;36327;43.9;25.6
05;2021-06-10;545;718;62837;37045;44.3;26.1
05;2021-06-11;765;723;63602;37768;44.9;26.6
05;2021-06-12;593;485;64195;38253;45.3;27.0
05;2021-06-13;113;91;64308;38344;45.4;27.0
05;2021-06-14;403;669;64711;39013;45.6;27.5
05;2021-06-15;543;911;65254;39924;46.0;28.2
05;2021-06-16;433;671;65687;40595;46.3;28.6
05;2021-06-17;360;805;66047;41400;46.6;29.2
05;2021-06-18;400;724;66447;42124;46.9;29.7
05;2021-06-19;421;570;66868;42694;47.2;30.1
05;2021-06-20;64;77;66932;42771;47.2;30.2
05;2021-06-21;319;641;67251;43412;47.4;30.6
05;2021-06-22;356;829;67607;44241;47.7;31.2
05;2021-06-23;354;763;67961;45004;47.9;31.7
05;2021-06-24;388;1021;68349;46025;48.2;32.5
05;2021-06-25;229;892;68578;46917;48.4;33.1
05;2021-06-26;292;1074;68870;47991;48.6;33.9
05;2021-06-27;128;170;68998;48161;48.7;34.0
05;2021-06-28;254;792;69252;48953;48.9;34.5
05;2021-06-29;250;785;69502;49738;49.0;35.1
05;2021-06-30;329;788;69831;50526;49.3;35.6
05;2021-07-01;385;792;70216;51318;49.5;36.2
05;2021-07-02;369;871;70585;52189;49.8;36.8
05;2021-07-03;305;741;70890;52930;50.0;37.3
05;2021-07-04;179;177;71069;53107;50.1;37.5
05;2021-07-05;264;780;71333;53887;50.3;38.0
05;2021-07-06;336;858;71669;54745;50.6;38.6
05;2021-07-07;400;781;72069;55526;50.8;39.2
05;2021-07-08;431;848;72500;56374;51.1;39.8
05;2021-07-09;422;994;72922;57368;51.4;40.5
05;2021-07-10;314;729;73236;58097;51.7;41.0
05;2021-07-11;176;120;73412;58217;51.8;41.1
05;2021-07-12;416;1014;73828;59231;52.1;41.8
05;2021-07-13;482;869;74310;60100;52.4;42.4
05;2021-07-14;837;300;75147;60400;53.0;42.6
05;2021-07-15;709;992;75856;61392;53.5;43.3
05;2021-07-16;1027;1456;76883;62848;54.2;44.3
05;2021-07-17;672;1306;77555;64154;54.7;45.3
05;2021-07-18;285;131;77840;64285;54.9;45.3
05;2021-07-19;572;792;78412;65077;55.3;45.9
05;2021-07-20;763;801;79175;65878;55.9;46.5
05;2021-07-21;882;840;80057;66718;56.5;47.1
05;2021-07-22;812;870;80869;67588;57.0;47.7
05;2021-07-23;1446;1239;82315;68827;58.1;48.6
05;2021-07-24;864;836;83179;69663;58.7;49.1
05;2021-07-25;305;160;83484;69823;58.9;49.3
05;2021-07-26;778;561;84262;70384;59.4;49.7
05;2021-07-27;1259;755;85521;71139;60.3;50.2
05;2021-07-28;1523;720;87044;71859;61.4;50.7
05;2021-07-29;1346;724;88390;72583;62.4;51.2
05;2021-07-30;960;595;89350;73178;63.0;51.6
05;2021-07-31;782;526;90132;73704;63.6;52.0
05;2021-08-01;192;178;90324;73882;63.7;52.1
05;2021-08-02;835;549;91159;74431;64.3;52.5
05;2021-08-03;828;610;91987;75041;64.9;52.9
05;2021-08-04;991;758;92978;75799;65.6;53.5
05;2021-08-05;981;727;93959;76526;66.3;54.0
05;2021-08-06;873;793;94832;77319;66.9;54.5
05;2021-08-07;631;642;95463;77961;67.3;55.0
05;2021-08-08;196;270;95659;78231;67.5;55.2
05;2021-08-09;774;847;96433;79078;68.0;55.8
05;2021-08-10;651;700;97084;79778;68.5;56.3
05;2021-08-11;743;857;97827;80635;69.0;56.9
05;2021-08-12;794;785;98621;81420;69.6;57.4
05;2021-08-13;626;893;99247;82313;70.0;58.1
05;2021-08-14;410;781;99657;83094;70.3;58.6
05;2021-08-15;188;224;99845;83318;70.4;58.8
05;2021-08-16;488;1086;100333;84404;70.8;59.5
05;2021-08-17;433;880;100766;85284;71.1;60.2
05;2021-08-18;438;974;101204;86258;71.4;60.8
05;2021-08-19;500;964;101704;87222;71.7;61.5
05;2021-08-20;478;1115;102182;88337;72.1;62.3
05;2021-08-21;359;851;102541;89188;72.3;62.9
05;2021-08-22;117;254;102658;89442;72.4;63.1
05;2021-08-23;320;828;102978;90270;72.6;63.7
05;2021-08-24;403;781;103381;91051;72.9;64.2
05;2021-08-25;408;926;103789;91977;73.2;64.9
05;2021-08-26;307;814;104096;92791;73.4;65.5
05;2021-08-27;334;921;104430;93712;73.7;66.1
05;2021-08-28;246;655;104676;94367;73.8;66.6
05;2021-08-29;66;255;104742;94622;73.9;66.7
05;2021-08-30;268;804;105010;95426;74.1;67.3
05;2021-08-31;253;713;105263;96139;74.3;67.8
05;2021-09-01;271;655;105534;96794;74.4;68.3
05;2021-09-02;255;708;105789;97502;74.6;68.8
05;2021-09-03;253;617;106042;98119;74.8;69.2
05;2021-09-04;203;669;106245;98788;74.9;69.7
05;2021-09-05;55;178;106300;98966;75.0;69.8
05;2021-09-06;164;422;106464;99388;75.1;70.1
05;2021-09-07;218;618;106682;100006;75.3;70.5
05;2021-09-08;177;594;106859;100600;75.4;71.0
05;2021-09-09;194;524;107053;101124;75.5;71.3
05;2021-09-10;182;450;107235;101574;75.6;71.7
05;2021-09-11;148;462;107383;102036;75.8;72.0
05;2021-09-12;24;106;107407;102142;75.8;72.1
05;2021-09-13;169;418;107576;102560;75.9;72.3
05;2021-09-14;218;366;107794;102926;76.0;72.6
05;2021-09-15;176;376;107970;103302;76.2;72.9
05;2021-09-16;174;254;108144;103556;76.3;73.1
05;2021-09-17;147;319;108291;103875;76.4;73.3
05;2021-09-18;120;359;108411;104234;76.5;73.5
05;2021-09-19;16;38;108427;104272;76.5;73.6
05;2021-09-20;59;166;108486;104438;76.5;73.7
05;2021-09-21;81;246;108567;104684;76.6;73.8
05;2021-09-22;109;291;108676;104975;76.7;74.1
05;2021-09-23;99;237;108775;105212;76.7;74.2
05;2021-09-24;85;281;108860;105493;76.8;74.4
05;2021-09-25;85;225;108945;105718;76.9;74.6
05;2021-09-26;17;31;108962;105749;76.9;74.6
05;2021-09-27;63;144;109025;105893;76.9;74.7
05;2021-09-28;68;159;109093;106052;77.0;74.8
05;2021-09-29;85;199;109178;106251;77.0;75.0
05;2021-09-30;59;102;109237;106353;77.1;75.0
05;2021-10-01;114;240;109351;106593;77.1;75.2
05;2021-10-02;93;193;109444;106786;77.2;75.3
05;2021-10-03;14;31;109458;106817;77.2;75.4
06;2020-12-27;16;0;16;0;0.0;0.0
06;2020-12-28;26;0;42;0;0.0;0.0
06;2020-12-29;12;0;54;0;0.0;0.0
06;2020-12-30;10;0;64;0;0.0;0.0
06;2020-12-31;30;0;94;0;0.0;0.0
06;2021-01-01;26;0;120;0;0.0;0.0
06;2021-01-02;9;0;129;0;0.0;0.0
06;2021-01-03;11;0;140;0;0.0;0.0
06;2021-01-04;159;1;299;1;0.0;0.0
06;2021-01-05;193;2;492;3;0.0;0.0
06;2021-01-06;253;2;745;5;0.1;0.0
06;2021-01-07;526;2;1271;7;0.1;0.0
06;2021-01-08;693;3;1964;10;0.2;0.0
06;2021-01-09;391;3;2355;13;0.2;0.0
06;2021-01-10;82;0;2437;13;0.2;0.0
06;2021-01-11;1164;1;3601;14;0.3;0.0
06;2021-01-12;2252;4;5853;18;0.5;0.0
06;2021-01-13;1756;7;7609;25;0.7;0.0
06;2021-01-14;2185;17;9794;42;0.9;0.0
06;2021-01-15;1891;5;11685;47;1.1;0.0
06;2021-01-16;994;5;12679;52;1.2;0.0
06;2021-01-17;246;0;12925;52;1.2;0.0
06;2021-01-18;2511;9;15436;61;1.4;0.0
06;2021-01-19;2780;12;18216;73;1.7;0.0
06;2021-01-20;3391;12;21607;85;2.0;0.0
06;2021-01-21;3061;22;24668;107;2.3;0.0
06;2021-01-22;3028;16;27696;123;2.6;0.0
06;2021-01-23;1310;3;29006;126;2.7;0.0
06;2021-01-24;34;0;29040;126;2.7;0.0
06;2021-01-25;2091;12;31131;138;2.9;0.0
06;2021-01-26;3416;44;34547;182;3.2;0.0
06;2021-01-27;2577;93;37124;275;3.4;0.0
06;2021-01-28;2829;183;39953;458;3.7;0.0
06;2021-01-29;2526;281;42479;739;3.9;0.1
06;2021-01-30;674;38;43153;777;4.0;0.1
06;2021-01-31;4;1;43157;778;4.0;0.1
06;2021-02-01;1029;412;44186;1190;4.1;0.1
06;2021-02-02;1517;364;45703;1554;4.2;0.1
06;2021-02-03;339;126;46042;1680;4.3;0.2
06;2021-02-04;727;773;46769;2453;4.3;0.2
06;2021-02-05;1015;946;47784;3399;4.4;0.3
06;2021-02-06;172;357;47956;3756;4.4;0.3
06;2021-02-07;14;49;47970;3805;4.4;0.4
06;2021-02-08;544;871;48514;4676;4.5;0.4
06;2021-02-09;327;682;48841;5358;4.5;0.5
06;2021-02-10;387;563;49228;5921;4.6;0.5
06;2021-02-11;485;897;49713;6818;4.6;0.6
06;2021-02-12;662;1077;50375;7895;4.7;0.7
06;2021-02-13;207;237;50582;8132;4.7;0.8
06;2021-02-14;19;2;50601;8134;4.7;0.8
06;2021-02-15;470;976;51071;9110;4.7;0.8
06;2021-02-16;877;1748;51948;10858;4.8;1.0
06;2021-02-17;845;1737;52793;12595;4.9;1.2
06;2021-02-18;1826;2200;54619;14795;5.1;1.4
06;2021-02-19;1774;1769;56393;16564;5.2;1.5
06;2021-02-20;291;416;56684;16980;5.3;1.6
06;2021-02-21;25;52;56709;17032;5.3;1.6
06;2021-02-22;1094;1220;57803;18252;5.4;1.7
06;2021-02-23;1769;1174;59572;19426;5.5;1.8
06;2021-02-24;2127;996;61699;20422;5.7;1.9
06;2021-02-25;3871;1367;65570;21789;6.1;2.0
06;2021-02-26;3416;1346;68986;23135;6.4;2.1
06;2021-02-27;1443;292;70429;23427;6.5;2.2
06;2021-02-28;103;23;70532;23450;6.5;2.2
06;2021-03-01;2438;669;72970;24119;6.8;2.2
06;2021-03-02;2472;808;75442;24927;7.0;2.3
06;2021-03-03;2879;460;78321;25387;7.3;2.4
06;2021-03-04;4643;502;82964;25889;7.7;2.4
06;2021-03-05;3927;900;86891;26789;8.0;2.5
06;2021-03-06;11973;343;98864;27132;9.2;2.5
06;2021-03-07;10223;311;109087;27443;10.1;2.5
06;2021-03-08;4186;981;113273;28424;10.5;2.6
06;2021-03-09;5020;791;118293;29215;11.0;2.7
06;2021-03-10;4740;655;123033;29870;11.4;2.8
06;2021-03-11;6746;825;129779;30695;12.0;2.8
06;2021-03-12;6898;975;136677;31670;12.7;2.9
06;2021-03-13;11276;347;147953;32017;13.7;3.0
06;2021-03-14;516;47;148469;32064;13.8;3.0
06;2021-03-15;4851;719;153320;32783;14.2;3.0
06;2021-03-16;3784;992;157104;33775;14.6;3.1
06;2021-03-17;6212;1729;163316;35504;15.1;3.3
06;2021-03-18;5136;1755;168452;37259;15.6;3.5
06;2021-03-19;6843;1960;175295;39219;16.2;3.6
06;2021-03-20;2380;511;177675;39730;16.5;3.7
06;2021-03-21;416;23;178091;39753;16.5;3.7
06;2021-03-22;3998;683;182089;40436;16.9;3.7
06;2021-03-23;5998;1185;188087;41621;17.4;3.9
06;2021-03-24;4233;3040;192320;44661;17.8;4.1
06;2021-03-25;5889;3086;198209;47747;18.4;4.4
06;2021-03-26;6373;1972;204582;49719;19.0;4.6
06;2021-03-27;2042;358;206624;50077;19.1;4.6
06;2021-03-28;218;5;206842;50082;19.2;4.6
06;2021-03-29;3212;2073;210054;52155;19.5;4.8
06;2021-03-30;5199;2483;215253;54638;19.9;5.1
06;2021-03-31;8063;1652;223316;56290;20.7;5.2
06;2021-04-01;7679;2457;230995;58747;21.4;5.4
06;2021-04-02;7253;2703;238248;61450;22.1;5.7
06;2021-04-03;2723;1374;240971;62824;22.3;5.8
06;2021-04-04;304;547;241275;63371;22.4;5.9
06;2021-04-05;1417;696;242692;64067;22.5;5.9
06;2021-04-06;6682;3312;249374;67379;23.1;6.2
06;2021-04-07;6239;3887;255613;71266;23.7;6.6
06;2021-04-08;5758;5647;261371;76913;24.2;7.1
06;2021-04-09;9398;5857;270769;82770;25.1;7.7
06;2021-04-10;2396;2778;273165;85548;25.3;7.9
06;2021-04-11;189;58;273354;85606;25.3;7.9
06;2021-04-12;4391;3503;277745;89109;25.7;8.3
06;2021-04-13;6395;5001;284140;94110;26.3;8.7
06;2021-04-14;5479;4431;289619;98541;26.8;9.1
06;2021-04-15;5560;4386;295179;102927;27.3;9.5
06;2021-04-16;7093;5190;302272;108117;28.0;10.0
06;2021-04-17;2789;3053;305061;111170;28.3;10.3
06;2021-04-18;272;223;305333;111393;28.3;10.3
06;2021-04-19;5505;4038;310838;115431;28.8;10.7
06;2021-04-20;5668;4872;316506;120303;29.3;11.1
06;2021-04-21;8339;4183;324845;124486;30.1;11.5
06;2021-04-22;8583;4200;333428;128686;30.9;11.9
06;2021-04-23;8854;4282;342282;132968;31.7;12.3
06;2021-04-24;2358;1495;344640;134463;31.9;12.5
06;2021-04-25;122;14;344762;134477;31.9;12.5
06;2021-04-26;4163;2318;348925;136795;32.3;12.7
06;2021-04-27;4594;4041;353519;140836;32.8;13.0
06;2021-04-28;4163;4574;357682;145410;33.1;13.5
06;2021-04-29;6095;5452;363777;150862;33.7;14.0
06;2021-04-30;6786;5167;370563;156029;34.3;14.5
06;2021-05-01;4168;838;374731;156867;34.7;14.5
06;2021-05-02;494;155;375225;157022;34.8;14.5
06;2021-05-03;6929;3561;382154;160583;35.4;14.9
06;2021-05-04;5757;5391;387911;165974;35.9;15.4
06;2021-05-05;4551;3909;392462;169883;36.4;15.7
06;2021-05-06;5234;4742;397696;174625;36.8;16.2
06;2021-05-07;5663;5673;403359;180298;37.4;16.7
06;2021-05-08;4874;1333;408233;181631;37.8;16.8
06;2021-05-09;206;308;408439;181939;37.8;16.9
06;2021-05-10;4834;5048;413273;186987;38.3;17.3
06;2021-05-11;4949;5558;418222;192545;38.7;17.8
06;2021-05-12;9111;4899;427333;197444;39.6;18.3
06;2021-05-13;9278;2146;436611;199590;40.4;18.5
06;2021-05-14;10863;3365;447474;202955;41.5;18.8
06;2021-05-15;9314;2225;456788;205180;42.3;19.0
06;2021-05-16;1506;288;458294;205468;42.5;19.0
06;2021-05-17;7524;3754;465818;209222;43.2;19.4
06;2021-05-18;9751;3233;475569;212455;44.1;19.7
06;2021-05-19;7716;2988;483285;215443;44.8;20.0
06;2021-05-20;7984;3681;491269;219124;45.5;20.3
06;2021-05-21;8833;3953;500102;223077;46.3;20.7
06;2021-05-22;3033;1326;503135;224403;46.6;20.8
06;2021-05-23;134;630;503269;225033;46.6;20.8
06;2021-05-24;3207;1002;506476;226035;46.9;20.9
06;2021-05-25;4763;4933;511239;230968;47.4;21.4
06;2021-05-26;5696;6631;516935;237599;47.9;22.0
06;2021-05-27;5594;6284;522529;243883;48.4;22.6
06;2021-05-28;4985;7291;527514;251174;48.9;23.3
06;2021-05-29;1638;2925;529152;254099;49.0;23.5
06;2021-05-30;258;1122;529410;255221;49.0;23.6
06;2021-05-31;4418;5120;533828;260341;49.5;24.1
06;2021-06-01;5755;7427;539583;267768;50.0;24.8
06;2021-06-02;3326;8549;542909;276317;50.3;25.6
06;2021-06-03;4551;8306;547460;284623;50.7;26.4
06;2021-06-04;5491;7726;552951;292349;51.2;27.1
06;2021-06-05;2468;3348;555419;295697;51.5;27.4
06;2021-06-06;183;235;555602;295932;51.5;27.4
06;2021-06-07;4148;5582;559750;301514;51.9;27.9
06;2021-06-08;4487;5218;564237;306732;52.3;28.4
06;2021-06-09;4125;7361;568362;314093;52.7;29.1
06;2021-06-10;4794;6871;573156;320964;53.1;29.7
06;2021-06-11;3929;8355;577085;329319;53.5;30.5
06;2021-06-12;1748;3751;578833;333070;53.6;30.9
06;2021-06-13;151;439;578984;333509;53.6;30.9
06;2021-06-14;2744;8605;581728;342114;53.9;31.7
06;2021-06-15;3296;9488;585024;351602;54.2;32.6
06;2021-06-16;3517;7023;588541;358625;54.5;33.2
06;2021-06-17;3684;7189;592225;365814;54.9;33.9
06;2021-06-18;2645;5929;594870;371743;55.1;34.4
06;2021-06-19;1319;1688;596189;373431;55.2;34.6
06;2021-06-20;211;349;596400;373780;55.3;34.6
06;2021-06-21;1737;6296;598137;380076;55.4;35.2
06;2021-06-22;2373;7359;600510;387435;55.6;35.9
06;2021-06-23;2095;6542;602605;393977;55.8;36.5
06;2021-06-24;3497;8967;606102;402944;56.2;37.3
06;2021-06-25;2308;9603;608410;412547;56.4;38.2
06;2021-06-26;893;2288;609303;414835;56.4;38.4
06;2021-06-27;379;1190;609682;416025;56.5;38.5
06;2021-06-28;2502;8123;612184;424148;56.7;39.3
06;2021-06-29;2396;7730;614580;431878;56.9;40.0
06;2021-06-30;1522;7693;616102;439571;57.1;40.7
06;2021-07-01;3572;7480;619674;447051;57.4;41.4
06;2021-07-02;4476;8279;624150;455330;57.8;42.2
06;2021-07-03;1240;4306;625390;459636;57.9;42.6
06;2021-07-04;318;303;625708;459939;58.0;42.6
06;2021-07-05;4079;5142;629787;465081;58.3;43.1
06;2021-07-06;2148;5813;631935;470894;58.5;43.6
06;2021-07-07;4188;5980;636123;476874;58.9;44.2
06;2021-07-08;3733;6334;639856;483208;59.3;44.8
06;2021-07-09;4868;6239;644724;489447;59.7;45.3
06;2021-07-10;1777;2330;646501;491777;59.9;45.6
06;2021-07-11;332;322;646833;492099;59.9;45.6
06;2021-07-12;4210;7150;651043;499249;60.3;46.3
06;2021-07-13;6126;9024;657169;508273;60.9;47.1
06;2021-07-14;1251;442;658420;508715;61.0;47.1
06;2021-07-15;6852;8038;665272;516753;61.6;47.9
06;2021-07-16;8542;9038;673814;525791;62.4;48.7
06;2021-07-17;3170;5477;676984;531268;62.7;49.2
06;2021-07-18;1079;5332;678063;536600;62.8;49.7
06;2021-07-19;6168;8030;684231;544630;63.4;50.5
06;2021-07-20;7602;10261;691833;554891;64.1;51.4
06;2021-07-21;8478;8716;700311;563607;64.9;52.2
06;2021-07-22;10456;7885;710767;571492;65.8;52.9
06;2021-07-23;9568;6930;720335;578422;66.7;53.6
06;2021-07-24;3305;3107;723640;581529;67.0;53.9
06;2021-07-25;1002;480;724642;582009;67.1;53.9
06;2021-07-26;7664;6892;732306;588901;67.8;54.6
06;2021-07-27;9276;5594;741582;594495;68.7;55.1
06;2021-07-28;7491;5406;749073;599901;69.4;55.6
06;2021-07-29;8893;5788;757966;605689;70.2;56.1
06;2021-07-30;8556;5559;766522;611248;71.0;56.6
06;2021-07-31;3830;3082;770352;614330;71.4;56.9
06;2021-08-01;900;436;771252;614766;71.5;57.0
06;2021-08-02;7143;4627;778395;619393;72.1;57.4
06;2021-08-03;6861;5500;785256;624893;72.7;57.9
06;2021-08-04;5835;3518;791091;628411;73.3;58.2
06;2021-08-05;6787;4474;797878;632885;73.9;58.6
06;2021-08-06;6115;6118;803993;639003;74.5;59.2
06;2021-08-07;2326;2474;806319;641477;74.7;59.4
06;2021-08-08;616;631;806935;642108;74.8;59.5
06;2021-08-09;4878;6040;811813;648148;75.2;60.0
06;2021-08-10;5519;6913;817332;655061;75.7;60.7
06;2021-08-11;4457;6216;821789;661277;76.1;61.3
06;2021-08-12;4741;6742;826530;668019;76.6;61.9
06;2021-08-13;3880;6455;830410;674474;76.9;62.5
06;2021-08-14;1599;2275;832009;676749;77.1;62.7
06;2021-08-15;418;639;832427;677388;77.1;62.8
06;2021-08-16;3296;6910;835723;684298;77.4;63.4
06;2021-08-17;3842;7781;839565;692079;77.8;64.1
06;2021-08-18;2995;6410;842560;698489;78.1;64.7
06;2021-08-19;4019;8127;846579;706616;78.4;65.5
06;2021-08-20;3304;6532;849883;713148;78.7;66.1
06;2021-08-21;1842;3593;851725;716741;78.9;66.4
06;2021-08-22;389;712;852114;717453;78.9;66.5
06;2021-08-23;2540;6531;854654;723984;79.2;67.1
06;2021-08-24;2888;6472;857542;730456;79.4;67.7
06;2021-08-25;2620;5681;860162;736137;79.7;68.2
06;2021-08-26;2736;6890;862898;743027;79.9;68.8
06;2021-08-27;2645;7077;865543;750104;80.2;69.5
06;2021-08-28;1295;3335;866838;753439;80.3;69.8
06;2021-08-29;295;826;867133;754265;80.3;69.9
06;2021-08-30;2464;6385;869597;760650;80.6;70.5
06;2021-08-31;2772;7145;872369;767795;80.8;71.1
06;2021-09-01;2462;5814;874831;773609;81.0;71.7
06;2021-09-02;2443;6434;877274;780043;81.3;72.3
06;2021-09-03;2164;6879;879438;786922;81.5;72.9
06;2021-09-04;1377;3661;880815;790583;81.6;73.2
06;2021-09-05;278;530;881093;791113;81.6;73.3
06;2021-09-06;1521;4914;882614;796027;81.8;73.7
06;2021-09-07;1622;5269;884236;801296;81.9;74.2
06;2021-09-08;1568;4472;885804;805768;82.1;74.6
06;2021-09-09;1441;4192;887245;809960;82.2;75.0
06;2021-09-10;1861;4276;889106;814236;82.4;75.4
06;2021-09-11;1083;2465;890189;816701;82.5;75.7
06;2021-09-12;143;337;890332;817038;82.5;75.7
06;2021-09-13;1285;3537;891617;820575;82.6;76.0
06;2021-09-14;1515;3147;893132;823722;82.7;76.3
06;2021-09-15;1468;2757;894600;826479;82.9;76.6
06;2021-09-16;1342;2423;895942;828902;83.0;76.8
06;2021-09-17;1473;2869;897415;831771;83.1;77.1
06;2021-09-18;687;1962;898102;833733;83.2;77.2
06;2021-09-19;108;289;898210;834022;83.2;77.3
06;2021-09-20;714;2134;898924;836156;83.3;77.5
06;2021-09-21;985;2476;899909;838632;83.4;77.7
06;2021-09-22;1046;2512;900955;841144;83.5;77.9
06;2021-09-23;815;2195;901770;843339;83.5;78.1
06;2021-09-24;919;2352;902689;845691;83.6;78.3
06;2021-09-25;488;1778;903177;847469;83.7;78.5
06;2021-09-26;96;217;903273;847686;83.7;78.5
06;2021-09-27;659;1607;903932;849293;83.7;78.7
06;2021-09-28;538;1595;904470;850888;83.8;78.8
06;2021-09-29;816;1788;905286;852676;83.9;79.0
06;2021-09-30;749;1704;906035;854380;83.9;79.2
06;2021-10-01;903;2072;906938;856452;84.0;79.3
06;2021-10-02;483;1339;907421;857791;84.1;79.5
06;2021-10-03;97;169;907518;857960;84.1;79.5
07;2020-12-27;0;0;0;0;0.0;0.0
07;2020-12-28;0;0;0;0;0.0;0.0
07;2020-12-29;0;0;0;0;0.0;0.0
07;2020-12-30;0;0;0;0;0.0;0.0
07;2020-12-31;0;0;0;0;0.0;0.0
07;2021-01-01;7;0;7;0;0.0;0.0
07;2021-01-02;0;0;7;0;0.0;0.0
07;2021-01-03;0;0;7;0;0.0;0.0
07;2021-01-04;0;0;7;0;0.0;0.0
07;2021-01-05;0;0;7;0;0.0;0.0
07;2021-01-06;31;0;38;0;0.0;0.0
07;2021-01-07;130;1;168;1;0.1;0.0
07;2021-01-08;45;1;213;2;0.1;0.0
07;2021-01-09;17;0;230;2;0.1;0.0
07;2021-01-10;0;0;230;2;0.1;0.0
07;2021-01-11;157;1;387;3;0.1;0.0
07;2021-01-12;310;0;697;3;0.2;0.0
07;2021-01-13;308;1;1005;4;0.3;0.0
07;2021-01-14;476;0;1481;4;0.5;0.0
07;2021-01-15;188;0;1669;4;0.5;0.0
07;2021-01-16;17;0;1686;4;0.5;0.0
07;2021-01-17;2;0;1688;4;0.5;0.0
07;2021-01-18;364;4;2052;8;0.6;0.0
07;2021-01-19;830;2;2882;10;0.9;0.0
07;2021-01-20;605;1;3487;11;1.1;0.0
07;2021-01-21;453;3;3940;14;1.2;0.0
07;2021-01-22;292;0;4232;14;1.3;0.0
07;2021-01-23;107;0;4339;14;1.3;0.0
07;2021-01-24;0;0;4339;14;1.3;0.0
07;2021-01-25;164;0;4503;14;1.4;0.0
07;2021-01-26;491;4;4994;18;1.5;0.0
07;2021-01-27;557;8;5551;26;1.7;0.0
07;2021-01-28;1207;102;6758;128;2.1;0.0
07;2021-01-29;712;17;7470;145;2.3;0.0
07;2021-01-30;212;4;7682;149;2.4;0.0
07;2021-01-31;7;0;7689;149;2.4;0.0
07;2021-02-01;267;17;7956;166;2.4;0.1
07;2021-02-02;664;194;8620;360;2.6;0.1
07;2021-02-03;1046;176;9666;536;3.0;0.2
07;2021-02-04;722;248;10388;784;3.2;0.2
07;2021-02-05;484;240;10872;1024;3.3;0.3
07;2021-02-06;98;2;10970;1026;3.4;0.3
07;2021-02-07;12;1;10982;1027;3.4;0.3
07;2021-02-08;239;143;11221;1170;3.4;0.4
07;2021-02-09;490;304;11711;1474;3.6;0.5
07;2021-02-10;538;366;12249;1840;3.7;0.6
07;2021-02-11;400;243;12649;2083;3.9;0.6
07;2021-02-12;266;146;12915;2229;4.0;0.7
07;2021-02-13;69;16;12984;2245;4.0;0.7
07;2021-02-14;1;0;12985;2245;4.0;0.7
07;2021-02-15;270;103;13255;2348;4.1;0.7
07;2021-02-16;352;310;13607;2658;4.2;0.8
07;2021-02-17;466;284;14073;2942;4.3;0.9
07;2021-02-18;564;719;14637;3661;4.5;1.1
07;2021-02-19;458;474;15095;4135;4.6;1.3
07;2021-02-20;109;58;15204;4193;4.7;1.3
07;2021-02-21;15;0;15219;4193;4.7;1.3
07;2021-02-22;425;178;15644;4371;4.8;1.3
07;2021-02-23;646;581;16290;4952;5.0;1.5
07;2021-02-24;927;655;17217;5607;5.3;1.7
07;2021-02-25;709;467;17926;6074;5.5;1.9
07;2021-02-26;844;243;18770;6317;5.7;1.9
07;2021-02-27;190;138;18960;6455;5.8;2.0
07;2021-02-28;1;0;18961;6455;5.8;2.0
07;2021-03-01;438;179;19399;6634;5.9;2.0
07;2021-03-02;657;523;20056;7157;6.1;2.2
07;2021-03-03;695;477;20751;7634;6.3;2.3
07;2021-03-04;1100;311;21851;7945;6.7;2.4
07;2021-03-05;1084;340;22935;8285;7.0;2.5
07;2021-03-06;1125;96;24060;8381;7.4;2.6
07;2021-03-07;717;20;24777;8401;7.6;2.6
07;2021-03-08;352;278;25129;8679;7.7;2.7
07;2021-03-09;1089;393;26218;9072;8.0;2.8
07;2021-03-10;869;501;27087;9573;8.3;2.9
07;2021-03-11;1373;444;28460;10017;8.7;3.1
07;2021-03-12;1618;542;30078;10559;9.2;3.2
07;2021-03-13;683;89;30761;10648;9.4;3.3
07;2021-03-14;4;0;30765;10648;9.4;3.3
07;2021-03-15;525;274;31290;10922;9.6;3.3
07;2021-03-16;1209;475;32499;11397;9.9;3.5
07;2021-03-17;1189;769;33688;12166;10.3;3.7
07;2021-03-18;1217;405;34905;12571;10.7;3.8
07;2021-03-19;1269;423;36174;12994;11.1;4.0
07;2021-03-20;467;106;36641;13100;11.2;4.0
07;2021-03-21;3;1;36644;13101;11.2;4.0
07;2021-03-22;790;530;37434;13631;11.5;4.2
07;2021-03-23;1517;710;38951;14341;11.9;4.4
07;2021-03-24;1280;660;40231;15001;12.3;4.6
07;2021-03-25;1852;508;42083;15509;12.9;4.7
07;2021-03-26;1834;436;43917;15945;13.4;4.9
07;2021-03-27;384;96;44301;16041;13.6;4.9
07;2021-03-28;6;1;44307;16042;13.6;4.9
07;2021-03-29;789;354;45096;16396;13.8;5.0
07;2021-03-30;1526;509;46622;16905;14.3;5.2
07;2021-03-31;1662;507;48284;17412;14.8;5.3
07;2021-04-01;1590;661;49874;18073;15.3;5.5
07;2021-04-02;1522;439;51396;18512;15.7;5.7
07;2021-04-03;230;106;51626;18618;15.8;5.7
07;2021-04-04;3;1;51629;18619;15.8;5.7
07;2021-04-05;0;66;51629;18685;15.8;5.7
07;2021-04-06;1159;761;52788;19446;16.1;5.9
07;2021-04-07;1316;900;54104;20346;16.6;6.2
07;2021-04-08;1969;1176;56073;21522;17.2;6.6
07;2021-04-09;2423;566;58496;22088;17.9;6.8
07;2021-04-10;807;163;59303;22251;18.1;6.8
07;2021-04-11;339;12;59642;22263;18.2;6.8
07;2021-04-12;1287;596;60929;22859;18.6;7.0
07;2021-04-13;1767;1338;62696;24197;19.2;7.4
07;2021-04-14;1686;1015;64382;25212;19.7;7.7
07;2021-04-15;1443;842;65825;26054;20.1;8.0
07;2021-04-16;1506;911;67331;26965;20.6;8.2
07;2021-04-17;870;216;68201;27181;20.9;8.3
07;2021-04-18;699;38;68900;27219;21.1;8.3
07;2021-04-19;1161;574;70061;27793;21.4;8.5
07;2021-04-20;1441;1318;71502;29111;21.9;8.9
07;2021-04-21;1719;917;73221;30028;22.4;9.2
07;2021-04-22;1817;967;75038;30995;23.0;9.5
07;2021-04-23;1411;969;76449;31964;23.4;9.8
07;2021-04-24;962;251;77411;32215;23.7;9.9
07;2021-04-25;717;69;78128;32284;23.9;9.9
07;2021-04-26;1137;678;79265;32962;24.2;10.1
07;2021-04-27;1394;1565;80659;34527;24.7;10.6
07;2021-04-28;1635;1755;82294;36282;25.2;11.1
07;2021-04-29;1937;1530;84231;37812;25.8;11.6
07;2021-04-30;1661;1479;85892;39291;26.3;12.0
07;2021-05-01;960;119;86852;39410;26.6;12.1
07;2021-05-02;844;155;87696;39565;26.8;12.1
07;2021-05-03;1280;434;88976;39999;27.2;12.2
07;2021-05-04;2170;1566;91146;41565;27.9;12.7
07;2021-05-05;1744;1386;92890;42951;28.4;13.1
07;2021-05-06;2101;1587;94991;44538;29.1;13.6
07;2021-05-07;1597;1553;96588;46091;29.5;14.1
07;2021-05-08;1230;403;97818;46494;29.9;14.2
07;2021-05-09;1030;326;98848;46820;30.2;14.3
07;2021-05-10;1406;1176;100254;47996;30.7;14.7
07;2021-05-11;2470;1693;102724;49689;31.4;15.2
07;2021-05-12;2164;1277;104888;50966;32.1;15.6
07;2021-05-13;1712;273;106600;51239;32.6;15.7
07;2021-05-14;1734;996;108334;52235;33.1;16.0
07;2021-05-15;1626;500;109960;52735;33.6;16.1
07;2021-05-16;1442;214;111402;52949;34.1;16.2
07;2021-05-17;1771;857;113173;53806;34.6;16.5
07;2021-05-18;2295;1302;115468;55108;35.3;16.9
07;2021-05-19;2375;1000;117843;56108;36.1;17.2
07;2021-05-20;2165;1308;120008;57416;36.7;17.6
07;2021-05-21;1757;1312;121765;58728;37.3;18.0
07;2021-05-22;935;542;122700;59270;37.5;18.1
07;2021-05-23;856;157;123556;59427;37.8;18.2
07;2021-05-24;1648;338;125204;59765;38.3;18.3
07;2021-05-25;2184;1477;127388;61242;39.0;18.7
07;2021-05-26;1526;1379;128914;62621;39.4;19.2
07;2021-05-27;2015;1411;130929;64032;40.1;19.6
07;2021-05-28;1770;2078;132699;66110;40.6;20.2
07;2021-05-29;942;683;133641;66793;40.9;20.4
07;2021-05-30;622;570;134263;67363;41.1;20.6
07;2021-05-31;1133;1281;135396;68644;41.4;21.0
07;2021-06-01;2153;2001;137549;70645;42.1;21.6
07;2021-06-02;1532;1653;139081;72298;42.5;22.1
07;2021-06-03;1712;1254;140793;73552;43.1;22.5
07;2021-06-04;1676;1593;142469;75145;43.6;23.0
07;2021-06-05;987;955;143456;76100;43.9;23.3
07;2021-06-06;598;624;144054;76724;44.1;23.5
07;2021-06-07;961;1193;145015;77917;44.4;23.8
07;2021-06-08;1548;1771;146563;79688;44.8;24.4
07;2021-06-09;1030;1418;147593;81106;45.2;24.8
07;2021-06-10;789;1388;148382;82494;45.4;25.2
07;2021-06-11;1154;2032;149536;84526;45.7;25.9
07;2021-06-12;643;1217;150179;85743;45.9;26.2
07;2021-06-13;395;444;150574;86187;46.1;26.4
07;2021-06-14;566;1958;151140;88145;46.2;27.0
07;2021-06-15;936;2550;152076;90695;46.5;27.7
07;2021-06-16;1023;1854;153099;92549;46.8;28.3
07;2021-06-17;885;1949;153984;94498;47.1;28.9
07;2021-06-18;868;2281;154852;96779;47.4;29.6
07;2021-06-19;603;1452;155455;98231;47.6;30.1
07;2021-06-20;369;729;155824;98960;47.7;30.3
07;2021-06-21;516;2143;156340;101103;47.8;30.9
07;2021-06-22;655;2661;156995;103764;48.0;31.7
07;2021-06-23;680;1960;157675;105724;48.2;32.3
07;2021-06-24;646;1849;158321;107573;48.4;32.9
07;2021-06-25;701;2175;159022;109748;48.6;33.6
07;2021-06-26;362;1430;159384;111178;48.8;34.0
07;2021-06-27;285;1073;159669;112251;48.8;34.3
07;2021-06-28;506;2241;160175;114492;49.0;35.0
07;2021-06-29;540;2986;160715;117478;49.2;35.9
07;2021-06-30;822;2279;161537;119757;49.4;36.6
07;2021-07-01;776;1951;162313;121708;49.7;37.2
07;2021-07-02;880;2294;163193;124002;49.9;37.9
07;2021-07-03;421;1137;163614;125139;50.1;38.3
07;2021-07-04;211;852;163825;125991;50.1;38.5
07;2021-07-05;670;1685;164495;127676;50.3;39.1
07;2021-07-06;880;2630;165375;130306;50.6;39.9
07;2021-07-07;969;1951;166344;132257;50.9;40.5
07;2021-07-08;928;1959;167272;134216;51.2;41.1
07;2021-07-09;994;2262;168266;136478;51.5;41.8
07;2021-07-10;598;1100;168864;137578;51.7;42.1
07;2021-07-11;239;614;169103;138192;51.7;42.3
07;2021-07-12;807;1769;169910;139961;52.0;42.8
07;2021-07-13;1770;3171;171680;143132;52.5;43.8
07;2021-07-14;167;133;171847;143265;52.6;43.8
07;2021-07-15;1960;2466;173807;145731;53.2;44.6
07;2021-07-16;2056;1987;175863;147718;53.8;45.2
07;2021-07-17;1484;1249;177347;148967;54.3;45.6
07;2021-07-18;771;480;178118;149447;54.5;45.7
07;2021-07-19;1515;1687;179633;151134;55.0;46.2
07;2021-07-20;2519;2679;182152;153813;55.7;47.1
07;2021-07-21;1856;1915;184008;155728;56.3;47.6
07;2021-07-22;1919;1375;185927;157103;56.9;48.1
07;2021-07-23;2266;1688;188193;158791;57.6;48.6
07;2021-07-24;1642;1112;189835;159903;58.1;48.9
07;2021-07-25;34;22;189869;159925;58.1;48.9
07;2021-07-26;2198;1541;192067;161466;58.8;49.4
07;2021-07-27;3016;1915;195083;163381;59.7;50.0
07;2021-07-28;1642;1308;196725;164689;60.2;50.4
07;2021-07-29;2541;1274;199266;165963;61.0;50.8
07;2021-07-30;1356;1415;200622;167378;61.4;51.2
07;2021-07-31;1506;922;202128;168300;61.8;51.5
07;2021-08-01;74;26;202202;168326;61.9;51.5
07;2021-08-02;1515;1133;203717;169459;62.3;51.8
07;2021-08-03;2417;1911;206134;171370;63.1;52.4
07;2021-08-04;1947;1032;208081;172402;63.7;52.7
07;2021-08-05;1893;1296;209974;173698;64.2;53.1
07;2021-08-06;2033;1709;212007;175407;64.9;53.7
07;2021-08-07;998;556;213005;175963;65.2;53.8
07;2021-08-08;12;23;213017;175986;65.2;53.8
07;2021-08-09;1258;1382;214275;177368;65.6;54.3
07;2021-08-10;1601;2259;215876;179627;66.0;55.0
07;2021-08-11;1400;1600;217276;181227;66.5;55.4
07;2021-08-12;1104;1485;218380;182712;66.8;55.9
07;2021-08-13;1182;1790;219562;184502;67.2;56.4
07;2021-08-14;512;766;220074;185268;67.3;56.7
07;2021-08-15;9;28;220083;185296;67.3;56.7
07;2021-08-16;754;1328;220837;186624;67.6;57.1
07;2021-08-17;1339;2278;222176;188902;68.0;57.8
07;2021-08-18;879;1516;223055;190418;68.2;58.3
07;2021-08-19;1148;1697;224203;192115;68.6;58.8
07;2021-08-20;899;2086;225102;194201;68.9;59.4
07;2021-08-21;364;549;225466;194750;69.0;59.6
07;2021-08-22;7;23;225473;194773;69.0;59.6
07;2021-08-23;467;1307;225940;196080;69.1;60.0
07;2021-08-24;1124;2312;227064;198392;69.5;60.7
07;2021-08-25;691;1837;227755;200229;69.7;61.3
07;2021-08-26;690;2021;228445;202250;69.9;61.9
07;2021-08-27;784;1830;229229;204080;70.1;62.4
07;2021-08-28;338;608;229567;204688;70.2;62.6
07;2021-08-29;1;33;229568;204721;70.2;62.6
07;2021-08-30;429;1326;229997;206047;70.4;63.0
07;2021-08-31;1093;2284;231090;208331;70.7;63.7
07;2021-09-01;543;1396;231633;209727;70.9;64.2
07;2021-09-02;603;1543;232236;211270;71.0;64.6
07;2021-09-03;740;1891;232976;213161;71.3;65.2
07;2021-09-04;308;716;233284;213877;71.4;65.4
07;2021-09-05;26;28;233310;213905;71.4;65.4
07;2021-09-06;403;1029;233713;214934;71.5;65.8
07;2021-09-07;521;1462;234234;216396;71.7;66.2
07;2021-09-08;442;1159;234676;217555;71.8;66.6
07;2021-09-09;476;1051;235152;218606;71.9;66.9
07;2021-09-10;518;1419;235670;220025;72.1;67.3
07;2021-09-11;167;660;235837;220685;72.1;67.5
07;2021-09-12;0;9;235837;220694;72.1;67.5
07;2021-09-13;347;617;236184;221311;72.3;67.7
07;2021-09-14;529;1126;236713;222437;72.4;68.0
07;2021-09-15;303;743;237016;223180;72.5;68.3
07;2021-09-16;426;566;237442;223746;72.6;68.5
07;2021-09-17;319;800;237761;224546;72.7;68.7
07;2021-09-18;100;454;237861;225000;72.8;68.8
07;2021-09-19;3;32;237864;225032;72.8;68.8
07;2021-09-20;238;365;238102;225397;72.8;69.0
07;2021-09-21;286;696;238388;226093;72.9;69.2
07;2021-09-22;173;725;238561;226818;73.0;69.4
07;2021-09-23;189;531;238750;227349;73.0;69.6
07;2021-09-24;277;838;239027;228187;73.1;69.8
07;2021-09-25;47;206;239074;228393;73.1;69.9
07;2021-09-26;6;17;239080;228410;73.1;69.9
07;2021-09-27;145;458;239225;228868;73.2;70.0
07;2021-09-28;178;522;239403;229390;73.2;70.2
07;2021-09-29;125;513;239528;229903;73.3;70.3
07;2021-09-30;174;451;239702;230354;73.3;70.5
07;2021-10-01;219;593;239921;230947;73.4;70.7
07;2021-10-02;76;137;239997;231084;73.4;70.7
07;2021-10-03;10;15;240007;231099;73.4;70.7
08;2020-12-27;1;0;1;0;0.0;0.0
08;2020-12-28;0;0;1;0;0.0;0.0
08;2020-12-29;0;0;1;0;0.0;0.0
08;2020-12-30;0;0;1;0;0.0;0.0
08;2020-12-31;0;0;1;0;0.0;0.0
08;2021-01-01;0;0;1;0;0.0;0.0
08;2021-01-02;0;0;1;0;0.0;0.0
08;2021-01-03;2;0;3;0;0.0;0.0
08;2021-01-04;24;0;27;0;0.0;0.0
08;2021-01-05;1;0;28;0;0.0;0.0
08;2021-01-06;0;0;28;0;0.0;0.0
08;2021-01-07;188;0;216;0;0.1;0.0
08;2021-01-08;315;0;531;0;0.2;0.0
08;2021-01-09;115;0;646;0;0.2;0.0
08;2021-01-10;1;0;647;0;0.2;0.0
08;2021-01-11;66;0;713;0;0.3;0.0
08;2021-01-12;157;0;870;0;0.3;0.0
08;2021-01-13;480;1;1350;1;0.5;0.0
08;2021-01-14;538;9;1888;10;0.7;0.0
08;2021-01-15;288;2;2176;12;0.8;0.0
08;2021-01-16;107;0;2283;12;0.9;0.0
08;2021-01-17;2;0;2285;12;0.9;0.0
08;2021-01-18;371;2;2656;14;1.0;0.0
08;2021-01-19;873;1;3529;15;1.3;0.0
08;2021-01-20;909;4;4438;19;1.7;0.0
08;2021-01-21;743;1;5181;20;2.0;0.0
08;2021-01-22;677;1;5858;21;2.2;0.0
08;2021-01-23;237;0;6095;21;2.3;0.0
08;2021-01-24;0;0;6095;21;2.3;0.0
08;2021-01-25;209;0;6304;21;2.4;0.0
08;2021-01-26;303;1;6607;22;2.5;0.0
08;2021-01-27;410;1;7017;23;2.6;0.0
08;2021-01-28;565;176;7582;199;2.9;0.1
08;2021-01-29;588;172;8170;371;3.1;0.1
08;2021-01-30;222;59;8392;430;3.2;0.2
08;2021-01-31;0;0;8392;430;3.2;0.2
08;2021-02-01;80;43;8472;473;3.2;0.2
08;2021-02-02;192;160;8664;633;3.3;0.2
08;2021-02-03;140;162;8804;795;3.3;0.3
08;2021-02-04;309;274;9113;1069;3.4;0.4
08;2021-02-05;499;341;9612;1410;3.6;0.5
08;2021-02-06;149;66;9761;1476;3.7;0.6
08;2021-02-07;8;0;9769;1476;3.7;0.6
08;2021-02-08;40;155;9809;1631;3.7;0.6
08;2021-02-09;221;605;10030;2236;3.8;0.8
08;2021-02-10;334;585;10364;2821;3.9;1.1
08;2021-02-11;466;320;10830;3141;4.1;1.2
08;2021-02-12;676;334;11506;3475;4.3;1.3
08;2021-02-13;140;91;11646;3566;4.4;1.3
08;2021-02-14;3;60;11649;3626;4.4;1.4
08;2021-02-15;227;166;11876;3792;4.5;1.4
08;2021-02-16;130;303;12006;4095;4.5;1.5
08;2021-02-17;112;314;12118;4409;4.6;1.7
08;2021-02-18;215;415;12333;4824;4.6;1.8
08;2021-02-19;305;336;12638;5160;4.8;1.9
08;2021-02-20;7;185;12645;5345;4.8;2.0
08;2021-02-21;0;0;12645;5345;4.8;2.0
08;2021-02-22;131;148;12776;5493;4.8;2.1
08;2021-02-23;150;260;12926;5753;4.9;2.2
08;2021-02-24;163;331;13089;6084;4.9;2.3
08;2021-02-25;500;439;13589;6523;5.1;2.5
08;2021-02-26;603;535;14192;7058;5.3;2.7
08;2021-02-27;318;174;14510;7232;5.5;2.7
08;2021-02-28;19;1;14529;7233;5.5;2.7
08;2021-03-01;200;90;14729;7323;5.5;2.8
08;2021-03-02;654;256;15383;7579;5.8;2.9
08;2021-03-03;899;183;16282;7762;6.1;2.9
08;2021-03-04;735;279;17017;8041;6.4;3.0
08;2021-03-05;1021;475;18038;8516;6.8;3.2
08;2021-03-06;695;137;18733;8653;7.1;3.3
08;2021-03-07;75;2;18808;8655;7.1;3.3
08;2021-03-08;217;122;19025;8777;7.2;3.3
08;2021-03-09;688;147;19713;8924;7.4;3.4
08;2021-03-10;1038;115;20751;9039;7.8;3.4
08;2021-03-11;982;233;21733;9272;8.2;3.5
08;2021-03-12;1631;504;23364;9776;8.8;3.7
08;2021-03-13;798;122;24162;9898;9.1;3.7
08;2021-03-14;22;0;24184;9898;9.1;3.7
08;2021-03-15;291;72;24475;9970;9.2;3.8
08;2021-03-16;563;38;25038;10008;9.4;3.8
08;2021-03-17;804;64;25842;10072;9.7;3.8
08;2021-03-18;816;157;26658;10229;10.0;3.9
08;2021-03-19;1135;278;27793;10507;10.5;4.0
08;2021-03-20;511;16;28304;10523;10.7;4.0
08;2021-03-21;13;1;28317;10524;10.7;4.0
08;2021-03-22;367;45;28684;10569;10.8;4.0
08;2021-03-23;733;63;29417;10632;11.1;4.0
08;2021-03-24;1327;70;30744;10702;11.6;4.0
08;2021-03-25;1906;97;32650;10799;12.3;4.1
08;2021-03-26;2571;171;35221;10970;13.3;4.1
08;2021-03-27;898;123;36119;11093;13.6;4.2
08;2021-03-28;228;7;36347;11100;13.7;4.2
08;2021-03-29;261;183;36608;11283;13.8;4.2
08;2021-03-30;832;482;37440;11765;14.1;4.4
08;2021-03-31;852;529;38292;12294;14.4;4.6
08;2021-04-01;1687;447;39979;12741;15.1;4.8
08;2021-04-02;1498;514;41477;13255;15.6;5.0
08;2021-04-03;1329;203;42806;13458;16.1;5.1
08;2021-04-04;134;4;42940;13462;16.2;5.1
08;2021-04-05;17;0;42957;13462;16.2;5.1
08;2021-04-06;702;481;43659;13943;16.4;5.3
08;2021-04-07;909;701;44568;14644;16.8;5.5
08;2021-04-08;1745;521;46313;15165;17.4;5.7
08;2021-04-09;2348;728;48661;15893;18.3;6.0
08;2021-04-10;1445;226;50106;16119;18.9;6.1
08;2021-04-11;10;6;50116;16125;18.9;6.1
08;2021-04-12;671;211;50787;16336;19.1;6.2
08;2021-04-13;1309;610;52096;16946;19.6;6.4
08;2021-04-14;1280;867;53376;17813;20.1;6.7
08;2021-04-15;1606;806;54982;18619;20.7;7.0
08;2021-04-16;1873;882;56855;19501;21.4;7.3
08;2021-04-17;1112;402;57967;19903;21.8;7.5
08;2021-04-18;23;14;57990;19917;21.8;7.5
08;2021-04-19;1151;298;59141;20215;22.3;7.6
08;2021-04-20;1120;543;60261;20758;22.7;7.8
08;2021-04-21;1139;745;61400;21503;23.1;8.1
08;2021-04-22;1326;879;62726;22382;23.6;8.4
08;2021-04-23;1675;1171;64401;23553;24.3;8.9
08;2021-04-24;1325;646;65726;24199;24.8;9.1
08;2021-04-25;26;198;65752;24397;24.8;9.2
08;2021-04-26;1040;156;66792;24553;25.2;9.2
08;2021-04-27;1338;592;68130;25145;25.7;9.5
08;2021-04-28;1453;665;69583;25810;26.2;9.7
08;2021-04-29;1173;1305;70756;27115;26.6;10.2
08;2021-04-30;1769;1606;72525;28721;27.3;10.8
08;2021-05-01;1049;494;73574;29215;27.7;11.0
08;2021-05-02;627;183;74201;29398;27.9;11.1
08;2021-05-03;1172;372;75373;29770;28.4;11.2
08;2021-05-04;1328;872;76701;30642;28.9;11.5
08;2021-05-05;1567;1335;78268;31977;29.5;12.0
08;2021-05-06;1971;1653;80239;33630;30.2;12.7
08;2021-05-07;1860;2097;82099;35727;30.9;13.5
08;2021-05-08;922;767;83021;36494;31.3;13.7
08;2021-05-09;443;71;83464;36565;31.4;13.8
08;2021-05-10;1192;657;84656;37222;31.9;14.0
08;2021-05-11;1907;942;86563;38164;32.6;14.4
08;2021-05-12;1809;1238;88372;39402;33.3;14.8
08;2021-05-13;1306;616;89678;40018;33.8;15.1
08;2021-05-14;2534;1036;92212;41054;34.7;15.5
08;2021-05-15;1820;711;94032;41765;35.4;15.7
08;2021-05-16;820;102;94852;41867;35.7;15.8
08;2021-05-17;700;906;95552;42773;36.0;16.1
08;2021-05-18;1250;838;96802;43611;36.5;16.4
08;2021-05-19;1611;960;98413;44571;37.1;16.8
08;2021-05-20;2147;956;100560;45527;37.9;17.1
08;2021-05-21;2339;1274;102899;46801;38.8;17.6
08;2021-05-22;1817;762;104716;47563;39.4;17.9
08;2021-05-23;864;90;105580;47653;39.8;17.9
08;2021-05-24;716;106;106296;47759;40.0;18.0
08;2021-05-25;1456;669;107752;48428;40.6;18.2
08;2021-05-26;1528;1008;109280;49436;41.2;18.6
08;2021-05-27;2005;1144;111285;50580;41.9;19.0
08;2021-05-28;1973;1812;113258;52392;42.7;19.7
08;2021-05-29;1767;960;115025;53352;43.3;20.1
08;2021-05-30;836;102;115861;53454;43.6;20.1
08;2021-05-31;755;570;116616;54024;43.9;20.3
08;2021-06-01;1350;876;117966;54900;44.4;20.7
08;2021-06-02;1295;1192;119261;56092;44.9;21.1
08;2021-06-03;1386;1521;120647;57613;45.4;21.7
08;2021-06-04;1777;2418;122424;60031;46.1;22.6
08;2021-06-05;1176;1380;123600;61411;46.5;23.1
08;2021-06-06;907;106;124507;61517;46.9;23.2
08;2021-06-07;661;1174;125168;62691;47.1;23.6
08;2021-06-08;931;1496;126099;64187;47.5;24.2
08;2021-06-09;840;1386;126939;65573;47.8;24.7
08;2021-06-10;1718;1562;128657;67135;48.5;25.3
08;2021-06-11;1721;2206;130378;69341;49.1;26.1
08;2021-06-12;1417;1526;131795;70867;49.6;26.7
08;2021-06-13;385;598;132180;71465;49.8;26.9
08;2021-06-14;380;1304;132560;72769;49.9;27.4
08;2021-06-15;742;1548;133302;74317;50.2;28.0
08;2021-06-16;808;2052;134110;76369;50.5;28.8
08;2021-06-17;1285;1850;135395;78219;51.0;29.5
08;2021-06-18;1610;2591;137005;80810;51.6;30.4
08;2021-06-19;1324;1405;138329;82215;52.1;31.0
08;2021-06-20;117;422;138446;82637;52.1;31.1
08;2021-06-21;494;1395;138940;84032;52.3;31.6
08;2021-06-22;812;2022;139752;86054;52.6;32.4
08;2021-06-23;859;1672;140611;87726;53.0;33.0
08;2021-06-24;1038;1923;141649;89649;53.3;33.8
08;2021-06-25;1084;2729;142733;92378;53.8;34.8
08;2021-06-26;1010;1784;143743;94162;54.1;35.5
08;2021-06-27;351;642;144094;94804;54.3;35.7
08;2021-06-28;397;1323;144491;96127;54.4;36.2
08;2021-06-29;627;1472;145118;97599;54.7;36.8
08;2021-06-30;857;1688;145975;99287;55.0;37.4
08;2021-07-01;887;2194;146862;101481;55.3;38.2
08;2021-07-02;939;2644;147801;104125;55.7;39.2
08;2021-07-03;784;2145;148585;106270;56.0;40.0
08;2021-07-04;128;861;148713;107131;56.0;40.3
08;2021-07-05;104;1195;148817;108326;56.0;40.8
08;2021-07-06;425;1834;149242;110160;56.2;41.5
08;2021-07-07;364;1781;149606;111941;56.3;42.2
08;2021-07-08;716;2016;150322;113957;56.6;42.9
08;2021-07-09;732;2432;151054;116389;56.9;43.8
08;2021-07-10;652;1998;151706;118387;57.1;44.6
08;2021-07-11;238;726;151944;119113;57.2;44.9
08;2021-07-12;312;1192;152256;120305;57.3;45.3
08;2021-07-13;947;1787;153203;122092;57.7;46.0
08;2021-07-14;179;329;153382;122421;57.8;46.1
08;2021-07-15;759;2448;154141;124869;58.1;47.0
08;2021-07-16;1084;2404;155225;127273;58.5;47.9
08;2021-07-17;993;2105;156218;129378;58.8;48.7
08;2021-07-18;346;741;156564;130119;59.0;49.0
08;2021-07-19;458;918;157022;131037;59.1;49.3
08;2021-07-20;878;1435;157900;132472;59.5;49.9
08;2021-07-21;1237;1716;159137;134188;59.9;50.5
08;2021-07-22;1150;2167;160287;136355;60.4;51.4
08;2021-07-23;1584;2442;161871;138797;61.0;52.3
08;2021-07-24;1309;1922;163180;140719;61.5;53.0
08;2021-07-25;774;445;163954;141164;61.7;53.2
08;2021-07-26;1323;844;165277;142008;62.2;53.5
08;2021-07-27;2186;1405;167463;143413;63.1;54.0
08;2021-07-28;2412;1453;169875;144866;64.0;54.6
08;2021-07-29;2601;1346;172476;146212;65.0;55.1
08;2021-07-30;2601;1587;175077;147799;65.9;55.7
08;2021-07-31;1972;1075;177049;148874;66.7;56.1
08;2021-08-01;935;301;177984;149175;67.0;56.2
08;2021-08-02;1255;682;179239;149857;67.5;56.4
08;2021-08-03;1635;822;180874;150679;68.1;56.7
08;2021-08-04;1493;665;182367;151344;68.7;57.0
08;2021-08-05;1905;977;184272;152321;69.4;57.4
08;2021-08-06;2589;1099;186861;153420;70.4;57.8
08;2021-08-07;1673;1161;188534;154581;71.0;58.2
08;2021-08-08;585;373;189119;154954;71.2;58.4
08;2021-08-09;672;534;189791;155488;71.5;58.6
08;2021-08-10;879;750;190670;156238;71.8;58.8
08;2021-08-11;523;791;191193;157029;72.0;59.1
08;2021-08-12;1161;1080;192354;158109;72.4;59.5
08;2021-08-13;1157;1013;193511;159122;72.9;59.9
08;2021-08-14;587;912;194098;160034;73.1;60.3
08;2021-08-15;137;273;194235;160307;73.1;60.4
08;2021-08-16;218;1177;194453;161484;73.2;60.8
08;2021-08-17;514;1210;194967;162694;73.4;61.3
08;2021-08-18;281;1263;195248;163957;73.5;61.7
08;2021-08-19;606;1888;195854;165845;73.8;62.5
08;2021-08-20;685;2178;196539;168023;74.0;63.3
08;2021-08-21;272;1340;196811;169363;74.1;63.8
08;2021-08-22;104;900;196915;170263;74.2;64.1
08;2021-08-23;160;1448;197075;171711;74.2;64.7
08;2021-08-24;364;1752;197439;173463;74.4;65.3
08;2021-08-25;322;1248;197761;174711;74.5;65.8
08;2021-08-26;502;2064;198263;176775;74.7;66.6
08;2021-08-27;450;2324;198713;179099;74.8;67.4
08;2021-08-28;262;1289;198975;180388;74.9;67.9
08;2021-08-29;169;563;199144;180951;75.0;68.1
08;2021-08-30;302;1170;199446;182121;75.1;68.6
08;2021-08-31;360;1284;199806;183405;75.2;69.1
08;2021-09-01;416;1353;200222;184758;75.4;69.6
08;2021-09-02;465;1297;200687;186055;75.6;70.1
08;2021-09-03;464;1695;201151;187750;75.8;70.7
08;2021-09-04;349;1468;201500;189218;75.9;71.3
08;2021-09-05;106;207;201606;189425;75.9;71.3
08;2021-09-06;196;516;201802;189941;76.0;71.5
08;2021-09-07;205;612;202007;190553;76.1;71.8
08;2021-09-08;280;598;202287;191151;76.2;72.0
08;2021-09-09;344;744;202631;191895;76.3;72.3
08;2021-09-10;494;1030;203125;192925;76.5;72.7
08;2021-09-11;383;853;203508;193778;76.6;73.0
08;2021-09-12;52;91;203560;193869;76.7;73.0
08;2021-09-13;381;255;203941;194124;76.8;73.1
08;2021-09-14;247;400;204188;194524;76.9;73.3
08;2021-09-15;219;316;204407;194840;77.0;73.4
08;2021-09-16;230;422;204637;195262;77.1;73.5
08;2021-09-17;320;500;204957;195762;77.2;73.7
08;2021-09-18;173;430;205130;196192;77.3;73.9
08;2021-09-19;29;90;205159;196282;77.3;73.9
08;2021-09-20;54;235;205213;196517;77.3;74.0
08;2021-09-21;123;277;205336;196794;77.3;74.1
08;2021-09-22;130;368;205466;197162;77.4;74.3
08;2021-09-23;174;412;205640;197574;77.4;74.4
08;2021-09-24;162;516;205802;198090;77.5;74.6
08;2021-09-25;122;414;205924;198504;77.6;74.8
08;2021-09-26;23;105;205947;198609;77.6;74.8
08;2021-09-27;48;211;205995;198820;77.6;74.9
08;2021-09-28;80;226;206075;199046;77.6;75.0
08;2021-09-29;116;339;206191;199385;77.7;75.1
08;2021-09-30;146;376;206337;199761;77.7;75.2
08;2021-10-01;161;465;206498;200226;77.8;75.4
08;2021-10-02;139;284;206637;200510;77.8;75.5
08;2021-10-03;24;67;206661;200577;77.8;75.5
09;2020-12-27;0;0;0;0;0.0;0.0
09;2020-12-28;1;0;1;0;0.0;0.0
09;2020-12-29;0;0;1;0;0.0;0.0
09;2020-12-30;0;0;1;0;0.0;0.0
09;2020-12-31;0;0;1;0;0.0;0.0
09;2021-01-01;0;0;1;0;0.0;0.0
09;2021-01-02;0;0;1;0;0.0;0.0
09;2021-01-03;0;0;1;0;0.0;0.0
09;2021-01-04;2;1;3;1;0.0;0.0
09;2021-01-05;0;0;3;1;0.0;0.0
09;2021-01-06;3;0;6;1;0.0;0.0
09;2021-01-07;257;2;263;3;0.2;0.0
09;2021-01-08;228;0;491;3;0.3;0.0
09;2021-01-09;103;0;594;3;0.4;0.0
09;2021-01-10;59;0;653;3;0.4;0.0
09;2021-01-11;175;0;828;3;0.5;0.0
09;2021-01-12;303;0;1131;3;0.7;0.0
09;2021-01-13;196;0;1327;3;0.9;0.0
09;2021-01-14;432;7;1759;10;1.2;0.0
09;2021-01-15;223;1;1982;11;1.3;0.0
09;2021-01-16;192;2;2174;13;1.4;0.0
09;2021-01-17;123;0;2297;13;1.5;0.0
09;2021-01-18;263;2;2560;15;1.7;0.0
09;2021-01-19;255;1;2815;16;1.8;0.0
09;2021-01-20;346;1;3161;17;2.1;0.0
09;2021-01-21;330;1;3491;18;2.3;0.0
09;2021-01-22;328;1;3819;19;2.5;0.0
09;2021-01-23;237;0;4056;19;2.7;0.0
09;2021-01-24;85;1;4141;20;2.7;0.0
09;2021-01-25;207;10;4348;30;2.9;0.0
09;2021-01-26;630;25;4978;55;3.3;0.0
09;2021-01-27;472;45;5450;100;3.6;0.1
09;2021-01-28;286;140;5736;240;3.8;0.2
09;2021-01-29;251;121;5987;361;3.9;0.2
09;2021-01-30;143;50;6130;411;4.0;0.3
09;2021-01-31;56;10;6186;421;4.1;0.3
09;2021-02-01;81;128;6267;549;4.1;0.4
09;2021-02-02;58;276;6325;825;4.2;0.5
09;2021-02-03;87;187;6412;1012;4.2;0.7
09;2021-02-04;49;260;6461;1272;4.2;0.8
09;2021-02-05;90;117;6551;1389;4.3;0.9
09;2021-02-06;68;31;6619;1420;4.3;0.9
09;2021-02-07;6;48;6625;1468;4.3;1.0
09;2021-02-08;22;139;6647;1607;4.4;1.1
09;2021-02-09;55;215;6702;1822;4.4;1.2
09;2021-02-10;14;121;6716;1943;4.4;1.3
09;2021-02-11;6;156;6722;2099;4.4;1.4
09;2021-02-12;147;100;6869;2199;4.5;1.4
09;2021-02-13;8;117;6877;2316;4.5;1.5
09;2021-02-14;0;35;6877;2351;4.5;1.5
09;2021-02-15;76;105;6953;2456;4.6;1.6
09;2021-02-16;227;424;7180;2880;4.7;1.9
09;2021-02-17;83;317;7263;3197;4.8;2.1
09;2021-02-18;87;351;7350;3548;4.8;2.3
09;2021-02-19;63;188;7413;3736;4.9;2.5
09;2021-02-20;58;143;7471;3879;4.9;2.5
09;2021-02-21;0;37;7471;3916;4.9;2.6
09;2021-02-22;127;165;7598;4081;5.0;2.7
09;2021-02-23;161;102;7759;4183;5.1;2.7
09;2021-02-24;74;141;7833;4324;5.1;2.8
09;2021-02-25;211;143;8044;4467;5.3;2.9
09;2021-02-26;162;140;8206;4607;5.4;3.0
09;2021-02-27;65;45;8271;4652;5.4;3.1
09;2021-02-28;44;13;8315;4665;5.5;3.1
09;2021-03-01;248;83;8563;4748;5.6;3.1
09;2021-03-02;282;63;8845;4811;5.8;3.2
09;2021-03-03;252;120;9097;4931;6.0;3.2
09;2021-03-04;414;29;9511;4960;6.2;3.3
09;2021-03-05;331;48;9842;5008;6.5;3.3
09;2021-03-06;397;41;10239;5049;6.7;3.3
09;2021-03-07;124;4;10363;5053;6.8;3.3
09;2021-03-08;380;60;10743;5113;7.0;3.4
09;2021-03-09;437;130;11180;5243;7.3;3.4
09;2021-03-10;562;71;11742;5314;7.7;3.5
09;2021-03-11;695;77;12437;5391;8.2;3.5
09;2021-03-12;660;31;13097;5422;8.6;3.6
09;2021-03-13;384;3;13481;5425;8.8;3.6
09;2021-03-14;120;4;13601;5429;8.9;3.6
09;2021-03-15;465;50;14066;5479;9.2;3.6
09;2021-03-16;370;77;14436;5556;9.5;3.6
09;2021-03-17;399;71;14835;5627;9.7;3.7
09;2021-03-18;454;42;15289;5669;10.0;3.7
09;2021-03-19;525;56;15814;5725;10.4;3.8
09;2021-03-20;314;39;16128;5764;10.6;3.8
09;2021-03-21;105;0;16233;5764;10.7;3.8
09;2021-03-22;424;117;16657;5881;10.9;3.9
09;2021-03-23;566;164;17223;6045;11.3;4.0
09;2021-03-24;710;43;17933;6088;11.8;4.0
09;2021-03-25;869;134;18802;6222;12.3;4.1
09;2021-03-26;751;47;19553;6269;12.8;4.1
09;2021-03-27;620;70;20173;6339;13.2;4.2
09;2021-03-28;132;24;20305;6363;13.3;4.2
09;2021-03-29;498;273;20803;6636;13.7;4.4
09;2021-03-30;729;153;21532;6789;14.1;4.5
09;2021-03-31;803;182;22335;6971;14.7;4.6
09;2021-04-01;734;253;23069;7224;15.1;4.7
09;2021-04-02;693;264;23762;7488;15.6;4.9
09;2021-04-03;772;117;24534;7605;16.1;5.0
09;2021-04-04;122;57;24656;7662;16.2;5.0
09;2021-04-05;237;61;24893;7723;16.3;5.1
09;2021-04-06;1059;390;25952;8113;17.0;5.3
09;2021-04-07;1207;360;27159;8473;17.8;5.6
09;2021-04-08;1470;409;28629;8882;18.8;5.8
09;2021-04-09;1137;417;29766;9299;19.5;6.1
09;2021-04-10;1349;196;31115;9495;20.4;6.2
09;2021-04-11;173;101;31288;9596;20.5;6.3
09;2021-04-12;737;345;32025;9941;21.0;6.5
09;2021-04-13;1047;413;33072;10354;21.7;6.8
09;2021-04-14;1332;510;34404;10864;22.6;7.1
09;2021-04-15;1148;502;35552;11366;23.3;7.5
09;2021-04-16;1032;405;36584;11771;24.0;7.7
09;2021-04-17;1192;356;37776;12127;24.8;8.0
09;2021-04-18;102;96;37878;12223;24.9;8.0
09;2021-04-19;697;407;38575;12630;25.3;8.3
09;2021-04-20;766;528;39341;13158;25.8;8.6
09;2021-04-21;938;587;40279;13745;26.4;9.0
09;2021-04-22;666;605;40945;14350;26.9;9.4
09;2021-04-23;773;431;41718;14781;27.4;9.7
09;2021-04-24;741;669;42459;15450;27.9;10.1
09;2021-04-25;75;112;42534;15562;27.9;10.2
09;2021-04-26;382;529;42916;16091;28.2;10.6
09;2021-04-27;444;719;43360;16810;28.5;11.0
09;2021-04-28;806;794;44166;17604;29.0;11.6
09;2021-04-29;550;776;44716;18380;29.3;12.1
09;2021-04-30;622;722;45338;19102;29.7;12.5
09;2021-05-01;478;455;45816;19557;30.1;12.8
09;2021-05-02;51;100;45867;19657;30.1;12.9
09;2021-05-03;521;662;46388;20319;30.4;13.3
09;2021-05-04;554;1347;46942;21666;30.8;14.2
09;2021-05-05;822;1348;47764;23014;31.3;15.1
09;2021-05-06;848;1031;48612;24045;31.9;15.8
09;2021-05-07;977;822;49589;24867;32.5;16.3
09;2021-05-08;395;461;49984;25328;32.8;16.6
09;2021-05-09;265;85;50249;25413;33.0;16.7
09;2021-05-10;504;966;50753;26379;33.3;17.3
09;2021-05-11;741;1052;51494;27431;33.8;18.0
09;2021-05-12;1535;1401;53029;28832;34.8;18.9
09;2021-05-13;1383;425;54412;29257;35.7;19.2
09;2021-05-14;987;653;55399;29910;36.4;19.6
09;2021-05-15;1236;789;56635;30699;37.2;20.1
09;2021-05-16;296;48;56931;30747;37.4;20.2
09;2021-05-17;873;412;57804;31159;37.9;20.4
09;2021-05-18;1290;395;59094;31554;38.8;20.7
09;2021-05-19;1495;371;60589;31925;39.8;20.9
09;2021-05-20;1379;404;61968;32329;40.7;21.2
09;2021-05-21;1162;495;63130;32824;41.4;21.5
09;2021-05-22;1544;364;64674;33188;42.4;21.8
09;2021-05-23;272;24;64946;33212;42.6;21.8
09;2021-05-24;177;100;65123;33312;42.7;21.9
09;2021-05-25;998;500;66121;33812;43.4;22.2
09;2021-05-26;1285;448;67406;34260;44.2;22.5
09;2021-05-27;965;403;68371;34663;44.9;22.7
09;2021-05-28;958;511;69329;35174;45.5;23.1
09;2021-05-29;1794;601;71123;35775;46.7;23.5
09;2021-05-30;541;197;71664;35972;47.0;23.6
09;2021-05-31;716;592;72380;36564;47.5;24.0
09;2021-06-01;970;639;73350;37203;48.1;24.4
09;2021-06-02;1009;897;74359;38100;48.8;25.0
09;2021-06-03;809;681;75168;38781;49.3;25.4
09;2021-06-04;877;797;76045;39578;49.9;26.0
09;2021-06-05;1320;875;77365;40453;50.8;26.5
09;2021-06-06;304;108;77669;40561;51.0;26.6
09;2021-06-07;623;517;78292;41078;51.4;27.0
09;2021-06-08;821;488;79113;41566;51.9;27.3
09;2021-06-09;805;834;79918;42400;52.4;27.8
09;2021-06-10;642;534;80560;42934;52.9;28.2
09;2021-06-11;831;762;81391;43696;53.4;28.7
09;2021-06-12;635;808;82026;44504;53.8;29.2
09;2021-06-13;94;130;82120;44634;53.9;29.3
09;2021-06-14;628;708;82748;45342;54.3;29.8
09;2021-06-15;824;889;83572;46231;54.8;30.3
09;2021-06-16;627;1079;84199;47310;55.2;31.0
09;2021-06-17;779;852;84978;48162;55.8;31.6
09;2021-06-18;635;1145;85613;49307;56.2;32.4
09;2021-06-19;516;1580;86129;50887;56.5;33.4
09;2021-06-20;8;279;86137;51166;56.5;33.6
09;2021-06-21;473;698;86610;51864;56.8;34.0
09;2021-06-22;463;1066;87073;52930;57.1;34.7
09;2021-06-23;435;1224;87508;54154;57.4;35.5
09;2021-06-24;581;769;88089;54923;57.8;36.0
09;2021-06-25;410;1064;88499;55987;58.1;36.7
09;2021-06-26;443;1087;88942;57074;58.4;37.5
09;2021-06-27;2;275;88944;57349;58.4;37.6
09;2021-06-28;239;1046;89183;58395;58.5;38.3
09;2021-06-29;314;1228;89497;59623;58.7;39.1
09;2021-06-30;455;1491;89952;61114;59.0;40.1
09;2021-07-01;384;1428;90336;62542;59.3;41.0
09;2021-07-02;308;1162;90644;63704;59.5;41.8
09;2021-07-03;210;1617;90854;65321;59.6;42.9
09;2021-07-04;4;253;90858;65574;59.6;43.0
09;2021-07-05;189;712;91047;66286;59.7;43.5
09;2021-07-06;293;1221;91340;67507;59.9;44.3
09;2021-07-07;419;1399;91759;68906;60.2;45.2
09;2021-07-08;325;1057;92084;69963;60.4;45.9
09;2021-07-09;292;1153;92376;71116;60.6;46.7
09;2021-07-10;345;1725;92721;72841;60.8;47.8
09;2021-07-11;147;392;92868;73233;60.9;48.1
09;2021-07-12;187;1074;93055;74307;61.1;48.8
09;2021-07-13;641;1308;93696;75615;61.5;49.6
09;2021-07-14;490;220;94186;75835;61.8;49.8
09;2021-07-15;818;1165;95004;77000;62.3;50.5
09;2021-07-16;610;1189;95614;78189;62.7;51.3
09;2021-07-17;1015;1444;96629;79633;63.4;52.3
09;2021-07-18;302;221;96931;79854;63.6;52.4
09;2021-07-19;483;973;97414;80827;63.9;53.0
09;2021-07-20;830;1256;98244;82083;64.5;53.9
09;2021-07-21;1016;1165;99260;83248;65.1;54.6
09;2021-07-22;846;910;100106;84158;65.7;55.2
09;2021-07-23;724;910;100830;85068;66.2;55.8
09;2021-07-24;927;463;101757;85531;66.8;56.1
09;2021-07-25;560;134;102317;85665;67.1;56.2
09;2021-07-26;647;765;102964;86430;67.6;56.7
09;2021-07-27;1177;949;104141;87379;68.3;57.3
09;2021-07-28;1197;987;105338;88366;69.1;58.0
09;2021-07-29;1042;738;106380;89104;69.8;58.5
09;2021-07-30;779;623;107159;89727;70.3;58.9
09;2021-07-31;1378;419;108537;90146;71.2;59.2
09;2021-08-01;141;125;108678;90271;71.3;59.2
09;2021-08-02;614;478;109292;90749;71.7;59.5
09;2021-08-03;1254;767;110546;91516;72.5;60.1
09;2021-08-04;1400;654;111946;92170;73.5;60.5
09;2021-08-05;997;677;112943;92847;74.1;60.9
09;2021-08-06;1017;641;113960;93488;74.8;61.3
09;2021-08-07;825;430;114785;93918;75.3;61.6
09;2021-08-08;129;131;114914;94049;75.4;61.7
09;2021-08-09;690;648;115604;94697;75.9;62.1
09;2021-08-10;940;694;116544;95391;76.5;62.6
09;2021-08-11;896;866;117440;96257;77.1;63.2
09;2021-08-12;631;730;118071;96987;77.5;63.6
09;2021-08-13;465;645;118536;97632;77.8;64.1
09;2021-08-14;311;828;118847;98460;78.0;64.6
09;2021-08-15;67;138;118914;98598;78.0;64.7
09;2021-08-16;547;620;119461;99218;78.4;65.1
09;2021-08-17;674;777;120135;99995;78.8;65.6
09;2021-08-18;620;931;120755;100926;79.2;66.2
09;2021-08-19;432;722;121187;101648;79.5;66.7
09;2021-08-20;363;749;121550;102397;79.8;67.2
09;2021-08-21;343;1384;121893;103781;80.0;68.1
09;2021-08-22;67;168;121960;103949;80.0;68.2
09;2021-08-23;341;758;122301;104707;80.3;68.7
09;2021-08-24;407;955;122708;105662;80.5;69.3
09;2021-08-25;283;1003;122991;106665;80.7;70.0
09;2021-08-26;316;928;123307;107593;80.9;70.6
09;2021-08-27;226;740;123533;108333;81.1;71.1
09;2021-08-28;257;970;123790;109303;81.2;71.7
09;2021-08-29;15;144;123805;109447;81.2;71.8
09;2021-08-30;275;749;124080;110196;81.4;72.3
09;2021-08-31;314;1150;124394;111346;81.6;73.1
09;2021-09-01;360;977;124754;112323;81.9;73.7
09;2021-09-02;159;605;124913;112928;82.0;74.1
09;2021-09-03;221;879;125134;113807;82.1;74.7
09;2021-09-04;166;539;125300;114346;82.2;75.0
09;2021-09-05;25;104;125325;114450;82.2;75.1
09;2021-09-06;182;651;125507;115101;82.4;75.5
09;2021-09-07;156;694;125663;115795;82.5;76.0
09;2021-09-08;203;920;125866;116715;82.6;76.6
09;2021-09-09;160;557;126026;117272;82.7;77.0
09;2021-09-10;130;475;126156;117747;82.8;77.3
09;2021-09-11;175;506;126331;118253;82.9;77.6
09;2021-09-12;27;80;126358;118333;82.9;77.6
09;2021-09-13;129;524;126487;118857;83.0;78.0
09;2021-09-14;142;689;126629;119546;83.1;78.4
09;2021-09-15;188;602;126817;120148;83.2;78.8
09;2021-09-16;130;324;126947;120472;83.3;79.1
09;2021-09-17;146;404;127093;120876;83.4;79.3
09;2021-09-18;158;345;127251;121221;83.5;79.5
09;2021-09-19;2;0;127253;121221;83.5;79.5
09;2021-09-20;71;290;127324;121511;83.5;79.7
09;2021-09-21;101;205;127425;121716;83.6;79.9
09;2021-09-22;141;471;127566;122187;83.7;80.2
09;2021-09-23;71;164;127637;122351;83.8;80.3
09;2021-09-24;117;289;127754;122640;83.8;80.5
09;2021-09-25;60;193;127814;122833;83.9;80.6
09;2021-09-26;0;17;127814;122850;83.9;80.6
09;2021-09-27;82;326;127896;123176;83.9;80.8
09;2021-09-28;74;175;127970;123351;84.0;80.9
09;2021-09-29;97;235;128067;123586;84.0;81.1
09;2021-09-30;43;118;128110;123704;84.1;81.2
09;2021-10-01;81;125;128191;123829;84.1;81.3
09;2021-10-02;83;230;128274;124059;84.2;81.4
09;2021-10-03;2;8;128276;124067;84.2;81.4
10;2020-12-27;0;0;0;0;0.0;0.0
10;2020-12-28;0;0;0;0;0.0;0.0
10;2020-12-29;0;0;0;0;0.0;0.0
10;2020-12-30;0;0;0;0;0.0;0.0
10;2020-12-31;0;0;0;0;0.0;0.0
10;2021-01-01;0;0;0;0;0.0;0.0
10;2021-01-02;1;0;1;0;0.0;0.0
10;2021-01-03;0;0;1;0;0.0;0.0
10;2021-01-04;0;0;1;0;0.0;0.0
10;2021-01-05;1;0;2;0;0.0;0.0
10;2021-01-06;0;0;2;0;0.0;0.0
10;2021-01-07;84;0;86;0;0.0;0.0
10;2021-01-08;255;0;341;0;0.1;0.0
10;2021-01-09;0;0;341;0;0.1;0.0
10;2021-01-10;1;0;342;0;0.1;0.0
10;2021-01-11;118;0;460;0;0.1;0.0
10;2021-01-12;195;0;655;0;0.2;0.0
10;2021-01-13;314;0;969;0;0.3;0.0
10;2021-01-14;392;8;1361;8;0.4;0.0
10;2021-01-15;359;3;1720;11;0.6;0.0
10;2021-01-16;56;0;1776;11;0.6;0.0
10;2021-01-17;0;0;1776;11;0.6;0.0
10;2021-01-18;702;0;2478;11;0.8;0.0
10;2021-01-19;1391;2;3869;13;1.2;0.0
10;2021-01-20;1086;7;4955;20;1.6;0.0
10;2021-01-21;1152;2;6107;22;2.0;0.0
10;2021-01-22;818;2;6925;24;2.2;0.0
10;2021-01-23;309;0;7234;24;2.3;0.0
10;2021-01-24;0;0;7234;24;2.3;0.0
10;2021-01-25;445;8;7679;32;2.5;0.0
10;2021-01-26;487;17;8166;49;2.6;0.0
10;2021-01-27;458;14;8624;63;2.8;0.0
10;2021-01-28;358;38;8982;101;2.9;0.0
10;2021-01-29;430;132;9412;233;3.0;0.1
10;2021-01-30;30;0;9442;233;3.0;0.1
10;2021-01-31;0;0;9442;233;3.0;0.1
10;2021-02-01;409;118;9851;351;3.2;0.1
10;2021-02-02;182;133;10033;484;3.2;0.2
10;2021-02-03;361;211;10394;695;3.4;0.2
10;2021-02-04;342;233;10736;928;3.5;0.3
10;2021-02-05;328;264;11064;1192;3.6;0.4
10;2021-02-06;3;35;11067;1227;3.6;0.4
10;2021-02-07;0;0;11067;1227;3.6;0.4
10;2021-02-08;190;310;11257;1537;3.6;0.5
10;2021-02-09;485;442;11742;1979;3.8;0.6
10;2021-02-10;667;455;12409;2434;4.0;0.8
10;2021-02-11;781;572;13190;3006;4.3;1.0
10;2021-02-12;580;516;13770;3522;4.4;1.1
10;2021-02-13;37;93;13807;3615;4.5;1.2
10;2021-02-14;0;0;13807;3615;4.5;1.2
10;2021-02-15;143;298;13950;3913;4.5;1.3
10;2021-02-16;116;411;14066;4324;4.5;1.4
10;2021-02-17;129;467;14195;4791;4.6;1.5
10;2021-02-18;217;413;14412;5204;4.7;1.7
10;2021-02-19;188;389;14600;5593;4.7;1.8
10;2021-02-20;24;151;14624;5744;4.7;1.9
10;2021-02-21;0;0;14624;5744;4.7;1.9
10;2021-02-22;77;343;14701;6087;4.7;2.0
10;2021-02-23;76;452;14777;6539;4.8;2.1
10;2021-02-24;114;305;14891;6844;4.8;2.2
10;2021-02-25;322;317;15213;7161;4.9;2.3
10;2021-02-26;351;257;15564;7418;5.0;2.4
10;2021-02-27;275;109;15839;7527;5.1;2.4
10;2021-02-28;0;0;15839;7527;5.1;2.4
10;2021-03-01;257;281;16096;7808;5.2;2.5
10;2021-03-02;435;322;16531;8130;5.3;2.6
10;2021-03-03;454;518;16985;8648;5.5;2.8
10;2021-03-04;636;462;17621;9110;5.7;2.9
10;2021-03-05;677;228;18298;9338;5.9;3.0
10;2021-03-06;950;42;19248;9380;6.2;3.0
10;2021-03-07;769;6;20017;9386;6.5;3.0
10;2021-03-08;502;398;20519;9784;6.6;3.2
10;2021-03-09;673;378;21192;10162;6.8;3.3
10;2021-03-10;661;333;21853;10495;7.1;3.4
10;2021-03-11;1174;224;23027;10719;7.4;3.5
10;2021-03-12;1338;231;24365;10950;7.9;3.5
10;2021-03-13;891;38;25256;10988;8.1;3.5
10;2021-03-14;1381;15;26637;11003;8.6;3.6
10;2021-03-15;821;77;27458;11080;8.9;3.6
10;2021-03-16;688;61;28146;11141;9.1;3.6
10;2021-03-17;831;68;28977;11209;9.4;3.6
10;2021-03-18;885;80;29862;11289;9.6;3.6
10;2021-03-19;952;64;30814;11353;9.9;3.7
10;2021-03-20;552;19;31366;11372;10.1;3.7
10;2021-03-21;1849;42;33215;11414;10.7;3.7
10;2021-03-22;879;74;34094;11488;11.0;3.7
10;2021-03-23;1244;89;35338;11577;11.4;3.7
10;2021-03-24;1311;58;36649;11635;11.8;3.8
10;2021-03-25;1676;227;38325;11862;12.4;3.8
10;2021-03-26;1432;115;39757;11977;12.8;3.9
10;2021-03-27;762;78;40519;12055;13.1;3.9
10;2021-03-28;1221;31;41740;12086;13.5;3.9
10;2021-03-29;648;303;42388;12389;13.7;4.0
10;2021-03-30;927;374;43315;12763;14.0;4.1
10;2021-03-31;617;358;43932;13121;14.2;4.2
10;2021-04-01;883;683;44815;13804;14.5;4.5
10;2021-04-02;1069;587;45884;14391;14.8;4.6
10;2021-04-03;540;603;46424;14994;15.0;4.8
10;2021-04-04;1826;263;48250;15257;15.6;4.9
10;2021-04-05;1843;43;50093;15300;16.2;4.9
10;2021-04-06;514;650;50607;15950;16.3;5.1
10;2021-04-07;592;540;51199;16490;16.5;5.3
10;2021-04-08;1060;606;52259;17096;16.9;5.5
10;2021-04-09;1130;612;53389;17708;17.2;5.7
10;2021-04-10;1769;350;55158;18058;17.8;5.8
10;2021-04-11;55;1220;55213;19278;17.8;6.2
10;2021-04-12;1001;807;56214;20085;18.1;6.5
10;2021-04-13;1506;894;57720;20979;18.6;6.8
10;2021-04-14;824;601;58544;21580;18.9;7.0
10;2021-04-15;1454;891;59998;22471;19.4;7.3
10;2021-04-16;1109;697;61107;23168;19.7;7.5
10;2021-04-17;2391;362;63498;23530;20.5;7.6
10;2021-04-18;1422;1785;64920;25315;20.9;8.2
10;2021-04-19;837;833;65757;26148;21.2;8.4
10;2021-04-20;546;1034;66303;27182;21.4;8.8
10;2021-04-21;636;973;66939;28155;21.6;9.1
10;2021-04-22;932;963;67871;29118;21.9;9.4
10;2021-04-23;2172;777;70043;29895;22.6;9.6
10;2021-04-24;2296;376;72339;30271;23.3;9.8
10;2021-04-25;1991;1214;74330;31485;24.0;10.2
10;2021-04-26;773;620;75103;32105;24.2;10.4
10;2021-04-27;895;536;75998;32641;24.5;10.5
10;2021-04-28;873;405;76871;33046;24.8;10.7
10;2021-04-29;1433;669;78304;33715;25.3;10.9
10;2021-04-30;2172;769;80476;34484;26.0;11.1
10;2021-05-01;1988;2167;82464;36651;26.6;11.8
10;2021-05-02;1948;1897;84412;38548;27.2;12.4
10;2021-05-03;622;447;85034;38995;27.4;12.6
10;2021-05-04;1144;1247;86178;40242;27.8;13.0
10;2021-05-05;1753;1021;87931;41263;28.4;13.3
10;2021-05-06;2257;948;90188;42211;29.1;13.6
10;2021-05-07;2218;1134;92406;43345;29.8;14.0
10;2021-05-08;2270;858;94676;44203;30.5;14.3
10;2021-05-09;2004;100;96680;44303;31.2;14.3
10;2021-05-10;531;1092;97211;45395;31.4;14.6
10;2021-05-11;1052;1027;98263;46422;31.7;15.0
10;2021-05-12;2062;883;100325;47305;32.4;15.3
10;2021-05-13;2181;435;102506;47740;33.1;15.4
10;2021-05-14;2728;673;105234;48413;34.0;15.6
10;2021-05-15;2423;2051;107657;50464;34.7;16.3
10;2021-05-16;2080;1448;109737;51912;35.4;16.8
10;2021-05-17;1451;442;111188;52354;35.9;16.9
10;2021-05-18;2510;640;113698;52994;36.7;17.1
10;2021-05-19;1554;639;115252;53633;37.2;17.3
10;2021-05-20;1892;847;117144;54480;37.8;17.6
10;2021-05-21;2318;618;119462;55098;38.5;17.8
10;2021-05-22;2179;421;121641;55519;39.3;17.9
10;2021-05-23;1816;138;123457;55657;39.8;18.0
10;2021-05-24;1968;177;125425;55834;40.5;18.0
10;2021-05-25;2195;491;127620;56325;41.2;18.2
10;2021-05-26;1679;419;129299;56744;41.7;18.3
10;2021-05-27;1659;752;130958;57496;42.3;18.6
10;2021-05-28;1720;1181;132678;58677;42.8;18.9
10;2021-05-29;2170;643;134848;59320;43.5;19.1
10;2021-05-30;1029;134;135877;59454;43.8;19.2
10;2021-05-31;1039;741;136916;60195;44.2;19.4
10;2021-06-01;1135;885;138051;61080;44.5;19.7
10;2021-06-02;1035;720;139086;61800;44.9;19.9
10;2021-06-03;1473;1066;140559;62866;45.4;20.3
10;2021-06-04;1768;2598;142327;65464;45.9;21.1
10;2021-06-05;1518;2450;143845;67914;46.4;21.9
10;2021-06-06;1005;1874;144850;69788;46.7;22.5
10;2021-06-07;700;1110;145550;70898;47.0;22.9
10;2021-06-08;896;1172;146446;72070;47.3;23.3
10;2021-06-09;880;911;147326;72981;47.5;23.5
10;2021-06-10;678;1070;148004;74051;47.8;23.9
10;2021-06-11;1199;2197;149203;76248;48.1;24.6
10;2021-06-12;856;2388;150059;78636;48.4;25.4
10;2021-06-13;401;1834;150460;80470;48.6;26.0
10;2021-06-14;538;742;150998;81212;48.7;26.2
10;2021-06-15;741;2130;151739;83342;49.0;26.9
10;2021-06-16;741;1858;152480;85200;49.2;27.5
10;2021-06-17;851;2457;153331;87657;49.5;28.3
10;2021-06-18;1030;2473;154361;90130;49.8;29.1
10;2021-06-19;981;2595;155342;92725;50.1;29.9
10;2021-06-20;549;1597;155891;94322;50.3;30.4
10;2021-06-21;684;1044;156575;95366;50.5;30.8
10;2021-06-22;745;1526;157320;96892;50.8;31.3
10;2021-06-23;653;2405;157973;99297;51.0;32.0
10;2021-06-24;786;2617;158759;101914;51.2;32.9
10;2021-06-25;730;3047;159489;104961;51.5;33.9
10;2021-06-26;514;2745;160003;107706;51.6;34.8
10;2021-06-27;402;1940;160405;109646;51.8;35.4
10;2021-06-28;683;1784;161088;111430;52.0;36.0
10;2021-06-29;616;2698;161704;114128;52.2;36.8
10;2021-06-30;534;1523;162238;115651;52.4;37.3
10;2021-07-01;555;2172;162793;117823;52.5;38.0
10;2021-07-02;664;2726;163457;120549;52.7;38.9
10;2021-07-03;529;2600;163986;123149;52.9;39.7
10;2021-07-04;411;1726;164397;124875;53.0;40.3
10;2021-07-05;667;2224;165064;127099;53.3;41.0
10;2021-07-06;651;2188;165715;129287;53.5;41.7
10;2021-07-07;639;1703;166354;130990;53.7;42.3
10;2021-07-08;751;1458;167105;132448;53.9;42.7
10;2021-07-09;820;1949;167925;134397;54.2;43.4
10;2021-07-10;632;2096;168557;136493;54.4;44.0
10;2021-07-11;500;1384;169057;137877;54.6;44.5
10;2021-07-12;783;1620;169840;139497;54.8;45.0
10;2021-07-13;1126;1874;170966;141371;55.2;45.6
10;2021-07-14;1169;1054;172135;142425;55.5;46.0
10;2021-07-15;1477;1980;173612;144405;56.0;46.6
10;2021-07-16;1241;2274;174853;146679;56.4;47.3
10;2021-07-17;1287;1738;176140;148417;56.8;47.9
10;2021-07-18;942;1225;177082;149642;57.1;48.3
10;2021-07-19;1361;1622;178443;151264;57.6;48.8
10;2021-07-20;1685;1431;180128;152695;58.1;49.3
10;2021-07-21;1395;1483;181523;154178;58.6;49.7
10;2021-07-22;1941;1598;183464;155776;59.2;50.3
10;2021-07-23;1606;1544;185070;157320;59.7;50.8
10;2021-07-24;1389;1227;186459;158547;60.2;51.2
10;2021-07-25;1251;789;187710;159336;60.6;51.4
10;2021-07-26;1914;1316;189624;160652;61.2;51.8
10;2021-07-27;2139;1070;191763;161722;61.9;52.2
10;2021-07-28;2094;1016;193857;162738;62.6;52.5
10;2021-07-29;2444;1205;196301;163943;63.3;52.9
10;2021-07-30;2176;1311;198477;165254;64.0;53.3
10;2021-07-31;1680;937;200157;166191;64.6;53.6
10;2021-08-01;1236;570;201393;166761;65.0;53.8
10;2021-08-02;1463;1337;202856;168098;65.5;54.2
10;2021-08-03;1635;897;204491;168995;66.0;54.5
10;2021-08-04;1370;1066;205861;170061;66.4;54.9
10;2021-08-05;1654;1345;207515;171406;67.0;55.3
10;2021-08-06;1835;1333;209350;172739;67.6;55.7
10;2021-08-07;1156;1133;210506;173872;67.9;56.1
10;2021-08-08;660;751;211166;174623;68.1;56.3
10;2021-08-09;1311;1542;212477;176165;68.6;56.8
10;2021-08-10;1670;1352;214147;177517;69.1;57.3
10;2021-08-11;854;1107;215001;178624;69.4;57.6
10;2021-08-12;1055;1225;216056;179849;69.7;58.0
10;2021-08-13;739;1075;216795;180924;70.0;58.4
10;2021-08-14;587;1235;217382;182159;70.1;58.8
10;2021-08-15;317;781;217699;182940;70.2;59.0
10;2021-08-16;725;1618;218424;184558;70.5;59.6
10;2021-08-17;877;1776;219301;186334;70.8;60.1
10;2021-08-18;723;1620;220024;187954;71.0;60.6
10;2021-08-19;551;1571;220575;189525;71.2;61.2
10;2021-08-20;644;1733;221219;191258;71.4;61.7
10;2021-08-21;452;1419;221671;192677;71.5;62.2
10;2021-08-22;188;1061;221859;193738;71.6;62.5
10;2021-08-23;481;1562;222340;195300;71.7;63.0
10;2021-08-24;669;1771;223009;197071;72.0;63.6
10;2021-08-25;460;1381;223469;198452;72.1;64.0
10;2021-08-26;432;1486;223901;199938;72.2;64.5
10;2021-08-27;626;1588;224527;201526;72.4;65.0
10;2021-08-28;396;1333;224923;202859;72.6;65.5
10;2021-08-29;225;946;225148;203805;72.7;65.8
10;2021-08-30;433;1395;225581;205200;72.8;66.2
10;2021-08-31;466;1451;226047;206651;72.9;66.7
10;2021-09-01;298;1202;226345;207853;73.0;67.1
10;2021-09-02;272;1149;226617;209002;73.1;67.4
10;2021-09-03;404;1219;227021;210221;73.3;67.8
10;2021-09-04;338;1095;227359;211316;73.4;68.2
10;2021-09-05;174;468;227533;211784;73.4;68.3
10;2021-09-06;272;757;227805;212541;73.5;68.6
10;2021-09-07;303;760;228108;213301;73.6;68.8
10;2021-09-08;255;765;228363;214066;73.7;69.1
10;2021-09-09;331;969;228694;215035;73.8;69.4
10;2021-09-10;433;907;229127;215942;73.9;69.7
10;2021-09-11;259;718;229386;216660;74.0;69.9
10;2021-09-12;93;229;229479;216889;74.0;70.0
10;2021-09-13;225;685;229704;217574;74.1;70.2
10;2021-09-14;244;990;229948;218564;74.2;70.5
10;2021-09-15;212;637;230160;219201;74.3;70.7
10;2021-09-16;282;597;230442;219798;74.4;70.9
10;2021-09-17;271;857;230713;220655;74.4;71.2
10;2021-09-18;199;610;230912;221265;74.5;71.4
10;2021-09-19;62;224;230974;221489;74.5;71.5
10;2021-09-20;139;627;231113;222116;74.6;71.7
10;2021-09-21;151;554;231264;222670;74.6;71.9
10;2021-09-22;132;305;231396;222975;74.7;71.9
10;2021-09-23;215;352;231611;223327;74.7;72.1
10;2021-09-24;211;546;231822;223873;74.8;72.2
10;2021-09-25;112;420;231934;224293;74.8;72.4
10;2021-09-26;58;215;231992;224508;74.9;72.4
10;2021-09-27;220;267;232212;224775;74.9;72.5
10;2021-09-28;204;362;232416;225137;75.0;72.6
10;2021-09-29;190;291;232606;225428;75.1;72.7
10;2021-09-30;156;220;232762;225648;75.1;72.8
10;2021-10-01;199;445;232961;226093;75.2;73.0
10;2021-10-02;145;284;233106;226377;75.2;73.0
10;2021-10-03;58;127;233164;226504;75.2;73.1
11;2020-12-27;0;0;0;0;0.0;0.0
11;2020-12-28;1;0;1;0;0.0;0.0
11;2020-12-29;1;0;2;0;0.0;0.0
11;2020-12-30;0;0;2;0;0.0;0.0
11;2020-12-31;0;0;2;0;0.0;0.0
11;2021-01-01;0;0;2;0;0.0;0.0
11;2021-01-02;5;0;7;0;0.0;0.0
11;2021-01-03;0;0;7;0;0.0;0.0
11;2021-01-04;1;0;8;0;0.0;0.0
11;2021-01-05;95;0;103;0;0.0;0.0
11;2021-01-06;25;0;128;0;0.0;0.0
11;2021-01-07;119;0;247;0;0.1;0.0
11;2021-01-08;91;1;338;1;0.1;0.0
11;2021-01-09;86;0;424;1;0.1;0.0
11;2021-01-10;67;0;491;1;0.1;0.0
11;2021-01-11;136;0;627;1;0.2;0.0
11;2021-01-12;545;3;1172;4;0.3;0.0
11;2021-01-13;409;1;1581;5;0.4;0.0
11;2021-01-14;645;8;2226;13;0.6;0.0
11;2021-01-15;342;3;2568;16;0.7;0.0
11;2021-01-16;77;1;2645;17;0.7;0.0
11;2021-01-17;47;1;2692;18;0.7;0.0
11;2021-01-18;388;0;3080;18;0.8;0.0
11;2021-01-19;539;4;3619;22;1.0;0.0
11;2021-01-20;693;7;4312;29;1.2;0.0
11;2021-01-21;649;5;4961;34;1.3;0.0
11;2021-01-22;524;2;5485;36;1.5;0.0
11;2021-01-23;164;0;5649;36;1.5;0.0
11;2021-01-24;139;0;5788;36;1.6;0.0
11;2021-01-25;377;18;6165;54;1.7;0.0
11;2021-01-26;851;86;7016;140;1.9;0.0
11;2021-01-27;803;23;7819;163;2.1;0.0
11;2021-01-28;652;53;8471;216;2.3;0.1
11;2021-01-29;442;120;8913;336;2.4;0.1
11;2021-01-30;138;0;9051;336;2.4;0.1
11;2021-01-31;82;0;9133;336;2.5;0.1
11;2021-02-01;344;187;9477;523;2.5;0.1
11;2021-02-02;412;361;9889;884;2.7;0.2
11;2021-02-03;392;346;10281;1230;2.8;0.3
11;2021-02-04;376;487;10657;1717;2.9;0.5
11;2021-02-05;318;327;10975;2044;2.9;0.5
11;2021-02-06;210;56;11185;2100;3.0;0.6
11;2021-02-07;108;13;11293;2113;3.0;0.6
11;2021-02-08;317;127;11610;2240;3.1;0.6
11;2021-02-09;300;244;11910;2484;3.2;0.7
11;2021-02-10;342;386;12252;2870;3.3;0.8
11;2021-02-11;609;527;12861;3397;3.5;0.9
11;2021-02-12;407;340;13268;3737;3.6;1.0
11;2021-02-13;195;87;13463;3824;3.6;1.0
11;2021-02-14;72;22;13535;3846;3.6;1.0
11;2021-02-15;241;173;13776;4019;3.7;1.1
11;2021-02-16;264;458;14040;4477;3.8;1.2
11;2021-02-17;454;535;14494;5012;3.9;1.3
11;2021-02-18;456;470;14950;5482;4.0;1.5
11;2021-02-19;300;449;15250;5931;4.1;1.6
11;2021-02-20;147;61;15397;5992;4.1;1.6
11;2021-02-21;59;32;15456;6024;4.1;1.6
11;2021-02-22;124;272;15580;6296;4.2;1.7
11;2021-02-23;283;264;15863;6560;4.3;1.8
11;2021-02-24;252;317;16115;6877;4.3;1.8
11;2021-02-25;563;283;16678;7160;4.5;1.9
11;2021-02-26;523;268;17201;7428;4.6;2.0
11;2021-02-27;319;89;17520;7517;4.7;2.0
11;2021-02-28;95;20;17615;7537;4.7;2.0
11;2021-03-01;339;259;17954;7796;4.8;2.1
11;2021-03-02;562;341;18516;8137;5.0;2.2
11;2021-03-03;600;381;19116;8518;5.1;2.3
11;2021-03-04;1078;368;20194;8886;5.4;2.4
11;2021-03-05;1003;372;21197;9258;5.7;2.5
11;2021-03-06;1095;179;22292;9437;6.0;2.5
11;2021-03-07;658;30;22950;9467;6.2;2.5
11;2021-03-08;369;308;23319;9775;6.3;2.6
11;2021-03-09;997;357;24316;10132;6.5;2.7
11;2021-03-10;1176;507;25492;10639;6.8;2.9
11;2021-03-11;1572;407;27064;11046;7.3;3.0
11;2021-03-12;1457;417;28521;11463;7.7;3.1
11;2021-03-13;1160;222;29681;11685;8.0;3.1
11;2021-03-14;523;49;30204;11734;8.1;3.1
11;2021-03-15;651;226;30855;11960;8.3;3.2
11;2021-03-16;853;196;31708;12156;8.5;3.3
11;2021-03-17;907;210;32615;12366;8.8;3.3
11;2021-03-18;1172;281;33787;12647;9.1;3.4
11;2021-03-19;1372;239;35159;12886;9.4;3.5
11;2021-03-20;790;172;35949;13058;9.6;3.5
11;2021-03-21;225;65;36174;13123;9.7;3.5
11;2021-03-22;809;219;36983;13342;9.9;3.6
11;2021-03-23;1806;386;38789;13728;10.4;3.7
11;2021-03-24;1847;315;40636;14043;10.9;3.8
11;2021-03-25;2190;372;42826;14415;11.5;3.9
11;2021-03-26;2125;421;44951;14836;12.1;4.0
11;2021-03-27;1178;145;46129;14981;12.4;4.0
11;2021-03-28;265;42;46394;15023;12.4;4.0
11;2021-03-29;1182;222;47576;15245;12.8;4.1
11;2021-03-30;1995;321;49571;15566;13.3;4.2
11;2021-03-31;1614;383;51185;15949;13.7;4.3
11;2021-04-01;2145;425;53330;16374;14.3;4.4
11;2021-04-02;1643;428;54973;16802;14.7;4.5
11;2021-04-03;720;145;55693;16947;14.9;4.5
11;2021-04-04;198;75;55891;17022;15.0;4.6
11;2021-04-05;257;4;56148;17026;15.1;4.6
11;2021-04-06;1574;551;57722;17577;15.5;4.7
11;2021-04-07;1778;573;59500;18150;16.0;4.9
11;2021-04-08;1785;680;61285;18830;16.4;5.1
11;2021-04-09;2261;603;63546;19433;17.0;5.2
11;2021-04-10;1169;178;64715;19611;17.4;5.3
11;2021-04-11;551;105;65266;19716;17.5;5.3
11;2021-04-12;1614;541;66880;20257;17.9;5.4
11;2021-04-13;2262;884;69142;21141;18.6;5.7
11;2021-04-14;1661;1018;70803;22159;19.0;5.9
11;2021-04-15;1843;1130;72646;23289;19.5;6.2
11;2021-04-16;1837;849;74483;24138;20.0;6.5
11;2021-04-17;1772;561;76255;24699;20.5;6.6
11;2021-04-18;114;155;76369;24854;20.5;6.7
11;2021-04-19;1384;735;77753;25589;20.9;6.9
11;2021-04-20;1729;1277;79482;26866;21.3;7.2
11;2021-04-21;1780;1323;81262;28189;21.8;7.6
11;2021-04-22;1749;1323;83011;29512;22.3;7.9
11;2021-04-23;2012;1235;85023;30747;22.8;8.2
11;2021-04-24;1735;468;86758;31215;23.3;8.4
11;2021-04-25;659;177;87417;31392;23.5;8.4
11;2021-04-26;1380;838;88797;32230;23.8;8.6
11;2021-04-27;1839;1550;90636;33780;24.3;9.1
11;2021-04-28;2008;1465;92644;35245;24.9;9.5
11;2021-04-29;2247;1637;94891;36882;25.5;9.9
11;2021-04-30;2158;1424;97049;38306;26.0;10.3
11;2021-05-01;1338;344;98387;38650;26.4;10.4
11;2021-05-02;588;336;98975;38986;26.6;10.5
11;2021-05-03;1487;735;100462;39721;27.0;10.7
11;2021-05-04;1878;1427;102340;41148;27.5;11.0
11;2021-05-05;1895;1441;104235;42589;28.0;11.4
11;2021-05-06;2191;1475;106426;44064;28.6;11.8
11;2021-05-07;2106;1548;108532;45612;29.1;12.2
11;2021-05-08;898;726;109430;46338;29.4;12.4
11;2021-05-09;628;543;110058;46881;29.5;12.6
11;2021-05-10;1328;1652;111386;48533;29.9;13.0
11;2021-05-11;2041;1871;113427;50404;30.4;13.5
11;2021-05-12;1847;1649;115274;52053;30.9;14.0
11;2021-05-13;1405;414;116679;52467;31.3;14.1
11;2021-05-14;1718;1182;118397;53649;31.8;14.4
11;2021-05-15;1158;897;119555;54546;32.1;14.6
11;2021-05-16;808;164;120363;54710;32.3;14.7
11;2021-05-17;1470;1047;121833;55757;32.7;15.0
11;2021-05-18;1898;1190;123731;56947;33.2;15.3
11;2021-05-19;1846;1123;125577;58070;33.7;15.6
11;2021-05-20;1971;1091;127548;59161;34.2;15.9
11;2021-05-21;2276;1089;129824;60250;34.8;16.2
11;2021-05-22;1485;726;131309;60976;35.2;16.4
11;2021-05-23;767;71;132076;61047;35.4;16.4
11;2021-05-24;1411;224;133487;61271;35.8;16.4
11;2021-05-25;1811;1353;135298;62624;36.3;16.8
11;2021-05-26;1934;1297;137232;63921;36.8;17.2
11;2021-05-27;1989;1720;139221;65641;37.4;17.6
11;2021-05-28;1755;1901;140976;67542;37.8;18.1
11;2021-05-29;1428;1599;142404;69141;38.2;18.6
11;2021-05-30;486;392;142890;69533;38.3;18.7
11;2021-05-31;1261;1615;144151;71148;38.7;19.1
11;2021-06-01;1856;1903;146007;73051;39.2;19.6
11;2021-06-02;1761;2068;147768;75119;39.6;20.2
11;2021-06-03;2597;2409;150365;77528;40.3;20.8
11;2021-06-04;2146;2663;152511;80191;40.9;21.5
11;2021-06-05;1588;1902;154099;82093;41.3;22.0
11;2021-06-06;877;857;154976;82950;41.6;22.3
11;2021-06-07;1527;1708;156503;84658;42.0;22.7
11;2021-06-08;2038;1986;158541;86644;42.5;23.2
11;2021-06-09;1786;2182;160327;88826;43.0;23.8
11;2021-06-10;1806;2426;162133;91252;43.5;24.5
11;2021-06-11;1864;2493;163997;93745;44.0;25.2
11;2021-06-12;1455;1621;165452;95366;44.4;25.6
11;2021-06-13;713;723;166165;96089;44.6;25.8
11;2021-06-14;1032;1968;167197;98057;44.9;26.3
11;2021-06-15;1395;2685;168592;100742;45.2;27.0
11;2021-06-16;1335;2527;169927;103269;45.6;27.7
11;2021-06-17;1474;2520;171401;105789;46.0;28.4
11;2021-06-18;1518;2486;172919;108275;46.4;29.1
11;2021-06-19;1236;1410;174155;109685;46.7;29.4
11;2021-06-20;299;599;174454;110284;46.8;29.6
11;2021-06-21;838;2122;175292;112406;47.0;30.2
11;2021-06-22;1016;2604;176308;115010;47.3;30.9
11;2021-06-23;1095;2089;177403;117099;47.6;31.4
11;2021-06-24;909;2244;178312;119343;47.8;32.0
11;2021-06-25;993;2547;179305;121890;48.1;32.7
11;2021-06-26;773;1655;180078;123545;48.3;33.1
11;2021-06-27;210;688;180288;124233;48.4;33.3
11;2021-06-28;697;2297;180985;126530;48.6;33.9
11;2021-06-29;962;2598;181947;129128;48.8;34.6
11;2021-06-30;906;2520;182853;131648;49.1;35.3
11;2021-07-01;1003;1888;183856;133536;49.3;35.8
11;2021-07-02;966;2539;184822;136075;49.6;36.5
11;2021-07-03;729;1807;185551;137882;49.8;37.0
11;2021-07-04;340;1109;185891;138991;49.9;37.3
11;2021-07-05;695;2132;186586;141123;50.1;37.9
11;2021-07-06;973;2519;187559;143642;50.3;38.5
11;2021-07-07;946;2508;188505;146150;50.6;39.2
11;2021-07-08;1191;1910;189696;148060;50.9;39.7
11;2021-07-09;824;1795;190520;149855;51.1;40.2
11;2021-07-10;369;1302;190889;151157;51.2;40.6
11;2021-07-11;313;564;191202;151721;51.3;40.7
11;2021-07-12;505;2672;191707;154393;51.4;41.4
11;2021-07-13;1304;3063;193011;157456;51.8;42.2
11;2021-07-14;210;233;193221;157689;51.8;42.3
11;2021-07-15;1450;2961;194671;160650;52.2;43.1
11;2021-07-16;1876;2730;196547;163380;52.7;43.8
11;2021-07-17;1075;2161;197622;165541;53.0;44.4
11;2021-07-18;652;946;198274;166487;53.2;44.7
11;2021-07-19;1355;2088;199629;168575;53.6;45.2
11;2021-07-20;1997;2403;201626;170978;54.1;45.9
11;2021-07-21;2015;2437;203641;173415;54.6;46.5
11;2021-07-22;2415;1883;206056;175298;55.3;47.0
11;2021-07-23;2230;2282;208286;177580;55.9;47.6
11;2021-07-24;1274;1628;209560;179208;56.2;48.1
11;2021-07-25;749;692;210309;179900;56.4;48.3
11;2021-07-26;1667;1427;211976;181327;56.9;48.7
11;2021-07-27;2342;1998;214318;183325;57.5;49.2
11;2021-07-28;2480;1989;216798;185314;58.2;49.7
11;2021-07-29;2771;1794;219569;187108;58.9;50.2
11;2021-07-30;2575;1803;222144;188911;59.6;50.7
11;2021-07-31;2008;1141;224152;190052;60.1;51.0
11;2021-08-01;1011;482;225163;190534;60.4;51.1
11;2021-08-02;1929;1151;227092;191685;60.9;51.4
11;2021-08-03;2441;1602;229533;193287;61.6;51.9
11;2021-08-04;2559;1266;232092;194553;62.3;52.2
11;2021-08-05;2382;1333;234474;195886;62.9;52.6
11;2021-08-06;2252;1660;236726;197546;63.5;53.0
11;2021-08-07;1665;1167;238391;198713;64.0;53.3
11;2021-08-08;599;210;238990;198923;64.1;53.4
11;2021-08-09;1031;1434;240021;200357;64.4;53.8
11;2021-08-10;1746;1986;241767;202343;64.9;54.3
11;2021-08-11;1717;1690;243484;204033;65.3;54.7
11;2021-08-12;1716;1858;245200;205891;65.8;55.2
11;2021-08-13;1348;1655;246548;207546;66.2;55.7
11;2021-08-14;984;1596;247532;209142;66.4;56.1
11;2021-08-15;138;125;247670;209267;66.5;56.1
11;2021-08-16;732;1914;248402;211181;66.6;56.7
11;2021-08-17;1046;2391;249448;213572;66.9;57.3
11;2021-08-18;1108;2032;250556;215604;67.2;57.8
11;2021-08-19;1006;2291;251562;217895;67.5;58.5
11;2021-08-20;976;2291;252538;220186;67.8;59.1
11;2021-08-21;576;1838;253114;222024;67.9;59.6
11;2021-08-22;192;512;253306;222536;68.0;59.7
11;2021-08-23;522;1817;253828;224353;68.1;60.2
11;2021-08-24;799;2255;254627;226608;68.3;60.8
11;2021-08-25;795;2155;255422;228763;68.5;61.4
11;2021-08-26;759;2001;256181;230764;68.7;61.9
11;2021-08-27;701;2222;256882;232986;68.9;62.5
11;2021-08-28;436;1745;257318;234731;69.0;63.0
11;2021-08-29;143;514;257461;235245;69.1;63.1
11;2021-08-30;455;1347;257916;236592;69.2;63.5
11;2021-08-31;584;1949;258500;238541;69.4;64.0
11;2021-09-01;607;1813;259107;240354;69.5;64.5
11;2021-09-02;554;1701;259661;242055;69.7;64.9
11;2021-09-03;537;1711;260198;243766;69.8;65.4
11;2021-09-04;488;1554;260686;245320;69.9;65.8
11;2021-09-05;153;271;260839;245591;70.0;65.9
11;2021-09-06;299;856;261138;246447;70.1;66.1
11;2021-09-07;355;1122;261493;247569;70.2;66.4
11;2021-09-08;478;1308;261971;248877;70.3;66.8
11;2021-09-09;394;1037;262365;249914;70.4;67.1
11;2021-09-10;380;1138;262745;251052;70.5;67.4
11;2021-09-11;378;1053;263123;252105;70.6;67.6
11;2021-09-12;61;146;263184;252251;70.6;67.7
11;2021-09-13;238;1041;263422;253292;70.7;68.0
11;2021-09-14;343;963;263765;254255;70.8;68.2
11;2021-09-15;360;973;264125;255228;70.9;68.5
11;2021-09-16;301;585;264426;255813;70.9;68.6
11;2021-09-17;313;682;264739;256495;71.0;68.8
11;2021-09-18;267;730;265006;257225;71.1;69.0
11;2021-09-19;59;123;265065;257348;71.1;69.0
11;2021-09-20;166;332;265231;257680;71.2;69.1
11;2021-09-21;288;417;265519;258097;71.2;69.2
11;2021-09-22;227;768;265746;258865;71.3;69.5
11;2021-09-23;179;398;265925;259263;71.3;69.6
11;2021-09-24;274;520;266199;259783;71.4;69.7
11;2021-09-25;235;673;266434;260456;71.5;69.9
11;2021-09-26;35;131;266469;260587;71.5;69.9
11;2021-09-27;105;385;266574;260972;71.5;70.0
11;2021-09-28;212;354;266786;261326;71.6;70.1
11;2021-09-29;219;537;267005;261863;71.6;70.3
11;2021-09-30;194;360;267199;262223;71.7;70.4
11;2021-10-01;225;389;267424;262612;71.8;70.5
11;2021-10-02;227;445;267651;263057;71.8;70.6
11;2021-10-03;2;1;267653;263058;71.8;70.6
12;2020-12-27;0;0;0;0;0.0;0.0
12;2020-12-28;0;0;0;0;0.0;0.0
12;2020-12-29;0;0;0;0;0.0;0.0
12;2020-12-30;0;0;0;0;0.0;0.0
12;2020-12-31;0;0;0;0;0.0;0.0
12;2021-01-01;0;0;0;0;0.0;0.0
12;2021-01-02;0;0;0;0;0.0;0.0
12;2021-01-03;2;0;2;0;0.0;0.0
12;2021-01-04;1;0;3;0;0.0;0.0
12;2021-01-05;1;0;4;0;0.0;0.0
12;2021-01-06;12;0;16;0;0.0;0.0
12;2021-01-07;202;0;218;0;0.1;0.0
12;2021-01-08;65;0;283;0;0.1;0.0
12;2021-01-09;0;0;283;0;0.1;0.0
12;2021-01-10;1;0;284;0;0.1;0.0
12;2021-01-11;101;0;385;0;0.1;0.0
12;2021-01-12;361;0;746;0;0.3;0.0
12;2021-01-13;285;0;1031;0;0.4;0.0
12;2021-01-14;600;12;1631;12;0.6;0.0
12;2021-01-15;367;8;1998;20;0.7;0.0
12;2021-01-16;138;1;2136;21;0.8;0.0
12;2021-01-17;1;0;2137;21;0.8;0.0
12;2021-01-18;452;0;2589;21;0.9;0.0
12;2021-01-19;609;3;3198;24;1.1;0.0
12;2021-01-20;879;3;4077;27;1.5;0.0
12;2021-01-21;736;0;4813;27;1.7;0.0
12;2021-01-22;798;1;5611;28;2.0;0.0
12;2021-01-23;382;0;5993;28;2.2;0.0
12;2021-01-24;0;0;5993;28;2.2;0.0
12;2021-01-25;453;0;6446;28;2.3;0.0
12;2021-01-26;650;0;7096;28;2.5;0.0
12;2021-01-27;1886;38;8982;66;3.2;0.0
12;2021-01-28;1886;225;10868;291;3.9;0.1
12;2021-01-29;1331;41;12199;332;4.4;0.1
12;2021-01-30;359;2;12558;334;4.5;0.1
12;2021-01-31;0;0;12558;334;4.5;0.1
12;2021-02-01;335;85;12893;419;4.6;0.2
12;2021-02-02;457;233;13350;652;4.8;0.2
12;2021-02-03;457;164;13807;816;5.0;0.3
12;2021-02-04;459;510;14266;1326;5.1;0.5
12;2021-02-05;449;170;14715;1496;5.3;0.5
12;2021-02-06;220;42;14935;1538;5.4;0.6
12;2021-02-07;8;0;14943;1538;5.4;0.6
12;2021-02-08;104;281;15047;1819;5.4;0.7
12;2021-02-09;209;293;15256;2112;5.5;0.8
12;2021-02-10;466;394;15722;2506;5.6;0.9
12;2021-02-11;539;293;16261;2799;5.8;1.0
12;2021-02-12;570;264;16831;3063;6.0;1.1
12;2021-02-13;175;110;17006;3173;6.1;1.1
12;2021-02-14;1;0;17007;3173;6.1;1.1
12;2021-02-15;175;295;17182;3468;6.2;1.2
12;2021-02-16;171;424;17353;3892;6.2;1.4
12;2021-02-17;366;1301;17719;5193;6.4;1.9
12;2021-02-18;676;1508;18395;6701;6.6;2.4
12;2021-02-19;594;891;18989;7592;6.8;2.7
12;2021-02-20;103;355;19092;7947;6.9;2.9
12;2021-02-21;0;0;19092;7947;6.9;2.9
12;2021-02-22;150;323;19242;8270;6.9;3.0
12;2021-02-23;157;469;19399;8739;7.0;3.1
12;2021-02-24;156;542;19555;9281;7.0;3.3
12;2021-02-25;201;642;19756;9923;7.1;3.6
12;2021-02-26;320;544;20076;10467;7.2;3.8
12;2021-02-27;190;301;20266;10768;7.3;3.9
12;2021-02-28;13;0;20279;10768;7.3;3.9
12;2021-03-01;51;318;20330;11086;7.3;4.0
12;2021-03-02;190;453;20520;11539;7.4;4.1
12;2021-03-03;244;347;20764;11886;7.5;4.3
12;2021-03-04;278;323;21042;12209;7.6;4.4
12;2021-03-05;421;330;21463;12539;7.7;4.5
12;2021-03-06;793;120;22256;12659;8.0;4.5
12;2021-03-07;140;32;22396;12691;8.0;4.6
12;2021-03-08;233;192;22629;12883;8.1;4.6
12;2021-03-09;716;220;23345;13103;8.4;4.7
12;2021-03-10;784;722;24129;13825;8.7;5.0
12;2021-03-11;919;642;25048;14467;9.0;5.2
12;2021-03-12;1259;511;26307;14978;9.5;5.4
12;2021-03-13;896;134;27203;15112;9.8;5.4
12;2021-03-14;45;2;27248;15114;9.8;5.4
12;2021-03-15;559;154;27807;15268;10.0;5.5
12;2021-03-16;818;159;28625;15427;10.3;5.5
12;2021-03-17;1504;165;30129;15592;10.8;5.6
12;2021-03-18;997;246;31126;15838;11.2;5.7
12;2021-03-19;1383;278;32509;16116;11.7;5.8
12;2021-03-20;725;78;33234;16194;11.9;5.8
12;2021-03-21;264;10;33498;16204;12.0;5.8
12;2021-03-22;606;174;34104;16378;12.3;5.9
12;2021-03-23;1214;176;35318;16554;12.7;5.9
12;2021-03-24;1422;206;36740;16760;13.2;6.0
12;2021-03-25;1844;205;38584;16965;13.9;6.1
12;2021-03-26;1978;231;40562;17196;14.6;6.2
12;2021-03-27;981;68;41543;17264;14.9;6.2
12;2021-03-28;60;1;41603;17265;14.9;6.2
12;2021-03-29;963;84;42566;17349;15.3;6.2
12;2021-03-30;1737;123;44303;17472;15.9;6.3
12;2021-03-31;1460;104;45763;17576;16.4;6.3
12;2021-04-01;1957;166;47720;17742;17.1;6.4
12;2021-04-02;1614;344;49334;18086;17.7;6.5
12;2021-04-03;882;96;50216;18182;18.0;6.5
12;2021-04-04;1;0;50217;18182;18.0;6.5
12;2021-04-05;645;14;50862;18196;18.3;6.5
12;2021-04-06;1151;536;52013;18732;18.7;6.7
12;2021-04-07;1651;637;53664;19369;19.3;7.0
12;2021-04-08;2098;570;55762;19939;20.0;7.2
12;2021-04-09;2112;652;57874;20591;20.8;7.4
12;2021-04-10;1427;219;59301;20810;21.3;7.5
12;2021-04-11;120;1;59421;20811;21.3;7.5
12;2021-04-12;1836;502;61257;21313;22.0;7.7
12;2021-04-13;1907;774;63164;22087;22.7;7.9
12;2021-04-14;1832;1318;64996;23405;23.3;8.4
12;2021-04-15;1937;896;66933;24301;24.0;8.7
12;2021-04-16;1675;1204;68608;25505;24.6;9.2
12;2021-04-17;1553;567;70161;26072;25.2;9.4
12;2021-04-18;0;0;70161;26072;25.2;9.4
12;2021-04-19;1687;549;71848;26621;25.8;9.6
12;2021-04-20;1546;984;73394;27605;26.4;9.9
12;2021-04-21;1693;1183;75087;28788;27.0;10.3
12;2021-04-22;1690;1092;76777;29880;27.6;10.7
12;2021-04-23;1382;1335;78159;31215;28.1;11.2
12;2021-04-24;1450;719;79609;31934;28.6;11.5
12;2021-04-25;60;0;79669;31934;28.6;11.5
12;2021-04-26;1459;898;81128;32832;29.1;11.8
12;2021-04-27;1321;1279;82449;34111;29.6;12.3
12;2021-04-28;1113;1870;83562;35981;30.0;12.9
12;2021-04-29;1571;1910;85133;37891;30.6;13.6
12;2021-04-30;1815;1836;86948;39727;31.2;14.3
12;2021-05-01;1617;261;88565;39988;31.8;14.4
12;2021-05-02;9;0;88574;39988;31.8;14.4
12;2021-05-03;1713;1252;90287;41240;32.4;14.8
12;2021-05-04;1483;1393;91770;42633;33.0;15.3
12;2021-05-05;1296;1673;93066;44306;33.4;15.9
12;2021-05-06;1753;1376;94819;45682;34.1;16.4
12;2021-05-07;1483;1777;96302;47459;34.6;17.0
12;2021-05-08;1330;461;97632;47920;35.1;17.2
12;2021-05-09;13;34;97645;47954;35.1;17.2
12;2021-05-10;829;2215;98474;50169;35.4;18.0
12;2021-05-11;928;1846;99402;52015;35.7;18.7
12;2021-05-12;948;1820;100350;53835;36.1;19.3
12;2021-05-13;1587;811;101937;54646;36.6;19.6
12;2021-05-14;1235;1534;103172;56180;37.1;20.2
12;2021-05-15;1067;1115;104239;57295;37.4;20.6
12;2021-05-16;2;19;104241;57314;37.4;20.6
12;2021-05-17;1082;1810;105323;59124;37.8;21.2
12;2021-05-18;1427;1534;106750;60658;38.3;21.8
12;2021-05-19;1915;1330;108665;61988;39.0;22.3
12;2021-05-20;2119;876;110784;62864;39.8;22.6
12;2021-05-21;1821;1253;112605;64117;40.5;23.0
12;2021-05-22;1207;1016;113812;65133;40.9;23.4
12;2021-05-23;7;12;113819;65145;40.9;23.4
12;2021-05-24;1956;536;115775;65681;41.6;23.6
12;2021-05-25;1742;1157;117517;66838;42.2;24.0
12;2021-05-26;1998;780;119515;67618;42.9;24.3
12;2021-05-27;2165;744;121680;68362;43.7;24.6
12;2021-05-28;1927;1025;123607;69387;44.4;24.9
12;2021-05-29;1637;805;125244;70192;45.0;25.2
12;2021-05-30;9;43;125253;70235;45.0;25.2
12;2021-05-31;1699;810;126952;71045;45.6;25.5
12;2021-06-01;1887;1026;128839;72071;46.3;25.9
12;2021-06-02;1979;1052;130818;73123;47.0;26.3
12;2021-06-03;2123;824;132941;73947;47.8;26.6
12;2021-06-04;1967;1417;134908;75364;48.5;27.1
12;2021-06-05;1738;985;136646;76349;49.1;27.4
12;2021-06-06;6;6;136652;76355;49.1;27.4
12;2021-06-07;1092;1811;137744;78166;49.5;28.1
12;2021-06-08;1332;1201;139076;79367;50.0;28.5
12;2021-06-09;895;1291;139971;80658;50.3;29.0
12;2021-06-10;1022;920;140993;81578;50.7;29.3
12;2021-06-11;1204;2076;142197;83654;51.1;30.1
12;2021-06-12;1033;1320;143230;84974;51.5;30.5
12;2021-06-13;6;47;143236;85021;51.5;30.5
12;2021-06-14;662;1829;143898;86850;51.7;31.2
12;2021-06-15;745;1877;144643;88727;52.0;31.9
12;2021-06-16;820;1818;145463;90545;52.3;32.5
12;2021-06-17;678;995;146141;91540;52.5;32.9
12;2021-06-18;1134;1840;147275;93380;52.9;33.5
12;2021-06-19;914;1406;148189;94786;53.2;34.1
12;2021-06-20;4;10;148193;94796;53.2;34.1
12;2021-06-21;511;1737;148704;96533;53.4;34.7
12;2021-06-22;502;1474;149206;98007;53.6;35.2
12;2021-06-23;579;1306;149785;99313;53.8;35.7
12;2021-06-24;249;541;150034;99854;53.9;35.9
12;2021-06-25;876;1842;150910;101696;54.2;36.5
12;2021-06-26;673;1527;151583;103223;54.5;37.1
12;2021-06-27;1;9;151584;103232;54.5;37.1
12;2021-06-28;467;2453;152051;105685;54.6;38.0
12;2021-06-29;565;1957;152616;107642;54.8;38.7
12;2021-06-30;828;2132;153444;109774;55.1;39.4
12;2021-07-01;345;1086;153789;110860;55.2;39.8
12;2021-07-02;796;2627;154585;113487;55.5;40.8
12;2021-07-03;565;1872;155150;115359;55.7;41.4
12;2021-07-04;1;0;155151;115359;55.7;41.4
12;2021-07-05;440;2406;155591;117765;55.9;42.3
12;2021-07-06;640;2495;156231;120260;56.1;43.2
12;2021-07-07;688;2116;156919;122376;56.4;44.0
12;2021-07-08;295;913;157214;123289;56.5;44.3
12;2021-07-09;724;2587;157938;125876;56.7;45.2
12;2021-07-10;445;2077;158383;127953;56.9;46.0
12;2021-07-11;0;0;158383;127953;56.9;46.0
12;2021-07-12;587;2439;158970;130392;57.1;46.8
12;2021-07-13;840;2592;159810;132984;57.4;47.8
12;2021-07-14;44;25;159854;133009;57.4;47.8
12;2021-07-15;795;2107;160649;135116;57.7;48.5
12;2021-07-16;1247;2556;161896;137672;58.2;49.5
12;2021-07-17;790;2007;162686;139679;58.4;50.2
12;2021-07-18;25;11;162711;139690;58.5;50.2
12;2021-07-19;1319;2005;164030;141695;58.9;50.9
12;2021-07-20;1422;1475;165452;143170;59.4;51.4
12;2021-07-21;1022;941;166474;144111;59.8;51.8
12;2021-07-22;2236;1308;168710;145419;60.6;52.2
12;2021-07-23;1865;2056;170575;147475;61.3;53.0
12;2021-07-24;1604;1566;172179;149041;61.9;53.5
12;2021-07-25;97;28;172276;149069;61.9;53.6
12;2021-07-26;1930;1438;174206;150507;62.6;54.1
12;2021-07-27;2236;1009;176442;151516;63.4;54.4
12;2021-07-28;1715;675;178157;152191;64.0;54.7
12;2021-07-29;1189;807;179346;152998;64.4;55.0
12;2021-07-30;2507;1283;181853;154281;65.3;55.4
12;2021-07-31;1967;1005;183820;155286;66.0;55.8
12;2021-08-01;225;38;184045;155324;66.1;55.8
12;2021-08-02;1815;832;185860;156156;66.8;56.1
12;2021-08-03;1960;776;187820;156932;67.5;56.4
12;2021-08-04;1693;832;189513;157764;68.1;56.7
12;2021-08-05;1636;683;191149;158447;68.7;56.9
12;2021-08-06;1706;1314;192855;159761;69.3;57.4
12;2021-08-07;1448;744;194303;160505;69.8;57.7
12;2021-08-08;0;3;194303;160508;69.8;57.7
12;2021-08-09;1351;1415;195654;161923;70.3;58.2
12;2021-08-10;1343;1247;196997;163170;70.8;58.6
12;2021-08-11;820;1195;197817;164365;71.1;59.0
12;2021-08-12;737;1070;198554;165435;71.3;59.4
12;2021-08-13;1075;1335;199629;166770;71.7;59.9
12;2021-08-14;739;1354;200368;168124;72.0;60.4
12;2021-08-15;255;75;200623;168199;72.1;60.4
12;2021-08-16;670;1817;201293;170016;72.3;61.1
12;2021-08-17;905;1991;202198;172007;72.6;61.8
12;2021-08-18;448;1522;202646;173529;72.8;62.3
12;2021-08-19;641;1115;203287;174644;73.0;62.7
12;2021-08-20;797;1888;204084;176532;73.3;63.4
12;2021-08-21;473;1526;204557;178058;73.5;64.0
12;2021-08-22;93;27;204650;178085;73.5;64.0
12;2021-08-23;453;1921;205103;180006;73.7;64.7
12;2021-08-24;486;1917;205589;181923;73.9;65.4
12;2021-08-25;333;1579;205922;183502;74.0;65.9
12;2021-08-26;487;1606;206409;185108;74.2;66.5
12;2021-08-27;597;1699;207006;186807;74.4;67.1
12;2021-08-28;332;1553;207338;188360;74.5;67.7
12;2021-08-29;176;143;207514;188503;74.5;67.7
12;2021-08-30;562;1908;208076;190411;74.8;68.4
12;2021-08-31;417;1392;208493;191803;74.9;68.9
12;2021-09-01;425;1020;208918;192823;75.1;69.3
12;2021-09-02;266;822;209184;193645;75.1;69.6
12;2021-09-03;490;1378;209674;195023;75.3;70.1
12;2021-09-04;432;1209;210106;196232;75.5;70.5
12;2021-09-05;52;206;210158;196438;75.5;70.6
12;2021-09-06;214;806;210372;197244;75.6;70.9
12;2021-09-07;270;671;210642;197915;75.7;71.1
12;2021-09-08;245;618;210887;198533;75.8;71.3
12;2021-09-09;174;448;211061;198981;75.8;71.5
12;2021-09-10;499;1276;211560;200257;76.0;71.9
12;2021-09-11;385;1087;211945;201344;76.1;72.3
12;2021-09-12;17;120;211962;201464;76.1;72.4
12;2021-09-13;157;625;212119;202089;76.2;72.6
12;2021-09-14;277;513;212396;202602;76.3;72.8
12;2021-09-15;244;407;212640;203009;76.4;72.9
12;2021-09-16;383;411;213023;203420;76.5;73.1
12;2021-09-17;342;505;213365;203925;76.7;73.3
12;2021-09-18;242;688;213607;204613;76.7;73.5
12;2021-09-19;0;4;213607;204617;76.7;73.5
12;2021-09-20;106;432;213713;205049;76.8;73.7
12;2021-09-21;112;220;213825;205269;76.8;73.7
12;2021-09-22;132;578;213957;205847;76.9;73.9
12;2021-09-23;106;160;214063;206007;76.9;74.0
12;2021-09-24;216;535;214279;206542;77.0;74.2
12;2021-09-25;161;664;214440;207206;77.0;74.4
12;2021-09-26;0;1;214440;207207;77.0;74.4
12;2021-09-27;82;241;214522;207448;77.1;74.5
12;2021-09-28;95;252;214617;207700;77.1;74.6
12;2021-09-29;112;325;214729;208025;77.1;74.7
12;2021-09-30;48;123;214777;208148;77.2;74.8
12;2021-10-01;161;404;214938;208552;77.2;74.9
12;2021-10-02;181;475;215119;209027;77.3;75.1
12;2021-10-03;0;2;215119;209029;77.3;75.1
13;2020-12-27;4;0;4;0;0.0;0.0
13;2020-12-28;6;0;10;0;0.0;0.0
13;2020-12-29;1;0;11;0;0.0;0.0
13;2020-12-30;3;0;14;0;0.0;0.0
13;2020-12-31;6;0;20;0;0.0;0.0
13;2021-01-01;4;0;24;0;0.0;0.0
13;2021-01-02;4;0;28;0;0.0;0.0
13;2021-01-03;11;0;39;0;0.0;0.0
13;2021-01-04;1;0;40;0;0.0;0.0
13;2021-01-05;79;1;119;1;0.0;0.0
13;2021-01-06;122;0;241;1;0.0;0.0
13;2021-01-07;174;1;415;2;0.0;0.0
13;2021-01-08;189;0;604;2;0.0;0.0
13;2021-01-09;13;0;617;2;0.0;0.0
13;2021-01-10;3;0;620;2;0.0;0.0
13;2021-01-11;482;1;1102;3;0.1;0.0
13;2021-01-12;813;2;1915;5;0.1;0.0
13;2021-01-13;1087;1;3002;6;0.1;0.0
13;2021-01-14;1587;16;4589;22;0.2;0.0
13;2021-01-15;1538;7;6127;29;0.3;0.0
13;2021-01-16;406;3;6533;32;0.3;0.0
13;2021-01-17;44;0;6577;32;0.3;0.0
13;2021-01-18;2386;9;8963;41;0.4;0.0
13;2021-01-19;7418;33;16381;74;0.8;0.0
13;2021-01-20;5582;18;21963;92;1.1;0.0
13;2021-01-21;5364;29;27327;121;1.3;0.0
13;2021-01-22;4006;22;31333;143;1.5;0.0
13;2021-01-23;1359;6;32692;149;1.6;0.0
13;2021-01-24;491;5;33183;154;1.6;0.0
13;2021-01-25;2340;27;35523;181;1.7;0.0
13;2021-01-26;2951;84;38474;265;1.9;0.0
13;2021-01-27;3122;119;41596;384;2.0;0.0
13;2021-01-28;3250;175;44846;559;2.2;0.0
13;2021-01-29;2512;122;47358;681;2.3;0.0
13;2021-01-30;1025;11;48383;692;2.4;0.0
13;2021-01-31;252;0;48635;692;2.4;0.0
13;2021-02-01;1864;260;50499;952;2.5;0.0
13;2021-02-02;2258;569;52757;1521;2.6;0.1
13;2021-02-03;1868;538;54625;2059;2.7;0.1
13;2021-02-04;1907;880;56532;2939;2.8;0.1
13;2021-02-05;2628;1458;59160;4397;2.9;0.2
13;2021-02-06;856;272;60016;4669;2.9;0.2
13;2021-02-07;278;5;60294;4674;3.0;0.2
13;2021-02-08;1906;1396;62200;6070;3.1;0.3
13;2021-02-09;3320;3962;65520;10032;3.2;0.5
13;2021-02-10;3240;3170;68760;13202;3.4;0.6
13;2021-02-11;3583;3188;72343;16390;3.6;0.8
13;2021-02-12;2839;2726;75182;19116;3.7;0.9
13;2021-02-13;734;524;75916;19640;3.7;1.0
13;2021-02-14;73;324;75989;19964;3.7;1.0
13;2021-02-15;971;1764;76960;21728;3.8;1.1
13;2021-02-16;1396;2302;78356;24030;3.9;1.2
13;2021-02-17;1350;2598;79706;26628;3.9;1.3
13;2021-02-18;1903;2338;81609;28966;4.0;1.4
13;2021-02-19;1514;1917;83123;30883;4.1;1.5
13;2021-02-20;458;648;83581;31531;4.1;1.5
13;2021-02-21;33;238;83614;31769;4.1;1.6
13;2021-02-22;1023;1921;84637;33690;4.2;1.7
13;2021-02-23;1289;2234;85926;35924;4.2;1.8
13;2021-02-24;1519;2263;87445;38187;4.3;1.9
13;2021-02-25;2384;1836;89829;40023;4.4;2.0
13;2021-02-26;2458;1864;92287;41887;4.5;2.1
13;2021-02-27;982;658;93269;42545;4.6;2.1
13;2021-02-28;195;186;93464;42731;4.6;2.1
13;2021-03-01;1927;1356;95391;44087;4.7;2.2
13;2021-03-02;3012;2323;98403;46410;4.8;2.3
13;2021-03-03;3489;2364;101892;48774;5.0;2.4
13;2021-03-04;4210;2846;106102;51620;5.2;2.5
13;2021-03-05;4043;2549;110145;54169;5.4;2.7
13;2021-03-06;5304;748;115449;54917;5.7;2.7
13;2021-03-07;4295;363;119744;55280;5.9;2.7
13;2021-03-08;3930;1794;123674;57074;6.1;2.8
13;2021-03-09;5081;2073;128755;59147;6.3;2.9
13;2021-03-10;5180;1868;133935;61015;6.6;3.0
13;2021-03-11;7307;2024;141242;63039;6.9;3.1
13;2021-03-12;8333;2002;149575;65041;7.4;3.2
13;2021-03-13;6379;703;155954;65744;7.7;3.2
13;2021-03-14;2312;161;158266;65905;7.8;3.2
13;2021-03-15;6358;1290;164624;67195;8.1;3.3
13;2021-03-16;5078;1493;169702;68688;8.3;3.4
13;2021-03-17;5174;1402;174876;70090;8.6;3.4
13;2021-03-18;5816;1829;180692;71919;8.9;3.5
13;2021-03-19;6811;1599;187503;73518;9.2;3.6
13;2021-03-20;4045;690;191548;74208;9.4;3.6
13;2021-03-21;726;84;192274;74292;9.5;3.7
13;2021-03-22;7297;1534;199571;75826;9.8;3.7
13;2021-03-23;9132;1742;208703;77568;10.3;3.8
13;2021-03-24;8867;2173;217570;79741;10.7;3.9
13;2021-03-25;10917;2100;228487;81841;11.2;4.0
13;2021-03-26;10717;1902;239204;83743;11.8;4.1
13;2021-03-27;4870;824;244074;84567;12.0;4.2
13;2021-03-28;1120;81;245194;84648;12.1;4.2
13;2021-03-29;7579;1986;252773;86634;12.4;4.3
13;2021-03-30;12617;2507;265390;89141;13.0;4.4
13;2021-03-31;10811;3157;276201;92298;13.6;4.5
13;2021-04-01;12279;3081;288480;95379;14.2;4.7
13;2021-04-02;9790;3887;298270;99266;14.7;4.9
13;2021-04-03;4006;2802;302276;102068;14.9;5.0
13;2021-04-04;631;306;302907;102374;14.9;5.0
13;2021-04-05;3537;728;306444;103102;15.1;5.1
13;2021-04-06;8520;4243;314964;107345;15.5;5.3
13;2021-04-07;10079;4681;325043;112026;16.0;5.5
13;2021-04-08;10117;5457;335160;117483;16.5;5.8
13;2021-04-09;11281;5111;346441;122594;17.0;6.0
13;2021-04-10;7300;2094;353741;124688;17.4;6.1
13;2021-04-11;1379;534;355120;125222;17.5;6.2
13;2021-04-12;7984;4786;363104;130008;17.8;6.4
13;2021-04-13;9146;5486;372250;135494;18.3;6.7
13;2021-04-14;9535;5816;381785;141310;18.8;6.9
13;2021-04-15;9880;5951;391665;147261;19.3;7.2
13;2021-04-16;9967;5564;401632;152825;19.7;7.5
13;2021-04-17;4079;2022;405711;154847;19.9;7.6
13;2021-04-18;2526;1425;408237;156272;20.1;7.7
13;2021-04-19;6456;6398;414693;162670;20.4;8.0
13;2021-04-20;7402;7585;422095;170255;20.7;8.4
13;2021-04-21;7772;7378;429867;177633;21.1;8.7
13;2021-04-22;8462;7913;438329;185546;21.5;9.1
13;2021-04-23;8395;6829;446724;192375;22.0;9.5
13;2021-04-24;4625;3811;451349;196186;22.2;9.6
13;2021-04-25;877;521;452226;196707;22.2;9.7
13;2021-04-26;6167;7109;458393;203816;22.5;10.0
13;2021-04-27;7264;8021;465657;211837;22.9;10.4
13;2021-04-28;9451;7706;475108;219543;23.4;10.8
13;2021-04-29;11408;7592;486516;227135;23.9;11.2
13;2021-04-30;10916;7361;497432;234496;24.5;11.5
13;2021-05-01;5365;3795;502797;238291;24.7;11.7
13;2021-05-02;2100;747;504897;239038;24.8;11.7
13;2021-05-03;7297;7865;512194;246903;25.2;12.1
13;2021-05-04;8454;8505;520648;255408;25.6;12.6
13;2021-05-05;8224;8966;528872;264374;26.0;13.0
13;2021-05-06;10142;8582;539014;272956;26.5;13.4
13;2021-05-07;8852;10021;547866;282977;26.9;13.9
13;2021-05-08;4569;3936;552435;286913;27.2;14.1
13;2021-05-09;939;687;553374;287600;27.2;14.1
13;2021-05-10;7709;8752;561083;296352;27.6;14.6
13;2021-05-11;10978;9554;572061;305906;28.1;15.0
13;2021-05-12;12841;8727;584902;314633;28.7;15.5
13;2021-05-13;9507;3637;594409;318270;29.2;15.6
13;2021-05-14;13656;6446;608065;324716;29.9;16.0
13;2021-05-15;10196;4534;618261;329250;30.4;16.2
13;2021-05-16;3125;789;621386;330039;30.5;16.2
13;2021-05-17;10844;6800;632230;336839;31.1;16.6
13;2021-05-18;11918;6480;644148;343319;31.7;16.9
13;2021-05-19;12157;6358;656305;349677;32.3;17.2
13;2021-05-20;13443;6467;669748;356144;32.9;17.5
13;2021-05-21;12990;6782;682738;362926;33.6;17.8
13;2021-05-22;7515;3635;690253;366561;33.9;18.0
13;2021-05-23;862;637;691115;367198;34.0;18.0
13;2021-05-24;6761;2469;697876;369667;34.3;18.2
13;2021-05-25;9271;7594;707147;377261;34.8;18.5
13;2021-05-26;10142;7837;717289;385098;35.3;18.9
13;2021-05-27;10337;8421;727626;393519;35.8;19.3
13;2021-05-28;9003;9163;736629;402682;36.2;19.8
13;2021-05-29;7173;4621;743802;407303;36.6;20.0
13;2021-05-30;890;527;744692;407830;36.6;20.0
13;2021-05-31;8184;8022;752876;415852;37.0;20.4
13;2021-06-01;9578;9284;762454;425136;37.5;20.9
13;2021-06-02;10081;8776;772535;433912;38.0;21.3
13;2021-06-03;12295;9487;784830;443399;38.6;21.8
13;2021-06-04;12025;10031;796855;453430;39.2;22.3
13;2021-06-05;7820;5595;804675;459025;39.6;22.6
13;2021-06-06;1671;886;806346;459911;39.6;22.6
13;2021-06-07;6686;9874;813032;469785;40.0;23.1
13;2021-06-08;8317;9983;821349;479768;40.4;23.6
13;2021-06-09;8397;9732;829746;489500;40.8;24.1
13;2021-06-10;8953;9773;838699;499273;41.2;24.5
13;2021-06-11;8230;12710;846929;511983;41.6;25.2
13;2021-06-12;5778;6705;852707;518688;41.9;25.5
13;2021-06-13;950;1216;853657;519904;42.0;25.6
13;2021-06-14;5994;11141;859651;531045;42.3;26.1
13;2021-06-15;7284;11402;866935;542447;42.6;26.7
13;2021-06-16;7340;9867;874275;552314;43.0;27.1
13;2021-06-17;7443;10710;881718;563024;43.3;27.7
13;2021-06-18;7549;11071;889267;574095;43.7;28.2
13;2021-06-19;4616;7496;893883;581591;43.9;28.6
13;2021-06-20;1074;1045;894957;582636;44.0;28.6
13;2021-06-21;4462;12259;899419;594895;44.2;29.2
13;2021-06-22;4940;13876;904359;608771;44.5;29.9
13;2021-06-23;5148;13578;909507;622349;44.7;30.6
13;2021-06-24;5341;12852;914848;635201;45.0;31.2
13;2021-06-25;5242;14680;920090;649881;45.2;31.9
13;2021-06-26;3016;9681;923106;659562;45.4;32.4
13;2021-06-27;537;931;923643;660493;45.4;32.5
13;2021-06-28;3731;12561;927374;673054;45.6;33.1
13;2021-06-29;4499;12900;931873;685954;45.8;33.7
13;2021-06-30;4903;12695;936776;698649;46.0;34.3
13;2021-07-01;5580;11493;942356;710142;46.3;34.9
13;2021-07-02;5570;12393;947926;722535;46.6;35.5
13;2021-07-03;3503;9161;951429;731696;46.8;36.0
13;2021-07-04;476;867;951905;732563;46.8;36.0
13;2021-07-05;3872;11769;955777;744332;47.0;36.6
13;2021-07-06;5461;11677;961238;756009;47.2;37.2
13;2021-07-07;5821;10706;967059;766715;47.5;37.7
13;2021-07-08;6231;10326;973290;777041;47.8;38.2
13;2021-07-09;5932;11934;979222;788975;48.1;38.8
13;2021-07-10;3163;8637;982385;797612;48.3;39.2
13;2021-07-11;435;1012;982820;798624;48.3;39.3
13;2021-07-12;4493;10944;987313;809568;48.5;39.8
13;2021-07-13;8980;13181;996293;822749;49.0;40.4
13;2021-07-14;5611;4862;1001904;827611;49.2;40.7
13;2021-07-15;11438;12946;1013342;840557;49.8;41.3
13;2021-07-16;12195;12927;1025537;853484;50.4;42.0
13;2021-07-17;6584;8492;1032121;861976;50.7;42.4
13;2021-07-18;727;1062;1032848;863038;50.8;42.4
13;2021-07-19;9808;11147;1042656;874185;51.2;43.0
13;2021-07-20;12271;11661;1054927;885846;51.9;43.5
13;2021-07-21;12688;10358;1067615;896204;52.5;44.1
13;2021-07-22;14557;10462;1082172;906666;53.2;44.6
13;2021-07-23;14486;10971;1096658;917637;53.9;45.1
13;2021-07-24;8342;7978;1105000;925615;54.3;45.5
13;2021-07-25;1017;784;1106017;926399;54.4;45.5
13;2021-07-26;11648;9116;1117665;935515;54.9;46.0
13;2021-07-27;13610;9420;1131275;944935;55.6;46.4
13;2021-07-28;12340;8184;1143615;953119;56.2;46.8
13;2021-07-29;13763;8092;1157378;961211;56.9;47.2
13;2021-07-30;13716;8638;1171094;969849;57.6;47.7
13;2021-07-31;8678;5832;1179772;975681;58.0;48.0
13;2021-08-01;1107;729;1180879;976410;58.0;48.0
13;2021-08-02;10052;6727;1190931;983137;58.5;48.3
13;2021-08-03;11070;7295;1202001;990432;59.1;48.7
13;2021-08-04;9427;6571;1211428;997003;59.5;49.0
13;2021-08-05;9522;7583;1220950;1004586;60.0;49.4
13;2021-08-06;9194;9000;1230144;1013586;60.5;49.8
13;2021-08-07;5441;5584;1235585;1019170;60.7;50.1
13;2021-08-08;905;804;1236490;1019974;60.8;50.1
13;2021-08-09;8398;9078;1244888;1029052;61.2;50.6
13;2021-08-10;9147;8912;1254035;1037964;61.6;51.0
13;2021-08-11;7908;8543;1261943;1046507;62.0;51.4
13;2021-08-12;7792;9673;1269735;1056180;62.4;51.9
13;2021-08-13;6959;9189;1276694;1065369;62.8;52.4
13;2021-08-14;3692;6456;1280386;1071825;62.9;52.7
13;2021-08-15;484;731;1280870;1072556;63.0;52.7
13;2021-08-16;6578;11078;1287448;1083634;63.3;53.3
13;2021-08-17;6672;10612;1294120;1094246;63.6;53.8
13;2021-08-18;6336;10175;1300456;1104421;63.9;54.3
13;2021-08-19;6670;10617;1307126;1115038;64.2;54.8
13;2021-08-20;5829;11234;1312955;1126272;64.5;55.4
13;2021-08-21;2617;7568;1315572;1133840;64.7;55.7
13;2021-08-22;369;1090;1315941;1134930;64.7;55.8
13;2021-08-23;4961;11218;1320902;1146148;64.9;56.3
13;2021-08-24;5440;10914;1326342;1157062;65.2;56.9
13;2021-08-25;5212;10093;1331554;1167155;65.4;57.4
13;2021-08-26;5116;9780;1336670;1176935;65.7;57.8
13;2021-08-27;5083;10635;1341753;1187570;66.0;58.4
13;2021-08-28;2359;6460;1344112;1194030;66.1;58.7
13;2021-08-29;338;1135;1344450;1195165;66.1;58.7
13;2021-08-30;4242;9860;1348692;1205025;66.3;59.2
13;2021-08-31;4868;10115;1353560;1215140;66.5;59.7
13;2021-09-01;4552;8594;1358112;1223734;66.8;60.2
13;2021-09-02;4470;8477;1362582;1232211;67.0;60.6
13;2021-09-03;4264;9293;1366846;1241504;67.2;61.0
13;2021-09-04;2167;5563;1369013;1247067;67.3;61.3
13;2021-09-05;183;393;1369196;1247460;67.3;61.3
13;2021-09-06;3101;6714;1372297;1254174;67.5;61.6
13;2021-09-07;3213;7280;1375510;1261454;67.6;62.0
13;2021-09-08;3498;7162;1379008;1268616;67.8;62.4
13;2021-09-09;3159;6706;1382167;1275322;67.9;62.7
13;2021-09-10;3650;7760;1385817;1283082;68.1;63.1
13;2021-09-11;2288;5471;1388105;1288553;68.2;63.3
13;2021-09-12;227;334;1388332;1288887;68.2;63.4
13;2021-09-13;2471;5227;1390803;1294114;68.4;63.6
13;2021-09-14;3156;6339;1393959;1300453;68.5;63.9
13;2021-09-15;2871;5510;1396830;1305963;68.7;64.2
13;2021-09-16;2204;3896;1399034;1309859;68.8;64.4
13;2021-09-17;2313;4873;1401347;1314732;68.9;64.6
13;2021-09-18;1523;4244;1402870;1318976;69.0;64.8
13;2021-09-19;123;174;1402993;1319150;69.0;64.8
13;2021-09-20;1530;3306;1404523;1322456;69.0;65.0
13;2021-09-21;1471;2921;1405994;1325377;69.1;65.1
13;2021-09-22;1637;4541;1407631;1329918;69.2;65.4
13;2021-09-23;1601;3533;1409232;1333451;69.3;65.5
13;2021-09-24;1617;4267;1410849;1337718;69.3;65.8
13;2021-09-25;1221;3966;1412070;1341684;69.4;65.9
13;2021-09-26;87;258;1412157;1341942;69.4;66.0
13;2021-09-27;1246;3152;1413403;1345094;69.5;66.1
13;2021-09-28;1323;2632;1414726;1347726;69.5;66.2
13;2021-09-29;1592;3548;1416318;1351274;69.6;66.4
13;2021-09-30;1345;3188;1417663;1354462;69.7;66.6
13;2021-10-01;1533;3551;1419196;1358013;69.8;66.8
13;2021-10-02;1166;2804;1420362;1360817;69.8;66.9
13;2021-10-03;86;413;1420448;1361230;69.8;66.9
14;2020-12-27;0;0;0;0;0.0;0.0
14;2020-12-28;1;1;1;1;0.0;0.0
14;2020-12-29;1;0;2;1;0.0;0.0
14;2020-12-30;0;0;2;1;0.0;0.0
14;2020-12-31;3;0;5;1;0.0;0.0
14;2021-01-01;1;0;6;1;0.0;0.0
14;2021-01-02;1;0;7;1;0.0;0.0
14;2021-01-03;0;0;7;1;0.0;0.0
14;2021-01-04;10;0;17;1;0.0;0.0
14;2021-01-05;24;0;41;1;0.0;0.0
14;2021-01-06;350;0;391;1;0.1;0.0
14;2021-01-07;402;2;793;3;0.1;0.0
14;2021-01-08;631;2;1424;5;0.2;0.0
14;2021-01-09;127;0;1551;5;0.2;0.0
14;2021-01-10;41;0;1592;5;0.2;0.0
14;2021-01-11;673;1;2265;6;0.3;0.0
14;2021-01-12;954;2;3219;8;0.5;0.0
14;2021-01-13;849;1;4068;9;0.6;0.0
14;2021-01-14;2840;14;6908;23;1.0;0.0
14;2021-01-15;1898;17;8806;40;1.3;0.0
14;2021-01-16;271;3;9077;43;1.3;0.0
14;2021-01-17;145;7;9222;50;1.3;0.0
14;2021-01-18;1086;5;10308;55;1.5;0.0
14;2021-01-19;1154;2;11462;57;1.7;0.0
14;2021-01-20;1988;2;13450;59;1.9;0.0
14;2021-01-21;1817;6;15267;65;2.2;0.0
14;2021-01-22;1494;5;16761;70;2.4;0.0
14;2021-01-23;297;1;17058;71;2.5;0.0
14;2021-01-24;73;1;17131;72;2.5;0.0
14;2021-01-25;911;10;18042;82;2.6;0.0
14;2021-01-26;848;35;18890;117;2.7;0.0
14;2021-01-27;884;156;19774;273;2.9;0.0
14;2021-01-28;782;103;20556;376;3.0;0.1
14;2021-01-29;786;220;21342;596;3.1;0.1
14;2021-01-30;270;11;21612;607;3.1;0.1
14;2021-01-31;58;1;21670;608;3.1;0.1
14;2021-02-01;729;219;22399;827;3.2;0.1
14;2021-02-02;830;412;23229;1239;3.4;0.2
14;2021-02-03;761;369;23990;1608;3.5;0.2
14;2021-02-04;1171;1850;25161;3458;3.6;0.5
14;2021-02-05;1296;1271;26457;4729;3.8;0.7
14;2021-02-06;396;210;26853;4939;3.9;0.7
14;2021-02-07;179;58;27032;4997;3.9;0.7
14;2021-02-08;774;677;27806;5674;4.0;0.8
14;2021-02-09;723;851;28529;6525;4.1;0.9
14;2021-02-10;825;1411;29354;7936;4.2;1.1
14;2021-02-11;1351;1339;30705;9275;4.4;1.3
14;2021-02-12;1383;961;32088;10236;4.6;1.5
14;2021-02-13;308;152;32396;10388;4.7;1.5
14;2021-02-14;84;44;32480;10432;4.7;1.5
14;2021-02-15;443;869;32923;11301;4.8;1.6
14;2021-02-16;679;708;33602;12009;4.9;1.7
14;2021-02-17;405;759;34007;12768;4.9;1.8
14;2021-02-18;707;688;34714;13456;5.0;1.9
14;2021-02-19;733;599;35447;14055;5.1;2.0
14;2021-02-20;91;209;35538;14264;5.1;2.1
14;2021-02-21;6;79;35544;14343;5.1;2.1
14;2021-02-22;432;798;35976;15141;5.2;2.2
14;2021-02-23;487;695;36463;15836;5.3;2.3
14;2021-02-24;439;689;36902;16525;5.3;2.4
14;2021-02-25;1224;978;38126;17503;5.5;2.5
14;2021-02-26;1576;1014;39702;18517;5.7;2.7
14;2021-02-27;507;226;40209;18743;5.8;2.7
14;2021-02-28;27;32;40236;18775;5.8;2.7
14;2021-03-01;522;750;40758;19525;5.9;2.8
14;2021-03-02;966;665;41724;20190;6.0;2.9
14;2021-03-03;1080;721;42804;20911;6.2;3.0
14;2021-03-04;1949;723;44753;21634;6.5;3.1
14;2021-03-05;2435;782;47188;22416;6.8;3.2
14;2021-03-06;3078;177;50266;22593;7.3;3.3
14;2021-03-07;1196;59;51462;22652;7.4;3.3
14;2021-03-08;1253;710;52715;23362;7.6;3.4
14;2021-03-09;1741;645;54456;24007;7.9;3.5
14;2021-03-10;1835;533;56291;24540;8.1;3.5
14;2021-03-11;2759;433;59050;24973;8.5;3.6
14;2021-03-12;4047;539;63097;25512;9.1;3.7
14;2021-03-13;1852;169;64949;25681;9.4;3.7
14;2021-03-14;31;38;64980;25719;9.4;3.7
14;2021-03-15;2006;142;66986;25861;9.7;3.7
14;2021-03-16;1401;265;68387;26126;9.9;3.8
14;2021-03-17;1155;194;69542;26320;10.1;3.8
14;2021-03-18;1481;295;71023;26615;10.3;3.8
14;2021-03-19;2608;260;73631;26875;10.6;3.9
14;2021-03-20;2659;41;76290;26916;11.0;3.9
14;2021-03-21;454;8;76744;26924;11.1;3.9
14;2021-03-22;1872;360;78616;27284;11.4;3.9
14;2021-03-23;2179;320;80795;27604;11.7;4.0
14;2021-03-24;2432;191;83227;27795;12.0;4.0
14;2021-03-25;3292;317;86519;28112;12.5;4.1
14;2021-03-26;4608;474;91127;28586;13.2;4.1
14;2021-03-27;2230;225;93357;28811;13.5;4.2
14;2021-03-28;36;1;93393;28812;13.5;4.2
14;2021-03-29;1614;478;95007;29290;13.7;4.2
14;2021-03-30;2722;515;97729;29805;14.1;4.3
14;2021-03-31;2326;922;100055;30727;14.5;4.4
14;2021-04-01;4175;1681;104230;32408;15.1;4.7
14;2021-04-02;3867;1266;108097;33674;15.6;4.9
14;2021-04-03;1126;1200;109223;34874;15.8;5.0
14;2021-04-04;25;482;109248;35356;15.8;5.1
14;2021-04-05;1218;324;110466;35680;16.0;5.2
14;2021-04-06;2383;996;112849;36676;16.3;5.3
14;2021-04-07;2730;1032;115579;37708;16.7;5.5
14;2021-04-08;4303;1118;119882;38826;17.3;5.6
14;2021-04-09;6030;1184;125912;40010;18.2;5.8
14;2021-04-10;2896;440;128808;40450;18.6;5.8
14;2021-04-11;629;121;129437;40571;18.7;5.9
14;2021-04-12;2915;1583;132352;42154;19.1;6.1
14;2021-04-13;3471;1442;135823;43596;19.6;6.3
14;2021-04-14;3123;1166;138946;44762;20.1;6.5
14;2021-04-15;4398;1504;143344;46266;20.7;6.7
14;2021-04-16;4598;1566;147942;47832;21.4;6.9
14;2021-04-17;2311;1668;150253;49500;21.7;7.2
14;2021-04-18;539;327;150792;49827;21.8;7.2
14;2021-04-19;2759;1684;153551;51511;22.2;7.4
14;2021-04-20;3389;1816;156940;53327;22.7;7.7
14;2021-04-21;3015;1468;159955;54795;23.1;7.9
14;2021-04-22;4230;2088;164185;56883;23.7;8.2
14;2021-04-23;4651;2302;168836;59185;24.4;8.6
14;2021-04-24;1851;1747;170687;60932;24.7;8.8
14;2021-04-25;456;29;171143;60961;24.8;8.8
14;2021-04-26;3379;1565;174522;62526;25.2;9.0
14;2021-04-27;3503;2560;178025;65086;25.7;9.4
14;2021-04-28;3245;1897;181270;66983;26.2;9.7
14;2021-04-29;4544;2307;185814;69290;26.9;10.0
14;2021-04-30;5124;2629;190938;71919;27.6;10.4
14;2021-05-01;3554;201;194492;72120;28.1;10.4
14;2021-05-02;1237;55;195729;72175;28.3;10.4
14;2021-05-03;2482;2763;198211;74938;28.7;10.8
14;2021-05-04;3128;2892;201339;77830;29.1;11.3
14;2021-05-05;3687;2742;205026;80572;29.7;11.7
14;2021-05-06;4929;3474;209955;84046;30.4;12.2
14;2021-05-07;4868;3834;214823;87880;31.1;12.7
14;2021-05-08;2728;1263;217551;89143;31.5;12.9
14;2021-05-09;1914;671;219465;89814;31.7;13.0
14;2021-05-10;3637;3145;223102;92959;32.3;13.4
14;2021-05-11;4346;3599;227448;96558;32.9;14.0
14;2021-05-12;4053;3214;231501;99772;33.5;14.4
14;2021-05-13;4688;1131;236189;100903;34.2;14.6
14;2021-05-14;6674;2626;242863;103529;35.1;15.0
14;2021-05-15;5148;778;248011;104307;35.9;15.1
14;2021-05-16;2319;120;250330;104427;36.2;15.1
14;2021-05-17;2820;2257;253150;106684;36.6;15.4
14;2021-05-18;4089;2236;257239;108920;37.2;15.8
14;2021-05-19;3752;2022;260991;110942;37.7;16.0
14;2021-05-20;4482;2764;265473;113706;38.4;16.4
14;2021-05-21;4276;3522;269749;117228;39.0;17.0
14;2021-05-22;1669;863;271418;118091;39.3;17.1
14;2021-05-23;649;71;272067;118162;39.3;17.1
14;2021-05-24;2845;751;274912;118913;39.8;17.2
14;2021-05-25;3637;3382;278549;122295;40.3;17.7
14;2021-05-26;3438;2406;281987;124701;40.8;18.0
14;2021-05-27;4771;3232;286758;127933;41.5;18.5
14;2021-05-28;5090;3864;291848;131797;42.2;19.1
14;2021-05-29;2342;2454;294190;134251;42.5;19.4
14;2021-05-30;759;237;294949;134488;42.7;19.5
14;2021-05-31;4091;2964;299040;137452;43.2;19.9
14;2021-06-01;5738;3202;304778;140654;44.1;20.3
14;2021-06-02;5024;2861;309802;143515;44.8;20.8
14;2021-06-03;6658;4017;316460;147532;45.8;21.3
14;2021-06-04;6445;5133;322905;152665;46.7;22.1
14;2021-06-05;4359;1860;327264;154525;47.3;22.3
14;2021-06-06;2043;83;329307;154608;47.6;22.4
14;2021-06-07;4253;3447;333560;158055;48.2;22.9
14;2021-06-08;5234;3128;338794;161183;49.0;23.3
14;2021-06-09;4270;2964;343064;164147;49.6;23.7
14;2021-06-10;5080;2968;348144;167115;50.3;24.2
14;2021-06-11;4840;4875;352984;171990;51.0;24.9
14;2021-06-12;3677;4519;356661;176509;51.6;25.5
14;2021-06-13;848;1089;357509;177598;51.7;25.7
14;2021-06-14;2185;3790;359694;181388;52.0;26.2
14;2021-06-15;3314;3970;363008;185358;52.5;26.8
14;2021-06-16;3445;4553;366453;189911;53.0;27.5
14;2021-06-17;4230;5264;370683;195175;53.6;28.2
14;2021-06-18;3732;6119;374415;201294;54.1;29.1
14;2021-06-19;2591;2951;377006;204245;54.5;29.5
14;2021-06-20;581;1556;377587;205801;54.6;29.8
14;2021-06-21;2121;4355;379708;210156;54.9;30.4
14;2021-06-22;2582;5179;382290;215335;55.3;31.1
14;2021-06-23;2503;4348;384793;219683;55.6;31.8
14;2021-06-24;3450;5810;388243;225493;56.1;32.6
14;2021-06-25;2751;7272;390994;232765;56.5;33.7
14;2021-06-26;2176;4539;393170;237304;56.9;34.3
14;2021-06-27;440;1828;393610;239132;56.9;34.6
14;2021-06-28;1311;3963;394921;243095;57.1;35.2
14;2021-06-29;1789;5362;396710;248457;57.4;35.9
14;2021-06-30;2024;4618;398734;253075;57.7;36.6
14;2021-07-01;2931;5067;401665;258142;58.1;37.3
14;2021-07-02;2600;6666;404265;264808;58.5;38.3
14;2021-07-03;1430;2646;405695;267454;58.7;38.7
14;2021-07-04;422;713;406117;268167;58.7;38.8
14;2021-07-05;1191;4778;407308;272945;58.9;39.5
14;2021-07-06;2090;6000;409398;278945;59.2;40.3
14;2021-07-07;2256;4577;411654;283522;59.5;41.0
14;2021-07-08;2912;5525;414566;289047;60.0;41.8
14;2021-07-09;2771;6431;417337;295478;60.4;42.7
14;2021-07-10;2038;3203;419375;298681;60.7;43.2
14;2021-07-11;900;871;420275;299552;60.8;43.3
14;2021-07-12;1634;5902;421909;305454;61.0;44.2
14;2021-07-13;3081;7338;424990;312792;61.5;45.2
14;2021-07-14;2259;3064;427249;315856;61.8;45.7
14;2021-07-15;4172;7652;431421;323508;62.4;46.8
14;2021-07-16;4708;7695;436129;331203;63.1;47.9
14;2021-07-17;2114;4211;438243;335414;63.4;48.5
14;2021-07-18;821;1870;439064;337284;63.5;48.8
14;2021-07-19;2599;6123;441663;343407;63.9;49.7
14;2021-07-20;3247;7253;444910;350660;64.3;50.7
14;2021-07-21;4105;5842;449015;356502;64.9;51.6
14;2021-07-22;4852;6602;453867;363104;65.6;52.5
14;2021-07-23;5384;6769;459251;369873;66.4;53.5
14;2021-07-24;3084;3790;462335;373663;66.9;54.0
14;2021-07-25;1504;1249;463839;374912;67.1;54.2
14;2021-07-26;4682;4186;468521;379098;67.8;54.8
14;2021-07-27;5404;4359;473925;383457;68.5;55.5
14;2021-07-28;5117;3973;479042;387430;69.3;56.0
14;2021-07-29;6446;4884;485488;392314;70.2;56.7
14;2021-07-30;5842;5169;491330;397483;71.1;57.5
14;2021-07-31;2774;2509;494104;399992;71.5;57.8
14;2021-08-01;1895;934;495999;400926;71.7;58.0
14;2021-08-02;3947;4290;499946;405216;72.3;58.6
14;2021-08-03;4482;4172;504428;409388;73.0;59.2
14;2021-08-04;4650;3537;509078;412925;73.6;59.7
14;2021-08-05;4658;4037;513736;416962;74.3;60.3
14;2021-08-06;4432;4808;518168;421770;74.9;61.0
14;2021-08-07;2133;2294;520301;424064;75.2;61.3
14;2021-08-08;638;854;520939;424918;75.3;61.5
14;2021-08-09;2129;2877;523068;427795;75.6;61.9
14;2021-08-10;3661;4171;526729;431966;76.2;62.5
14;2021-08-11;3076;3449;529805;435415;76.6;63.0
14;2021-08-12;3482;4351;533287;439766;77.1;63.6
14;2021-08-13;2638;4139;535925;443905;77.5;64.2
14;2021-08-14;1424;2009;537349;445914;77.7;64.5
14;2021-08-15;389;1484;537738;447398;77.8;64.7
14;2021-08-16;1833;2785;539571;450183;78.0;65.1
14;2021-08-17;2263;4570;541834;454753;78.4;65.8
14;2021-08-18;2063;4527;543897;459280;78.7;66.4
14;2021-08-19;2336;5086;546233;464366;79.0;67.2
14;2021-08-20;2189;5403;548422;469769;79.3;67.9
14;2021-08-21;1016;2837;549438;472606;79.5;68.3
14;2021-08-22;170;1564;549608;474170;79.5;68.6
14;2021-08-23;1269;4170;550877;478340;79.7;69.2
14;2021-08-24;1347;4302;552224;482642;79.9;69.8
14;2021-08-25;1399;4399;553623;487041;80.1;70.4
14;2021-08-26;1432;5081;555055;492122;80.3;71.2
14;2021-08-27;1468;5289;556523;497411;80.5;71.9
14;2021-08-28;733;3003;557256;500414;80.6;72.4
14;2021-08-29;185;1014;557441;501428;80.6;72.5
14;2021-08-30;1017;3631;558458;505059;80.8;73.0
14;2021-08-31;1329;4805;559787;509864;81.0;73.7
14;2021-09-01;1068;3986;560855;513850;81.1;74.3
14;2021-09-02;862;3350;561717;517200;81.2;74.8
14;2021-09-03;1180;4354;562897;521554;81.4;75.4
14;2021-09-04;665;2371;563562;523925;81.5;75.8
14;2021-09-05;126;413;563688;524338;81.5;75.8
14;2021-09-06;468;2223;564156;526561;81.6;76.2
14;2021-09-07;497;2200;564653;528761;81.7;76.5
14;2021-09-08;679;3173;565332;531934;81.8;76.9
14;2021-09-09;594;2213;565926;534147;81.8;77.2
14;2021-09-10;770;2868;566696;537015;82.0;77.7
14;2021-09-11;521;1626;567217;538641;82.0;77.9
14;2021-09-12;75;295;567292;538936;82.0;77.9
14;2021-09-13;311;1601;567603;540537;82.1;78.2
14;2021-09-14;655;1904;568258;542441;82.2;78.4
14;2021-09-15;715;1998;568973;544439;82.3;78.7
14;2021-09-16;586;1338;569559;545777;82.4;78.9
14;2021-09-17;628;1453;570187;547230;82.5;79.1
14;2021-09-18;217;970;570404;548200;82.5;79.3
14;2021-09-19;41;137;570445;548337;82.5;79.3
14;2021-09-20;331;810;570776;549147;82.5;79.4
14;2021-09-21;538;847;571314;549994;82.6;79.5
14;2021-09-22;483;1754;571797;551748;82.7;79.8
14;2021-09-23;446;784;572243;552532;82.8;79.9
14;2021-09-24;403;1308;572646;553840;82.8;80.1
14;2021-09-25;188;688;572834;554528;82.8;80.2
14;2021-09-26;41;139;572875;554667;82.9;80.2
14;2021-09-27;276;710;573151;555377;82.9;80.3
14;2021-09-28;358;673;573509;556050;82.9;80.4
14;2021-09-29;305;918;573814;556968;83.0;80.6
14;2021-09-30;335;685;574149;557653;83.0;80.6
14;2021-10-01;445;829;574594;558482;83.1;80.8
14;2021-10-02;244;514;574838;558996;83.1;80.8
14;2021-10-03;37;61;574875;559057;83.1;80.9
15;2020-12-27;2;0;2;0;0.0;0.0
15;2020-12-28;0;0;2;0;0.0;0.0
15;2020-12-29;0;0;2;0;0.0;0.0
15;2020-12-30;0;0;2;0;0.0;0.0
15;2020-12-31;0;0;2;0;0.0;0.0
15;2021-01-01;1;0;3;0;0.0;0.0
15;2021-01-02;0;0;3;0;0.0;0.0
15;2021-01-03;0;0;3;0;0.0;0.0
15;2021-01-04;0;0;3;0;0.0;0.0
15;2021-01-05;0;0;3;0;0.0;0.0
15;2021-01-06;0;0;3;0;0.0;0.0
15;2021-01-07;72;0;75;0;0.1;0.0
15;2021-01-08;110;0;185;0;0.1;0.0
15;2021-01-09;0;0;185;0;0.1;0.0
15;2021-01-10;2;0;187;0;0.1;0.0
15;2021-01-11;99;0;286;0;0.2;0.0
15;2021-01-12;94;0;380;0;0.3;0.0
15;2021-01-13;230;0;610;0;0.4;0.0
15;2021-01-14;313;1;923;1;0.6;0.0
15;2021-01-15;138;0;1061;1;0.7;0.0
15;2021-01-16;90;0;1151;1;0.8;0.0
15;2021-01-17;0;0;1151;1;0.8;0.0
15;2021-01-18;404;2;1555;3;1.1;0.0
15;2021-01-19;550;0;2105;3;1.5;0.0
15;2021-01-20;629;1;2734;4;1.9;0.0
15;2021-01-21;576;4;3310;8;2.3;0.0
15;2021-01-22;502;1;3812;9;2.7;0.0
15;2021-01-23;432;1;4244;10;3.0;0.0
15;2021-01-24;6;0;4250;10;3.0;0.0
15;2021-01-25;401;0;4651;10;3.3;0.0
15;2021-01-26;437;0;5088;10;3.6;0.0
15;2021-01-27;736;7;5824;17;4.1;0.0
15;2021-01-28;623;51;6447;68;4.5;0.0
15;2021-01-29;336;80;6783;148;4.7;0.1
15;2021-01-30;218;3;7001;151;4.9;0.1
15;2021-01-31;1;1;7002;152;4.9;0.1
15;2021-02-01;239;81;7241;233;5.1;0.2
15;2021-02-02;189;80;7430;313;5.2;0.2
15;2021-02-03;267;145;7697;458;5.4;0.3
15;2021-02-04;663;166;8360;624;5.9;0.4
15;2021-02-05;296;200;8656;824;6.1;0.6
15;2021-02-06;98;52;8754;876;6.1;0.6
15;2021-02-07;0;0;8754;876;6.1;0.6
15;2021-02-08;233;85;8987;961;6.3;0.7
15;2021-02-09;206;105;9193;1066;6.4;0.7
15;2021-02-10;338;288;9531;1354;6.7;0.9
15;2021-02-11;117;225;9648;1579;6.8;1.1
15;2021-02-12;136;145;9784;1724;6.9;1.2
15;2021-02-13;92;75;9876;1799;6.9;1.3
15;2021-02-14;0;0;9876;1799;6.9;1.3
15;2021-02-15;64;177;9940;1976;7.0;1.4
15;2021-02-16;52;253;9992;2229;7.0;1.6
15;2021-02-17;134;383;10126;2612;7.1;1.8
15;2021-02-18;87;684;10213;3296;7.2;2.3
15;2021-02-19;90;381;10303;3677;7.2;2.6
15;2021-02-20;20;219;10323;3896;7.2;2.7
15;2021-02-21;0;0;10323;3896;7.2;2.7
15;2021-02-22;23;406;10346;4302;7.2;3.0
15;2021-02-23;180;391;10526;4693;7.4;3.3
15;2021-02-24;31;402;10557;5095;7.4;3.6
15;2021-02-25;228;829;10785;5924;7.6;4.1
15;2021-02-26;186;430;10971;6354;7.7;4.4
15;2021-02-27;145;77;11116;6431;7.8;4.5
15;2021-02-28;1;0;11117;6431;7.8;4.5
15;2021-03-01;121;197;11238;6628;7.9;4.6
15;2021-03-02;250;278;11488;6906;8.0;4.8
15;2021-03-03;207;26;11695;6932;8.2;4.9
15;2021-03-04;246;227;11941;7159;8.4;5.0
15;2021-03-05;348;164;12289;7323;8.6;5.1
15;2021-03-06;680;11;12969;7334;9.1;5.1
15;2021-03-07;81;2;13050;7336;9.1;5.1
15;2021-03-08;93;101;13143;7437;9.2;5.2
15;2021-03-09;281;269;13424;7706;9.4;5.4
15;2021-03-10;417;167;13841;7873;9.7;5.5
15;2021-03-11;434;279;14275;8152;10.0;5.7
15;2021-03-12;525;90;14800;8242;10.4;5.8
15;2021-03-13;355;7;15155;8249;10.6;5.8
15;2021-03-14;18;0;15173;8249;10.6;5.8
15;2021-03-15;542;64;15715;8313;11.0;5.8
15;2021-03-16;328;22;16043;8335;11.2;5.8
15;2021-03-17;130;53;16173;8388;11.3;5.9
15;2021-03-18;250;93;16423;8481;11.5;5.9
15;2021-03-19;669;31;17092;8512;12.0;6.0
15;2021-03-20;148;38;17240;8550;12.1;6.0
15;2021-03-21;6;0;17246;8550;12.1;6.0
15;2021-03-22;575;79;17821;8629;12.5;6.0
15;2021-03-23;776;101;18597;8730;13.0;6.1
15;2021-03-24;936;36;19533;8766;13.7;6.1
15;2021-03-25;1282;33;20815;8799;14.6;6.2
15;2021-03-26;1009;62;21824;8861;15.3;6.2
15;2021-03-27;301;7;22125;8868;15.5;6.2
15;2021-03-28;20;0;22145;8868;15.5;6.2
15;2021-03-29;782;18;22927;8886;16.1;6.2
15;2021-03-30;1135;203;24062;9089;16.8;6.4
15;2021-03-31;941;26;25003;9115;17.5;6.4
15;2021-04-01;1233;62;26236;9177;18.4;6.4
15;2021-04-02;1141;61;27377;9238;19.2;6.5
15;2021-04-03;120;18;27497;9256;19.3;6.5
15;2021-04-04;0;0;27497;9256;19.3;6.5
15;2021-04-05;33;3;27530;9259;19.3;6.5
15;2021-04-06;834;86;28364;9345;19.9;6.5
15;2021-04-07;663;108;29027;9453;20.3;6.6
15;2021-04-08;1246;150;30273;9603;21.2;6.7
15;2021-04-09;1277;106;31550;9709;22.1;6.8
15;2021-04-10;364;20;31914;9729;22.3;6.8
15;2021-04-11;14;0;31928;9729;22.4;6.8
15;2021-04-12;644;457;32572;10186;22.8;7.1
15;2021-04-13;1124;321;33696;10507;23.6;7.4
15;2021-04-14;1038;199;34734;10706;24.3;7.5
15;2021-04-15;1183;311;35917;11017;25.2;7.7
15;2021-04-16;1038;552;36955;11569;25.9;8.1
15;2021-04-17;445;14;37400;11583;26.2;8.1
15;2021-04-18;0;10;37400;11593;26.2;8.1
15;2021-04-19;537;514;37937;12107;26.6;8.5
15;2021-04-20;847;615;38784;12722;27.2;8.9
15;2021-04-21;593;651;39377;13373;27.6;9.4
15;2021-04-22;728;775;40105;14148;28.1;9.9
15;2021-04-23;730;676;40835;14824;28.6;10.4
15;2021-04-24;363;123;41198;14947;28.8;10.5
15;2021-04-25;1;3;41199;14950;28.8;10.5
15;2021-04-26;325;632;41524;15582;29.1;10.9
15;2021-04-27;467;938;41991;16520;29.4;11.6
15;2021-04-28;383;785;42374;17305;29.7;12.1
15;2021-04-29;587;1005;42961;18310;30.1;12.8
15;2021-04-30;547;1070;43508;19380;30.5;13.6
15;2021-05-01;283;29;43791;19409;30.7;13.6
15;2021-05-02;0;0;43791;19409;30.7;13.6
15;2021-05-03;881;331;44672;19740;31.3;13.8
15;2021-05-04;801;854;45473;20594;31.8;14.4
15;2021-05-05;676;680;46149;21274;32.3;14.9
15;2021-05-06;826;967;46975;22241;32.9;15.6
15;2021-05-07;1154;903;48129;23144;33.7;16.2
15;2021-05-08;491;55;48620;23199;34.0;16.2
15;2021-05-09;24;9;48644;23208;34.1;16.3
15;2021-05-10;704;910;49348;24118;34.6;16.9
15;2021-05-11;1186;1182;50534;25300;35.4;17.7
15;2021-05-12;1147;837;51681;26137;36.2;18.3
15;2021-05-13;1165;440;52846;26577;37.0;18.6
15;2021-05-14;1503;582;54349;27159;38.1;19.0
15;2021-05-15;1410;418;55759;27577;39.0;19.3
15;2021-05-16;1;10;55760;27587;39.0;19.3
15;2021-05-17;999;605;56759;28192;39.7;19.7
15;2021-05-18;1221;970;57980;29162;40.6;20.4
15;2021-05-19;1020;459;59000;29621;41.3;20.7
15;2021-05-20;1239;781;60239;30402;42.2;21.3
15;2021-05-21;1348;749;61587;31151;43.1;21.8
15;2021-05-22;527;188;62114;31339;43.5;21.9
15;2021-05-23;2;11;62116;31350;43.5;22.0
15;2021-05-24;693;257;62809;31607;44.0;22.1
15;2021-05-25;1151;620;63960;32227;44.8;22.6
15;2021-05-26;1093;459;65053;32686;45.6;22.9
15;2021-05-27;1271;660;66324;33346;46.4;23.3
15;2021-05-28;1509;883;67833;34229;47.5;24.0
15;2021-05-29;984;360;68817;34589;48.2;24.2
15;2021-05-30;14;25;68831;34614;48.2;24.2
15;2021-05-31;1200;480;70031;35094;49.0;24.6
15;2021-06-01;1398;570;71429;35664;50.0;25.0
15;2021-06-02;864;417;72293;36081;50.6;25.3
15;2021-06-03;932;701;73225;36782;51.3;25.8
15;2021-06-04;1076;713;74301;37495;52.0;26.3
15;2021-06-05;651;262;74952;37757;52.5;26.4
15;2021-06-06;16;20;74968;37777;52.5;26.5
15;2021-06-07;797;350;75765;38127;53.1;26.7
15;2021-06-08;477;394;76242;38521;53.4;27.0
15;2021-06-09;375;376;76617;38897;53.6;27.2
15;2021-06-10;276;423;76893;39320;53.8;27.5
15;2021-06-11;660;1099;77553;40419;54.3;28.3
15;2021-06-12;377;467;77930;40886;54.6;28.6
15;2021-06-13;11;6;77941;40892;54.6;28.6
15;2021-06-14;542;977;78483;41869;55.0;29.3
15;2021-06-15;450;1164;78933;43033;55.3;30.1
15;2021-06-16;543;899;79476;43932;55.7;30.8
15;2021-06-17;292;934;79768;44866;55.9;31.4
15;2021-06-18;740;1205;80508;46071;56.4;32.3
15;2021-06-19;542;704;81050;46775;56.8;32.8
15;2021-06-20;11;1;81061;46776;56.8;32.8
15;2021-06-21;279;1042;81340;47818;57.0;33.5
15;2021-06-22;232;1480;81572;49298;57.1;34.5
15;2021-06-23;346;1445;81918;50743;57.4;35.5
15;2021-06-24;291;1094;82209;51837;57.6;36.3
15;2021-06-25;379;1640;82588;53477;57.8;37.4
15;2021-06-26;164;908;82752;54385;57.9;38.1
15;2021-06-27;0;0;82752;54385;57.9;38.1
15;2021-06-28;176;1228;82928;55613;58.1;38.9
15;2021-06-29;302;1264;83230;56877;58.3;39.8
15;2021-06-30;268;981;83498;57858;58.5;40.5
15;2021-07-01;380;1220;83878;59078;58.7;41.4
15;2021-07-02;410;1348;84288;60426;59.0;42.3
15;2021-07-03;252;707;84540;61133;59.2;42.8
15;2021-07-04;1;1;84541;61134;59.2;42.8
15;2021-07-05;248;1257;84789;62391;59.4;43.7
15;2021-07-06;275;1467;85064;63858;59.6;44.7
15;2021-07-07;255;1343;85319;65201;59.7;45.7
15;2021-07-08;489;1353;85808;66554;60.1;46.6
15;2021-07-09;488;1783;86296;68337;60.4;47.9
15;2021-07-10;215;862;86511;69199;60.6;48.5
15;2021-07-11;9;5;86520;69204;60.6;48.5
15;2021-07-12;278;1484;86798;70688;60.8;49.5
15;2021-07-13;587;1776;87385;72464;61.2;50.7
15;2021-07-14;16;130;87401;72594;61.2;50.8
15;2021-07-15;1132;728;88533;73322;62.0;51.3
15;2021-07-16;1139;1336;89672;74658;62.8;52.3
15;2021-07-17;819;953;90491;75611;63.4;52.9
15;2021-07-18;0;3;90491;75614;63.4;52.9
15;2021-07-19;1074;1270;91565;76884;64.1;53.8
15;2021-07-20;1612;547;93177;77431;65.2;54.2
15;2021-07-21;1189;603;94366;78034;66.1;54.6
15;2021-07-22;894;511;95260;78545;66.7;55.0
15;2021-07-23;1341;1064;96601;79609;67.6;55.7
15;2021-07-24;628;769;97229;80378;68.1;56.3
15;2021-07-25;1;24;97230;80402;68.1;56.3
15;2021-07-26;1247;594;98477;80996;69.0;56.7
15;2021-07-27;1691;576;100168;81572;70.1;57.1
15;2021-07-28;1238;581;101406;82153;71.0;57.5
15;2021-07-29;838;399;102244;82552;71.6;57.8
15;2021-07-30;1007;1130;103251;83682;72.3;58.6
15;2021-07-31;604;637;103855;84319;72.7;59.0
15;2021-08-01;21;12;103876;84331;72.7;59.1
15;2021-08-02;1143;543;105019;84874;73.5;59.4
15;2021-08-03;1162;383;106181;85257;74.4;59.7
15;2021-08-04;788;408;106969;85665;74.9;60.0
15;2021-08-05;383;284;107352;85949;75.2;60.2
15;2021-08-06;789;1235;108141;87184;75.7;61.0
15;2021-08-07;265;1160;108406;88344;75.9;61.9
15;2021-08-08;3;6;108409;88350;75.9;61.9
15;2021-08-09;511;1164;108920;89514;76.3;62.7
15;2021-08-10;435;725;109355;90239;76.6;63.2
15;2021-08-11;411;1007;109766;91246;76.9;63.9
15;2021-08-12;520;1182;110286;92428;77.2;64.7
15;2021-08-13;682;1137;110968;93565;77.7;65.5
15;2021-08-14;179;552;111147;94117;77.8;65.9
15;2021-08-15;17;9;111164;94126;77.8;65.9
15;2021-08-16;387;1134;111551;95260;78.1;66.7
15;2021-08-17;402;1140;111953;96400;78.4;67.5
15;2021-08-18;368;803;112321;97203;78.7;68.1
15;2021-08-19;300;878;112621;98081;78.9;68.7
15;2021-08-20;601;1215;113222;99296;79.3;69.5
15;2021-08-21;218;867;113440;100163;79.4;70.1
15;2021-08-22;12;26;113452;100189;79.4;70.2
15;2021-08-23;229;611;113681;100800;79.6;70.6
15;2021-08-24;246;590;113927;101390;79.8;71.0
15;2021-08-25;155;493;114082;101883;79.9;71.3
15;2021-08-26;136;363;114218;102246;80.0;71.6
15;2021-08-27;366;1337;114584;103583;80.2;72.5
15;2021-08-28;214;857;114798;104440;80.4;73.1
15;2021-08-29;7;13;114805;104453;80.4;73.1
15;2021-08-30;225;1062;115030;105515;80.5;73.9
15;2021-08-31;404;667;115434;106182;80.8;74.4
15;2021-09-01;182;445;115616;106627;81.0;74.7
15;2021-09-02;97;275;115713;106902;81.0;74.9
15;2021-09-03;202;1007;115915;107909;81.2;75.6
15;2021-09-04;157;422;116072;108331;81.3;75.9
15;2021-09-05;0;2;116072;108333;81.3;75.9
15;2021-09-06;98;490;116170;108823;81.3;76.2
15;2021-09-07;100;230;116270;109053;81.4;76.4
15;2021-09-08;200;589;116470;109642;81.6;76.8
15;2021-09-09;100;353;116570;109995;81.6;77.0
15;2021-09-10;231;997;116801;110992;81.8;77.7
15;2021-09-11;95;365;116896;111357;81.9;78.0
15;2021-09-12;0;0;116896;111357;81.9;78.0
15;2021-09-13;102;386;116998;111743;81.9;78.2
15;2021-09-14;122;254;117120;111997;82.0;78.4
15;2021-09-15;69;247;117189;112244;82.1;78.6
15;2021-09-16;33;101;117222;112345;82.1;78.7
15;2021-09-17;265;604;117487;112949;82.3;79.1
15;2021-09-18;79;380;117566;113329;82.3;79.4
15;2021-09-19;0;0;117566;113329;82.3;79.4
15;2021-09-20;123;217;117689;113546;82.4;79.5
15;2021-09-21;41;107;117730;113653;82.4;79.6
15;2021-09-22;84;355;117814;114008;82.5;79.8
15;2021-09-23;37;108;117851;114116;82.5;79.9
15;2021-09-24;138;334;117989;114450;82.6;80.1
15;2021-09-25;42;217;118031;114667;82.6;80.3
15;2021-09-26;1;5;118032;114672;82.6;80.3
15;2021-09-27;88;133;118120;114805;82.7;80.4
15;2021-09-28;74;131;118194;114936;82.8;80.5
15;2021-09-29;69;191;118263;115127;82.8;80.6
15;2021-09-30;37;93;118300;115220;82.8;80.7
15;2021-10-01;117;216;118417;115436;82.9;80.8
15;2021-10-02;30;143;118447;115579;82.9;80.9
15;2021-10-03;0;2;118447;115581;82.9;80.9
16;2020-12-27;0;0;0;0;0.0;0.0
16;2020-12-28;2;0;2;0;0.0;0.0
16;2020-12-29;0;0;2;0;0.0;0.0
16;2020-12-30;1;0;3;0;0.0;0.0
16;2020-12-31;0;0;3;0;0.0;0.0
16;2021-01-01;0;0;3;0;0.0;0.0
16;2021-01-02;0;0;3;0;0.0;0.0
16;2021-01-03;0;0;3;0;0.0;0.0
16;2021-01-04;1;0;4;0;0.0;0.0
16;2021-01-05;1;0;5;0;0.0;0.0
16;2021-01-06;88;0;93;0;0.0;0.0
16;2021-01-07;240;0;333;0;0.1;0.0
16;2021-01-08;465;2;798;2;0.2;0.0
16;2021-01-09;1;0;799;2;0.2;0.0
16;2021-01-10;1;0;800;2;0.2;0.0
16;2021-01-11;304;0;1104;2;0.3;0.0
16;2021-01-12;437;1;1541;3;0.4;0.0
16;2021-01-13;480;0;2021;3;0.6;0.0
16;2021-01-14;601;6;2622;9;0.8;0.0
16;2021-01-15;504;3;3126;12;0.9;0.0
16;2021-01-16;0;0;3126;12;0.9;0.0
16;2021-01-17;0;0;3126;12;0.9;0.0
16;2021-01-18;432;2;3558;14;1.0;0.0
16;2021-01-19;835;2;4393;16;1.3;0.0
16;2021-01-20;1187;2;5580;18;1.6;0.0
16;2021-01-21;1383;3;6963;21;2.0;0.0
16;2021-01-22;1115;0;8078;21;2.3;0.0
16;2021-01-23;183;0;8261;21;2.4;0.0
16;2021-01-24;0;0;8261;21;2.4;0.0
16;2021-01-25;641;2;8902;23;2.6;0.0
16;2021-01-26;1025;1;9927;24;2.9;0.0
16;2021-01-27;1406;105;11333;129;3.3;0.0
16;2021-01-28;1276;53;12609;182;3.6;0.1
16;2021-01-29;742;125;13351;307;3.8;0.1
16;2021-01-30;36;0;13387;307;3.8;0.1
16;2021-01-31;0;0;13387;307;3.8;0.1
16;2021-02-01;394;197;13781;504;4.0;0.1
16;2021-02-02;576;161;14357;665;4.1;0.2
16;2021-02-03;621;342;14978;1007;4.3;0.3
16;2021-02-04;465;254;15443;1261;4.4;0.4
16;2021-02-05;505;261;15948;1522;4.6;0.4
16;2021-02-06;3;80;15951;1602;4.6;0.5
16;2021-02-07;41;3;15992;1605;4.6;0.5
16;2021-02-08;356;188;16348;1793;4.7;0.5
16;2021-02-09;650;248;16998;2041;4.9;0.6
16;2021-02-10;693;597;17691;2638;5.1;0.8
16;2021-02-11;802;515;18493;3153;5.3;0.9
16;2021-02-12;622;792;19115;3945;5.5;1.1
16;2021-02-13;43;77;19158;4022;5.5;1.2
16;2021-02-14;2;5;19160;4027;5.5;1.2
16;2021-02-15;217;570;19377;4597;5.6;1.3
16;2021-02-16;373;791;19750;5388;5.7;1.5
16;2021-02-17;346;1155;20096;6543;5.8;1.9
16;2021-02-18;511;1048;20607;7591;5.9;2.2
16;2021-02-19;389;637;20996;8228;6.0;2.4
16;2021-02-20;2;8;20998;8236;6.0;2.4
16;2021-02-21;2;0;21000;8236;6.0;2.4
16;2021-02-22;136;407;21136;8643;6.1;2.5
16;2021-02-23;206;677;21342;9320;6.1;2.7
16;2021-02-24;277;770;21619;10090;6.2;2.9
16;2021-02-25;395;528;22014;10618;6.3;3.0
16;2021-02-26;479;423;22493;11041;6.5;3.2
16;2021-02-27;249;1;22742;11042;6.5;3.2
16;2021-02-28;5;1;22747;11043;6.5;3.2
16;2021-03-01;152;237;22899;11280;6.6;3.2
16;2021-03-02;271;514;23170;11794;6.7;3.4
16;2021-03-03;390;621;23560;12415;6.8;3.6
16;2021-03-04;803;509;24363;12924;7.0;3.7
16;2021-03-05;1143;489;25506;13413;7.3;3.9
16;2021-03-06;753;13;26259;13426;7.5;3.9
16;2021-03-07;94;18;26353;13444;7.6;3.9
16;2021-03-08;437;272;26790;13716;7.7;3.9
16;2021-03-09;774;554;27564;14270;7.9;4.1
16;2021-03-10;606;593;28170;14863;8.1;4.3
16;2021-03-11;1447;506;29617;15369;8.5;4.4
16;2021-03-12;1164;422;30781;15791;8.8;4.5
16;2021-03-13;765;15;31546;15806;9.1;4.5
16;2021-03-14;1;0;31547;15806;9.1;4.5
16;2021-03-15;462;170;32009;15976;9.2;4.6
16;2021-03-16;860;401;32869;16377;9.4;4.7
16;2021-03-17;591;280;33460;16657;9.6;4.8
16;2021-03-18;1033;267;34493;16924;9.9;4.9
16;2021-03-19;1103;232;35596;17156;10.2;4.9
16;2021-03-20;396;5;35992;17161;10.3;4.9
16;2021-03-21;9;0;36001;17161;10.3;4.9
16;2021-03-22;728;96;36729;17257;10.5;5.0
16;2021-03-23;1464;101;38193;17358;11.0;5.0
16;2021-03-24;1123;182;39316;17540;11.3;5.0
16;2021-03-25;2047;87;41363;17627;11.9;5.1
16;2021-03-26;1916;98;43279;17725;12.4;5.1
16;2021-03-27;432;21;43711;17746;12.6;5.1
16;2021-03-28;0;0;43711;17746;12.6;5.1
16;2021-03-29;923;60;44634;17806;12.8;5.1
16;2021-03-30;1883;175;46517;17981;13.4;5.2
16;2021-03-31;1513;134;48030;18115;13.8;5.2
16;2021-04-01;2009;399;50039;18514;14.4;5.3
16;2021-04-02;1442;378;51481;18892;14.8;5.4
16;2021-04-03;288;5;51769;18897;14.9;5.4
16;2021-04-04;1;0;51770;18897;14.9;5.4
16;2021-04-05;2;0;51772;18897;14.9;5.4
16;2021-04-06;2013;546;53785;19443;15.4;5.6
16;2021-04-07;1954;404;55739;19847;16.0;5.7
16;2021-04-08;2824;583;58563;20430;16.8;5.9
16;2021-04-09;2695;552;61258;20982;17.6;6.0
16;2021-04-10;1290;37;62548;21019;18.0;6.0
16;2021-04-11;2;0;62550;21019;18.0;6.0
16;2021-04-12;1431;316;63981;21335;18.4;6.1
16;2021-04-13;2124;838;66105;22173;19.0;6.4
16;2021-04-14;1951;630;68056;22803;19.5;6.5
16;2021-04-15;2102;979;70158;23782;20.1;6.8
16;2021-04-16;2043;786;72201;24568;20.7;7.1
16;2021-04-17;1507;92;73708;24660;21.2;7.1
16;2021-04-18;197;3;73905;24663;21.2;7.1
16;2021-04-19;1440;523;75345;25186;21.6;7.2
16;2021-04-20;2053;1231;77398;26417;22.2;7.6
16;2021-04-21;1776;750;79174;27167;22.7;7.8
16;2021-04-22;2290;1007;81464;28174;23.4;8.1
16;2021-04-23;2362;1167;83826;29341;24.1;8.4
16;2021-04-24;829;38;84655;29379;24.3;8.4
16;2021-04-25;117;5;84772;29384;24.3;8.4
16;2021-04-26;1400;808;86172;30192;24.7;8.7
16;2021-04-27;2055;1410;88227;31602;25.3;9.1
16;2021-04-28;1592;1124;89819;32726;25.8;9.4
16;2021-04-29;2250;1483;92069;34209;26.4;9.8
16;2021-04-30;2856;1338;94925;35547;27.3;10.2
16;2021-05-01;353;60;95278;35607;27.4;10.2
16;2021-05-02;155;13;95433;35620;27.4;10.2
16;2021-05-03;2611;528;98044;36148;28.2;10.4
16;2021-05-04;2057;2040;100101;38188;28.7;11.0
16;2021-05-05;1688;1826;101789;40014;29.2;11.5
16;2021-05-06;1886;2236;103675;42250;29.8;12.1
16;2021-05-07;3072;2115;106747;44365;30.7;12.7
16;2021-05-08;1197;466;107944;44831;31.0;12.9
16;2021-05-09;530;27;108474;44858;31.2;12.9
16;2021-05-10;1930;1623;110404;46481;31.7;13.3
16;2021-05-11;2354;1959;112758;48440;32.4;13.9
16;2021-05-12;1734;1792;114492;50232;32.9;14.4
16;2021-05-13;1461;354;115953;50586;33.3;14.5
16;2021-05-14;1988;1551;117941;52137;33.9;15.0
16;2021-05-15;596;895;118537;53032;34.0;15.2
16;2021-05-16;132;6;118669;53038;34.1;15.2
16;2021-05-17;1609;1285;120278;54323;34.5;15.6
16;2021-05-18;2756;1422;123034;55745;35.3;16.0
16;2021-05-19;2006;1241;125040;56986;35.9;16.4
16;2021-05-20;2832;1389;127872;58375;36.7;16.8
16;2021-05-21;2943;1388;130815;59763;37.6;17.2
16;2021-05-22;411;711;131226;60474;37.7;17.4
16;2021-05-23;210;11;131436;60485;37.7;17.4
16;2021-05-24;1262;234;132698;60719;38.1;17.4
16;2021-05-25;2759;1461;135457;62180;38.9;17.9
16;2021-05-26;1833;1184;137290;63364;39.4;18.2
16;2021-05-27;2416;1582;139706;64946;40.1;18.7
16;2021-05-28;2899;1556;142605;66502;41.0;19.1
16;2021-05-29;814;883;143419;67385;41.2;19.4
16;2021-05-30;1;4;143420;67389;41.2;19.4
16;2021-05-31;1984;1100;145404;68489;41.8;19.7
16;2021-06-01;2344;1703;147748;70192;42.4;20.2
16;2021-06-02;1820;1502;149568;71694;43.0;20.6
16;2021-06-03;2622;1758;152190;73452;43.7;21.1
16;2021-06-04;2833;2028;155023;75480;44.5;21.7
16;2021-06-05;1006;546;156029;76026;44.8;21.8
16;2021-06-06;161;29;156190;76055;44.9;21.8
16;2021-06-07;1991;1281;158181;77336;45.4;22.2
16;2021-06-08;2394;1991;160575;79327;46.1;22.8
16;2021-06-09;2528;1616;163103;80943;46.8;23.2
16;2021-06-10;2569;1995;165672;82938;47.6;23.8
16;2021-06-11;2152;2730;167824;85668;48.2;24.6
16;2021-06-12;1613;517;169437;86185;48.7;24.8
16;2021-06-13;260;72;169697;86257;48.7;24.8
16;2021-06-14;797;2795;170494;89052;49.0;25.6
16;2021-06-15;1866;2623;172360;91675;49.5;26.3
16;2021-06-16;1575;2083;173935;93758;50.0;26.9
16;2021-06-17;2040;2496;175975;96254;50.5;27.6
16;2021-06-18;2060;3214;178035;99468;51.1;28.6
16;2021-06-19;1352;1311;179387;100779;51.5;28.9
16;2021-06-20;243;28;179630;100807;51.6;29.0
16;2021-06-21;1411;2166;181041;102973;52.0;29.6
16;2021-06-22;1675;2943;182716;105916;52.5;30.4
16;2021-06-23;1562;2015;184278;107931;52.9;31.0
16;2021-06-24;1928;2167;186206;110098;53.5;31.6
16;2021-06-25;1984;2726;188190;112824;54.0;32.4
16;2021-06-26;1060;725;189250;113549;54.4;32.6
16;2021-06-27;132;25;189382;113574;54.4;32.6
16;2021-06-28;1164;1962;190546;115536;54.7;33.2
16;2021-06-29;1282;3359;191828;118895;55.1;34.1
16;2021-06-30;1337;2713;193165;121608;55.5;34.9
16;2021-07-01;1866;3153;195031;124761;56.0;35.8
16;2021-07-02;1423;3578;196454;128339;56.4;36.9
16;2021-07-03;696;1108;197150;129447;56.6;37.2
16;2021-07-04;3;15;197153;129462;56.6;37.2
16;2021-07-05;815;2297;197968;131759;56.9;37.8
16;2021-07-06;1278;3363;199246;135122;57.2;38.8
16;2021-07-07;871;2275;200117;137397;57.5;39.5
16;2021-07-08;1234;2732;201351;140129;57.8;40.2
16;2021-07-09;1113;3707;202464;143836;58.1;41.3
16;2021-07-10;338;1337;202802;145173;58.2;41.7
16;2021-07-11;2;13;202804;145186;58.2;41.7
16;2021-07-12;634;2432;203438;147618;58.4;42.4
16;2021-07-13;1385;3527;204823;151145;58.8;43.4
16;2021-07-14;797;877;205620;152022;59.1;43.7
16;2021-07-15;1249;3406;206869;155428;59.4;44.6
16;2021-07-16;1498;3377;208367;158805;59.8;45.6
16;2021-07-17;539;1188;208906;159993;60.0;46.0
16;2021-07-18;14;6;208920;159999;60.0;46.0
16;2021-07-19;618;2851;209538;162850;60.2;46.8
16;2021-07-20;1125;3281;210663;166131;60.5;47.7
16;2021-07-21;1117;2619;211780;168750;60.8;48.5
16;2021-07-22;1871;2853;213651;171603;61.4;49.3
16;2021-07-23;1552;3544;215203;175147;61.8;50.3
16;2021-07-24;639;1206;215842;176353;62.0;50.6
16;2021-07-25;11;11;215853;176364;62.0;50.7
16;2021-07-26;1529;2128;217382;178492;62.4;51.3
16;2021-07-27;1865;2819;219247;181311;63.0;52.1
16;2021-07-28;1863;2307;221110;183618;63.5;52.7
16;2021-07-29;2240;2473;223350;186091;64.1;53.4
16;2021-07-30;2355;3103;225705;189194;64.8;54.3
16;2021-07-31;960;1353;226665;190547;65.1;54.7
16;2021-08-01;192;22;226857;190569;65.2;54.7
16;2021-08-02;2121;1827;228978;192396;65.8;55.3
16;2021-08-03;2121;2323;231099;194719;66.4;55.9
16;2021-08-04;2121;1886;233220;196605;67.0;56.5
16;2021-08-05;2775;1654;235995;198259;67.8;56.9
16;2021-08-06;2511;2365;238506;200624;68.5;57.6
16;2021-08-07;828;559;239334;201183;68.7;57.8
16;2021-08-08;36;33;239370;201216;68.7;57.8
16;2021-08-09;2182;1060;241552;202276;69.4;58.1
16;2021-08-10;2886;1584;244438;203860;70.2;58.6
16;2021-08-11;2603;1232;247041;205092;71.0;58.9
16;2021-08-12;2012;1734;249053;206826;71.5;59.4
16;2021-08-13;2686;1467;251739;208293;72.3;59.8
16;2021-08-14;757;455;252496;208748;72.5;60.0
16;2021-08-15;29;4;252525;208752;72.5;60.0
16;2021-08-16;1339;1582;253864;210334;72.9;60.4
16;2021-08-17;1837;1628;255701;211962;73.4;60.9
16;2021-08-18;1591;1471;257292;213433;73.9;61.3
16;2021-08-19;1517;1777;258809;215210;74.3;61.8
16;2021-08-20;1601;1902;260410;217112;74.8;62.4
16;2021-08-21;564;827;260974;217939;75.0;62.6
16;2021-08-22;4;5;260978;217944;75.0;62.6
16;2021-08-23;993;2064;261971;220008;75.2;63.2
16;2021-08-24;1040;2376;263011;222384;75.5;63.9
16;2021-08-25;887;1780;263898;224164;75.8;64.4
16;2021-08-26;880;2531;264778;226695;76.0;65.1
16;2021-08-27;853;2408;265631;229103;76.3;65.8
16;2021-08-28;261;771;265892;229874;76.4;66.0
16;2021-08-29;2;15;265894;229889;76.4;66.0
16;2021-08-30;638;2396;266532;232285;76.6;66.7
16;2021-08-31;668;2632;267200;234917;76.7;67.5
16;2021-09-01;469;2544;267669;237461;76.9;68.2
16;2021-09-02;543;2366;268212;239827;77.0;68.9
16;2021-09-03;541;2812;268753;242639;77.2;69.7
16;2021-09-04;361;965;269114;243604;77.3;70.0
16;2021-09-05;5;29;269119;243633;77.3;70.0
16;2021-09-06;318;1760;269437;245393;77.4;70.5
16;2021-09-07;354;1990;269791;247383;77.5;71.1
16;2021-09-08;390;2213;270181;249596;77.6;71.7
16;2021-09-09;346;1711;270527;251307;77.7;72.2
16;2021-09-10;440;2099;270967;253406;77.8;72.8
16;2021-09-11;185;847;271152;254253;77.9;73.0
16;2021-09-12;6;23;271158;254276;77.9;73.0
16;2021-09-13;256;1350;271414;255626;78.0;73.4
16;2021-09-14;368;1441;271782;257067;78.1;73.8
16;2021-09-15;348;1347;272130;258414;78.2;74.2
16;2021-09-16;303;887;272433;259301;78.2;74.5
16;2021-09-17;498;1374;272931;260675;78.4;74.9
16;2021-09-18;100;535;273031;261210;78.4;75.0
16;2021-09-19;0;9;273031;261219;78.4;75.0
16;2021-09-20;191;720;273222;261939;78.5;75.2
16;2021-09-21;183;673;273405;262612;78.5;75.4
16;2021-09-22;187;990;273592;263602;78.6;75.7
16;2021-09-23;170;559;273762;264161;78.6;75.9
16;2021-09-24;337;1049;274099;265210;78.7;76.2
16;2021-09-25;64;439;274163;265649;78.7;76.3
16;2021-09-26;1;6;274164;265655;78.7;76.3
16;2021-09-27;193;581;274357;266236;78.8;76.5
16;2021-09-28;145;536;274502;266772;78.8;76.6
16;2021-09-29;197;606;274699;267378;78.9;76.8
16;2021-09-30;114;481;274813;267859;78.9;76.9
16;2021-10-01;241;538;275054;268397;79.0;77.1
16;2021-10-02;81;324;275135;268721;79.0;77.2
16;2021-10-03;0;7;275135;268728;79.0;77.2
17;2020-12-27;0;0;0;0;0.0;0.0
17;2020-12-28;0;0;0;0;0.0;0.0
17;2020-12-29;0;0;0;0;0.0;0.0
17;2020-12-30;1;0;1;0;0.0;0.0
17;2020-12-31;0;0;1;0;0.0;0.0
17;2021-01-01;1;0;2;0;0.0;0.0
17;2021-01-02;1;0;3;0;0.0;0.0
17;2021-01-03;0;0;3;0;0.0;0.0
17;2021-01-04;56;0;59;0;0.0;0.0
17;2021-01-05;98;0;157;0;0.0;0.0
17;2021-01-06;132;0;289;0;0.0;0.0
17;2021-01-07;484;1;773;1;0.1;0.0
17;2021-01-08;418;0;1191;1;0.2;0.0
17;2021-01-09;0;0;1191;1;0.2;0.0
17;2021-01-10;1;0;1192;1;0.2;0.0
17;2021-01-11;381;1;1573;2;0.2;0.0
17;2021-01-12;751;1;2324;3;0.4;0.0
17;2021-01-13;654;2;2978;5;0.5;0.0
17;2021-01-14;616;8;3594;13;0.6;0.0
17;2021-01-15;681;1;4275;14;0.7;0.0
17;2021-01-16;129;2;4404;16;0.7;0.0
17;2021-01-17;19;0;4423;16;0.7;0.0
17;2021-01-18;887;2;5310;18;0.8;0.0
17;2021-01-19;1910;3;7220;21;1.1;0.0
17;2021-01-20;2396;2;9616;23;1.5;0.0
17;2021-01-21;2500;3;12116;26;1.9;0.0
17;2021-01-22;1893;6;14009;32;2.2;0.0
17;2021-01-23;738;1;14747;33;2.3;0.0
17;2021-01-24;50;0;14797;33;2.3;0.0
17;2021-01-25;1383;5;16180;38;2.5;0.0
17;2021-01-26;2110;2;18290;40;2.8;0.0
17;2021-01-27;1676;32;19966;72;3.1;0.0
17;2021-01-28;2476;217;22442;289;3.5;0.0
17;2021-01-29;1740;157;24182;446;3.7;0.1
17;2021-01-30;528;3;24710;449;3.8;0.1
17;2021-01-31;37;2;24747;451;3.8;0.1
17;2021-02-01;741;186;25488;637;3.9;0.1
17;2021-02-02;1202;320;26690;957;4.1;0.1
17;2021-02-03;1297;375;27987;1332;4.3;0.2
17;2021-02-04;1162;436;29149;1768;4.5;0.3
17;2021-02-05;603;695;29752;2463;4.6;0.4
17;2021-02-06;24;39;29776;2502;4.6;0.4
17;2021-02-07;31;13;29807;2515;4.6;0.4
17;2021-02-08;706;348;30513;2863;4.7;0.4
17;2021-02-09;1101;1082;31614;3945;4.9;0.6
17;2021-02-10;866;1219;32480;5164;5.0;0.8
17;2021-02-11;1241;1296;33721;6460;5.2;1.0
17;2021-02-12;773;881;34494;7341;5.3;1.1
17;2021-02-13;43;93;34537;7434;5.3;1.1
17;2021-02-14;1;10;34538;7444;5.3;1.2
17;2021-02-15;621;925;35159;8369;5.4;1.3
17;2021-02-16;751;1431;35910;9800;5.5;1.5
17;2021-02-17;795;999;36705;10799;5.7;1.7
17;2021-02-18;965;1714;37670;12513;5.8;1.9
17;2021-02-19;1069;1249;38739;13762;6.0;2.1
17;2021-02-20;105;258;38844;14020;6.0;2.2
17;2021-02-21;9;2;38853;14022;6.0;2.2
17;2021-02-22;648;1246;39501;15268;6.1;2.4
17;2021-02-23;782;1216;40283;16484;6.2;2.5
17;2021-02-24;1080;1292;41363;17776;6.4;2.7
17;2021-02-25;1087;1458;42450;19234;6.6;3.0
17;2021-02-26;1307;1047;43757;20281;6.8;3.1
17;2021-02-27;527;212;44284;20493;6.8;3.2
17;2021-02-28;19;9;44303;20502;6.8;3.2
17;2021-03-01;638;868;44941;21370;6.9;3.3
17;2021-03-02;1095;740;46036;22110;7.1;3.4
17;2021-03-03;1618;684;47654;22794;7.4;3.5
17;2021-03-04;2426;1010;50080;23804;7.7;3.7
17;2021-03-05;2662;566;52742;24370;8.2;3.8
17;2021-03-06;1027;28;53769;24398;8.3;3.8
17;2021-03-07;183;17;53952;24415;8.3;3.8
17;2021-03-08;1018;748;54970;25163;8.5;3.9
17;2021-03-09;1745;521;56715;25684;8.8;4.0
17;2021-03-10;2047;592;58762;26276;9.1;4.1
17;2021-03-11;3227;921;61989;27197;9.6;4.2
17;2021-03-12;3356;567;65345;27764;10.1;4.3
17;2021-03-13;1202;11;66547;27775;10.3;4.3
17;2021-03-14;33;0;66580;27775;10.3;4.3
17;2021-03-15;1243;961;67823;28736;10.5;4.4
17;2021-03-16;892;517;68715;29253;10.6;4.5
17;2021-03-17;1460;689;70175;29942;10.8;4.6
17;2021-03-18;1683;757;71858;30699;11.1;4.7
17;2021-03-19;2096;535;73954;31234;11.4;4.8
17;2021-03-20;1086;57;75040;31291;11.6;4.8
17;2021-03-21;37;41;75077;31332;11.6;4.8
17;2021-03-22;1577;682;76654;32014;11.8;4.9
17;2021-03-23;2491;573;79145;32587;12.2;5.0
17;2021-03-24;3545;842;82690;33429;12.8;5.2
17;2021-03-25;4713;639;87403;34068;13.5;5.3
17;2021-03-26;4943;468;92346;34536;14.3;5.3
17;2021-03-27;1737;68;94083;34604;14.5;5.3
17;2021-03-28;369;45;94452;34649;14.6;5.4
17;2021-03-29;2361;566;96813;35215;15.0;5.4
17;2021-03-30;2654;977;99467;36192;15.4;5.6
17;2021-03-31;3843;899;103310;37091;16.0;5.7
17;2021-04-01;4013;1157;107323;38248;16.6;5.9
17;2021-04-02;3710;831;111033;39079;17.2;6.0
17;2021-04-03;1152;187;112185;39266;17.3;6.1
17;2021-04-04;501;6;112686;39272;17.4;6.1
17;2021-04-05;445;128;113131;39400;17.5;6.1
17;2021-04-06;3479;1024;116610;40424;18.0;6.2
17;2021-04-07;4131;1149;120741;41573;18.7;6.4
17;2021-04-08;4567;1476;125308;43049;19.4;6.7
17;2021-04-09;6499;842;131807;43891;20.4;6.8
17;2021-04-10;2582;68;134389;43959;20.8;6.8
17;2021-04-11;790;16;135179;43975;20.9;6.8
17;2021-04-12;2889;1610;138068;45585;21.3;7.0
17;2021-04-13;4152;1281;142220;46866;22.0;7.2
17;2021-04-14;4419;1206;146639;48072;22.7;7.4
17;2021-04-15;4601;1134;151240;49206;23.4;7.6
17;2021-04-16;4298;1153;155538;50359;24.0;7.8
17;2021-04-17;1682;382;157220;50741;24.3;7.8
17;2021-04-18;471;81;157691;50822;24.4;7.9
17;2021-04-19;2336;2053;160027;52875;24.7;8.2
17;2021-04-20;2927;2547;162954;55422;25.2;8.6
17;2021-04-21;2974;1940;165928;57362;25.6;8.9
17;2021-04-22;3121;2355;169049;59717;26.1;9.2
17;2021-04-23;2446;2723;171495;62440;26.5;9.6
17;2021-04-24;1669;923;173164;63363;26.8;9.8
17;2021-04-25;664;244;173828;63607;26.9;9.8
17;2021-04-26;2578;2610;176406;66217;27.3;10.2
17;2021-04-27;3150;2658;179556;68875;27.7;10.6
17;2021-04-28;3102;2915;182658;71790;28.2;11.1
17;2021-04-29;4149;2835;186807;74625;28.9;11.5
17;2021-04-30;4355;2619;191162;77244;29.5;11.9
17;2021-05-01;849;539;192011;77783;29.7;12.0
17;2021-05-02;553;837;192564;78620;29.8;12.1
17;2021-05-03;2546;2953;195110;81573;30.2;12.6
17;2021-05-04;2315;3709;197425;85282;30.5;13.2
17;2021-05-05;2907;3698;200332;88980;31.0;13.8
17;2021-05-06;4120;3391;204452;92371;31.6;14.3
17;2021-05-07;4359;3618;208811;95989;32.3;14.8
17;2021-05-08;1306;751;210117;96740;32.5;15.0
17;2021-05-09;1311;705;211428;97445;32.7;15.1
17;2021-05-10;2726;3674;214154;101119;33.1;15.6
17;2021-05-11;3500;3986;217654;105105;33.6;16.2
17;2021-05-12;3529;3797;221183;108902;34.2;16.8
17;2021-05-13;2542;693;223725;109595;34.6;16.9
17;2021-05-14;3031;2392;226756;111987;35.0;17.3
17;2021-05-15;2127;654;228883;112641;35.4;17.4
17;2021-05-16;1733;316;230616;112957;35.6;17.5
17;2021-05-17;4288;1997;234904;114954;36.3;17.8
17;2021-05-18;4745;1630;239649;116584;37.0;18.0
17;2021-05-19;5070;1281;244719;117865;37.8;18.2
17;2021-05-20;4940;1935;249659;119800;38.6;18.5
17;2021-05-21;4994;1943;254653;121743;39.4;18.8
17;2021-05-22;2390;529;257043;122272;39.7;18.9
17;2021-05-23;1900;128;258943;122400;40.0;18.9
17;2021-05-24;1426;210;260369;122610;40.2;18.9
17;2021-05-25;4031;1767;264400;124377;40.9;19.2
17;2021-05-26;4368;2035;268768;126412;41.5;19.5
17;2021-05-27;5211;2136;273979;128548;42.3;19.9
17;2021-05-28;4467;3412;278446;131960;43.0;20.4
17;2021-05-29;1559;1696;280005;133656;43.3;20.7
17;2021-05-30;857;410;280862;134066;43.4;20.7
17;2021-05-31;2946;2998;283808;137064;43.9;21.2
17;2021-06-01;4296;2915;288104;139979;44.5;21.6
17;2021-06-02;4203;3167;292307;143146;45.2;22.1
17;2021-06-03;5058;3144;297365;146290;46.0;22.6
17;2021-06-04;4513;3849;301878;150139;46.7;23.2
17;2021-06-05;1991;1594;303869;151733;47.0;23.4
17;2021-06-06;852;734;304721;152467;47.1;23.6
17;2021-06-07;3138;4339;307859;156806;47.6;24.2
17;2021-06-08;3790;4493;311649;161299;48.2;24.9
17;2021-06-09;4344;3048;315993;164347;48.8;25.4
17;2021-06-10;4927;2782;320920;167129;49.6;25.8
17;2021-06-11;4793;3679;325713;170808;50.3;26.4
17;2021-06-12;1813;1388;327526;172196;50.6;26.6
17;2021-06-13;612;415;328138;172611;50.7;26.7
17;2021-06-14;2834;4533;330972;177144;51.1;27.4
17;2021-06-15;3624;4368;334596;181512;51.7;28.1
17;2021-06-16;4127;3692;338723;185204;52.3;28.6
17;2021-06-17;4367;4110;343090;189314;53.0;29.3
17;2021-06-18;4059;4435;347149;193749;53.6;29.9
17;2021-06-19;1450;1975;348599;195724;53.9;30.2
17;2021-06-20;595;1036;349194;196760;54.0;30.4
17;2021-06-21;2559;4369;351753;201129;54.4;31.1
17;2021-06-22;3530;4450;355283;205579;54.9;31.8
17;2021-06-23;3795;3994;359078;209573;55.5;32.4
17;2021-06-24;3599;3952;362677;213525;56.0;33.0
17;2021-06-25;2718;4984;365395;218509;56.5;33.8
17;2021-06-26;905;2333;366300;220842;56.6;34.1
17;2021-06-27;397;1903;366697;222745;56.7;34.4
17;2021-06-28;1523;5413;368220;228158;56.9;35.3
17;2021-06-29;1684;5889;369904;234047;57.2;36.2
17;2021-06-30;2030;5546;371934;239593;57.5;37.0
17;2021-07-01;2267;5560;374201;245153;57.8;37.9
17;2021-07-02;2485;5979;376686;251132;58.2;38.8
17;2021-07-03;627;2533;377313;253665;58.3;39.2
17;2021-07-04;155;1250;377468;254915;58.3;39.4
17;2021-07-05;1887;5176;379355;260091;58.6;40.2
17;2021-07-06;2129;5595;381484;265686;59.0;41.1
17;2021-07-07;2406;5496;383890;271182;59.3;41.9
17;2021-07-08;2915;5442;386805;276624;59.8;42.7
17;2021-07-09;2526;6073;389331;282697;60.2;43.7
17;2021-07-10;826;2469;390157;285166;60.3;44.1
17;2021-07-11;379;906;390536;286072;60.4;44.2
17;2021-07-12;2002;5617;392538;291689;60.7;45.1
17;2021-07-13;2372;6717;394910;298406;61.0;46.1
17;2021-07-14;71;71;394981;298477;61.0;46.1
17;2021-07-15;2190;6861;397171;305338;61.4;47.2
17;2021-07-16;2777;6964;399948;312302;61.8;48.3
17;2021-07-17;1051;2271;400999;314573;62.0;48.6
17;2021-07-18;312;1036;401311;315609;62.0;48.8
17;2021-07-19;2635;5904;403946;321513;62.4;49.7
17;2021-07-20;3314;6312;407260;327825;62.9;50.7
17;2021-07-21;3802;6023;411062;333848;63.5;51.6
17;2021-07-22;4248;6264;415310;340112;64.2;52.6
17;2021-07-23;3904;6562;419214;346674;64.8;53.6
17;2021-07-24;2067;1390;421281;348064;65.1;53.8
17;2021-07-25;1040;417;422321;348481;65.3;53.9
17;2021-07-26;3735;5425;426056;353906;65.8;54.7
17;2021-07-27;4728;5439;430784;359345;66.6;55.5
17;2021-07-28;5215;5161;435999;364506;67.4;56.3
17;2021-07-29;5166;5339;441165;369845;68.2;57.2
17;2021-07-30;5511;5573;446676;375418;69.0;58.0
17;2021-07-31;2116;1213;448792;376631;69.4;58.2
17;2021-08-01;1095;359;449887;376990;69.5;58.3
17;2021-08-02;4621;4391;454508;381381;70.2;58.9
17;2021-08-03;5761;4160;460269;385541;71.1;59.6
17;2021-08-04;6201;3379;466470;388920;72.1;60.1
17;2021-08-05;6389;3148;472859;392068;73.1;60.6
17;2021-08-06;5888;3600;478747;395668;74.0;61.1
17;2021-08-07;1992;867;480739;396535;74.3;61.3
17;2021-08-08;978;219;481717;396754;74.4;61.3
17;2021-08-09;3923;3689;485640;400443;75.1;61.9
17;2021-08-10;5086;3486;490726;403929;75.8;62.4
17;2021-08-11;4918;3811;495644;407740;76.6;63.0
17;2021-08-12;4895;3959;500539;411699;77.4;63.6
17;2021-08-13;4520;4142;505059;415841;78.1;64.3
17;2021-08-14;1239;1383;506298;417224;78.2;64.5
17;2021-08-15;407;375;506705;417599;78.3;64.5
17;2021-08-16;2854;4065;509559;421664;78.7;65.2
17;2021-08-17;3052;4291;512611;425955;79.2;65.8
17;2021-08-18;2621;4554;515232;430509;79.6;66.5
17;2021-08-19;2733;4372;517965;434881;80.0;67.2
17;2021-08-20;2496;5025;520461;439906;80.4;68.0
17;2021-08-21;684;1355;521145;441261;80.5;68.2
17;2021-08-22;217;457;521362;441718;80.6;68.3
17;2021-08-23;1987;4954;523349;446672;80.9;69.0
17;2021-08-24;1941;5091;525290;451763;81.2;69.8
17;2021-08-25;1659;5505;526949;457268;81.4;70.7
17;2021-08-26;1603;5761;528552;463029;81.7;71.6
17;2021-08-27;1551;5954;530103;468983;81.9;72.5
17;2021-08-28;521;1455;530624;470438;82.0;72.7
17;2021-08-29;87;575;530711;471013;82.0;72.8
17;2021-08-30;1435;5106;532146;476119;82.2;73.6
17;2021-08-31;1326;5356;533472;481475;82.4;74.4
17;2021-09-01;1195;5117;534667;486592;82.6;75.2
17;2021-09-02;1139;4548;535806;491140;82.8;75.9
17;2021-09-03;1169;5337;536975;496477;83.0;76.7
17;2021-09-04;287;971;537262;497448;83.0;76.9
17;2021-09-05;54;140;537316;497588;83.0;76.9
17;2021-09-06;727;3734;538043;501322;83.1;77.5
17;2021-09-07;717;3259;538760;504581;83.3;78.0
17;2021-09-08;822;4141;539582;508722;83.4;78.6
17;2021-09-09;815;3193;540397;511915;83.5;79.1
17;2021-09-10;799;3950;541196;515865;83.6;79.7
17;2021-09-11;302;1003;541498;516868;83.7;79.9
17;2021-09-12;10;23;541508;516891;83.7;79.9
17;2021-09-13;647;2800;542155;519691;83.8;80.3
17;2021-09-14;615;2750;542770;522441;83.9;80.7
17;2021-09-15;940;2376;543710;524817;84.0;81.1
17;2021-09-16;540;1451;544250;526268;84.1;81.3
17;2021-09-17;610;1921;544860;528189;84.2;81.6
17;2021-09-18;192;582;545052;528771;84.2;81.7
17;2021-09-19;12;6;545064;528777;84.2;81.7
17;2021-09-20;428;1226;545492;530003;84.3;81.9
17;2021-09-21;324;892;545816;530895;84.4;82.0
17;2021-09-22;419;1692;546235;532587;84.4;82.3
17;2021-09-23;357;971;546592;533558;84.5;82.5
17;2021-09-24;384;1821;546976;535379;84.5;82.7
17;2021-09-25;128;472;547104;535851;84.5;82.8
17;2021-09-26;0;16;547104;535867;84.5;82.8
17;2021-09-27;437;1176;547541;537043;84.6;83.0
17;2021-09-28;274;685;547815;537728;84.7;83.1
17;2021-09-29;453;1212;548268;538940;84.7;83.3
17;2021-09-30;372;714;548640;539654;84.8;83.4
17;2021-10-01;354;741;548994;540395;84.8;83.5
17;2021-10-02;100;308;549094;540703;84.9;83.6
17;2021-10-03;4;28;549098;540731;84.9;83.6
18;2020-12-27;0;0;0;0;0.0;0.0
18;2020-12-28;0;0;0;0;0.0;0.0
18;2020-12-29;0;0;0;0;0.0;0.0
18;2020-12-30;1;0;1;0;0.0;0.0
18;2020-12-31;0;0;1;0;0.0;0.0
18;2021-01-01;0;0;1;0;0.0;0.0
18;2021-01-02;0;0;1;0;0.0;0.0
18;2021-01-03;0;0;1;0;0.0;0.0
18;2021-01-04;3;0;4;0;0.0;0.0
18;2021-01-05;0;0;4;0;0.0;0.0
18;2021-01-06;1;0;5;0;0.0;0.0
18;2021-01-07;30;1;35;1;0.0;0.0
18;2021-01-08;65;0;100;1;0.0;0.0
18;2021-01-09;225;0;325;1;0.1;0.0
18;2021-01-10;146;0;471;1;0.2;0.0
18;2021-01-11;169;0;640;1;0.2;0.0
18;2021-01-12;371;0;1011;1;0.3;0.0
18;2021-01-13;270;1;1281;2;0.4;0.0
18;2021-01-14;269;2;1550;4;0.5;0.0
18;2021-01-15;332;2;1882;6;0.6;0.0
18;2021-01-16;288;2;2170;8;0.7;0.0
18;2021-01-17;1;0;2171;8;0.7;0.0
18;2021-01-18;291;0;2462;8;0.8;0.0
18;2021-01-19;1373;2;3835;10;1.3;0.0
18;2021-01-20;1239;2;5074;12;1.7;0.0
18;2021-01-21;965;0;6039;12;2.0;0.0
18;2021-01-22;780;2;6819;14;2.3;0.0
18;2021-01-23;249;2;7068;16;2.4;0.0
18;2021-01-24;0;0;7068;16;2.4;0.0
18;2021-01-25;509;0;7577;16;2.6;0.0
18;2021-01-26;395;1;7972;17;2.7;0.0
18;2021-01-27;390;2;8362;19;2.8;0.0
18;2021-01-28;566;8;8928;27;3.0;0.0
18;2021-01-29;491;73;9419;100;3.2;0.0
18;2021-01-30;431;135;9850;235;3.3;0.1
18;2021-01-31;82;97;9932;332;3.4;0.1
18;2021-02-01;328;119;10260;451;3.5;0.2
18;2021-02-02;507;227;10767;678;3.6;0.2
18;2021-02-03;398;201;11165;879;3.8;0.3
18;2021-02-04;630;226;11795;1105;4.0;0.4
18;2021-02-05;448;181;12243;1286;4.1;0.4
18;2021-02-06;283;88;12526;1374;4.2;0.5
18;2021-02-07;108;1;12634;1375;4.3;0.5
18;2021-02-08;268;189;12902;1564;4.4;0.5
18;2021-02-09;583;759;13485;2323;4.5;0.8
18;2021-02-10;741;628;14226;2951;4.8;1.0
18;2021-02-11;655;412;14881;3363;5.0;1.1
18;2021-02-12;502;303;15383;3666;5.2;1.2
18;2021-02-13;286;107;15669;3773;5.3;1.3
18;2021-02-14;364;97;16033;3870;5.4;1.3
18;2021-02-15;378;308;16411;4178;5.5;1.4
18;2021-02-16;399;327;16810;4505;5.7;1.5
18;2021-02-17;403;385;17213;4890;5.8;1.6
18;2021-02-18;344;456;17557;5346;5.9;1.8
18;2021-02-19;471;244;18028;5590;6.1;1.9
18;2021-02-20;721;191;18749;5781;6.3;2.0
18;2021-02-21;317;4;19066;5785;6.4;2.0
18;2021-02-22;217;293;19283;6078;6.5;2.1
18;2021-02-23;204;270;19487;6348;6.6;2.1
18;2021-02-24;241;200;19728;6548;6.7;2.2
18;2021-02-25;294;453;20022;7001;6.8;2.4
18;2021-02-26;583;191;20605;7192;7.0;2.4
18;2021-02-27;510;346;21115;7538;7.1;2.5
18;2021-02-28;7;66;21122;7604;7.1;2.6
18;2021-03-01;237;345;21359;7949;7.2;2.7
18;2021-03-02;284;462;21643;8411;7.3;2.8
18;2021-03-03;346;526;21989;8937;7.4;3.0
18;2021-03-04;475;520;22464;9457;7.6;3.2
18;2021-03-05;524;335;22988;9792;7.8;3.3
18;2021-03-06;1071;307;24059;10099;8.1;3.4
18;2021-03-07;7;131;24066;10230;8.1;3.5
18;2021-03-08;335;313;24401;10543;8.2;3.6
18;2021-03-09;411;328;24812;10871;8.4;3.7
18;2021-03-10;422;414;25234;11285;8.5;3.8
18;2021-03-11;518;383;25752;11668;8.7;3.9
18;2021-03-12;705;283;26457;11951;8.9;4.0
18;2021-03-13;1164;241;27621;12192;9.3;4.1
18;2021-03-14;301;214;27922;12406;9.4;4.2
18;2021-03-15;492;365;28414;12771;9.6;4.3
18;2021-03-16;392;302;28806;13073;9.7;4.4
18;2021-03-17;383;407;29189;13480;9.8;4.5
18;2021-03-18;512;220;29701;13700;10.0;4.6
18;2021-03-19;755;221;30456;13921;10.3;4.7
18;2021-03-20;986;614;31442;14535;10.6;4.9
18;2021-03-21;308;305;31750;14840;10.7;5.0
18;2021-03-22;602;292;32352;15132;10.9;5.1
18;2021-03-23;707;287;33059;15419;11.2;5.2
18;2021-03-24;1052;295;34111;15714;11.5;5.3
18;2021-03-25;1049;299;35160;16013;11.9;5.4
18;2021-03-26;1209;347;36369;16360;12.3;5.5
18;2021-03-27;1488;317;37857;16677;12.8;5.6
18;2021-03-28;215;0;38072;16677;12.8;5.6
18;2021-03-29;1102;197;39174;16874;13.2;5.7
18;2021-03-30;1084;302;40258;17176;13.6;5.8
18;2021-03-31;1305;252;41563;17428;14.0;5.9
18;2021-04-01;1375;348;42938;17776;14.5;6.0
18;2021-04-02;1229;309;44167;18085;14.9;6.1
18;2021-04-03;581;181;44748;18266;15.1;6.2
18;2021-04-04;71;5;44819;18271;15.1;6.2
18;2021-04-05;199;0;45018;18271;15.2;6.2
18;2021-04-06;1027;350;46045;18621;15.5;6.3
18;2021-04-07;1322;363;47367;18984;16.0;6.4
18;2021-04-08;1692;347;49059;19331;16.6;6.5
18;2021-04-09;1833;281;50892;19612;17.2;6.6
18;2021-04-10;2632;652;53524;20264;18.1;6.8
18;2021-04-11;1986;319;55510;20583;18.7;6.9
18;2021-04-12;1401;404;56911;20987;19.2;7.1
18;2021-04-13;1785;470;58696;21457;19.8;7.2
18;2021-04-14;1378;517;60074;21974;20.3;7.4
18;2021-04-15;1532;530;61606;22504;20.8;7.6
18;2021-04-16;1614;590;63220;23094;21.3;7.8
18;2021-04-17;1599;520;64819;23614;21.9;8.0
18;2021-04-18;377;232;65196;23846;22.0;8.0
18;2021-04-19;1317;592;66513;24438;22.4;8.2
18;2021-04-20;1446;715;67959;25153;22.9;8.5
18;2021-04-21;1270;908;69229;26061;23.4;8.8
18;2021-04-22;1403;703;70632;26764;23.8;9.0
18;2021-04-23;1387;734;72019;27498;24.3;9.3
18;2021-04-24;1355;1271;73374;28769;24.8;9.7
18;2021-04-25;287;217;73661;28986;24.9;9.8
18;2021-04-26;1205;955;74866;29941;25.3;10.1
18;2021-04-27;1544;764;76410;30705;25.8;10.4
18;2021-04-28;1358;876;77768;31581;26.2;10.7
18;2021-04-29;1851;735;79619;32316;26.9;10.9
18;2021-04-30;1569;991;81188;33307;27.4;11.2
18;2021-05-01;788;210;81976;33517;27.7;11.3
18;2021-05-02;806;61;82782;33578;27.9;11.3
18;2021-05-03;1627;1012;84409;34590;28.5;11.7
18;2021-05-04;1729;1283;86138;35873;29.1;12.1
18;2021-05-05;1735;1213;87873;37086;29.6;12.5
18;2021-05-06;2162;1363;90035;38449;30.4;13.0
18;2021-05-07;1234;1398;91269;39847;30.8;13.4
18;2021-05-08;994;1464;92263;41311;31.1;13.9
18;2021-05-09;500;2258;92763;43569;31.3;14.7
18;2021-05-10;1157;1508;93920;45077;31.7;15.2
18;2021-05-11;1696;1748;95616;46825;32.3;15.8
18;2021-05-12;1806;1495;97422;48320;32.9;16.3
18;2021-05-13;1061;370;98483;48690;33.2;16.4
18;2021-05-14;1345;942;99828;49632;33.7;16.7
18;2021-05-15;1809;1163;101637;50795;34.3;17.1
18;2021-05-16;537;581;102174;51376;34.5;17.3
18;2021-05-17;1245;1091;103419;52467;34.9;17.7
18;2021-05-18;2146;933;105565;53400;35.6;18.0
18;2021-05-19;2162;920;107727;54320;36.3;18.3
18;2021-05-20;2275;983;110002;55303;37.1;18.7
18;2021-05-21;1495;764;111497;56067;37.6;18.9
18;2021-05-22;1724;1072;113221;57139;38.2;19.3
18;2021-05-23;486;336;113707;57475;38.4;19.4
18;2021-05-24;461;292;114168;57767;38.5;19.5
18;2021-05-25;1841;1057;116009;58824;39.1;19.8
18;2021-05-26;2153;846;118162;59670;39.9;20.1
18;2021-05-27;2209;1228;120371;60898;40.6;20.5
18;2021-05-28;1712;1306;122083;62204;41.2;21.0
18;2021-05-29;2621;1661;124704;63865;42.1;21.5
18;2021-05-30;1482;504;126186;64369;42.6;21.7
18;2021-05-31;1785;693;127971;65062;43.2;22.0
18;2021-06-01;2039;948;130010;66010;43.9;22.3
18;2021-06-02;2010;1015;132020;67025;44.5;22.6
18;2021-06-03;2283;1198;134303;68223;45.3;23.0
18;2021-06-04;1912;1122;136215;69345;46.0;23.4
18;2021-06-05;2800;1445;139015;70790;46.9;23.9
18;2021-06-06;364;381;139379;71171;47.0;24.0
18;2021-06-07;1294;1232;140673;72403;47.5;24.4
18;2021-06-08;1490;1394;142163;73797;48.0;24.9
18;2021-06-09;1329;1068;143492;74865;48.4;25.3
18;2021-06-10;1631;1408;145123;76273;49.0;25.7
18;2021-06-11;1496;1404;146619;77677;49.5;26.2
18;2021-06-12;1245;2510;147864;80187;49.9;27.1
18;2021-06-13;126;262;147990;80449;49.9;27.1
18;2021-06-14;656;1828;148646;82277;50.1;27.8
18;2021-06-15;1093;1823;149739;84100;50.5;28.4
18;2021-06-16;1255;1441;150994;85541;50.9;28.9
18;2021-06-17;1205;1671;152199;87212;51.3;29.4
18;2021-06-18;1290;1665;153489;88877;51.8;30.0
18;2021-06-19;1564;1251;155053;90128;52.3;30.4
18;2021-06-20;246;159;155299;90287;52.4;30.5
18;2021-06-21;665;1601;155964;91888;52.6;31.0
18;2021-06-22;1068;1645;157032;93533;53.0;31.6
18;2021-06-23;944;1642;157976;95175;53.3;32.1
18;2021-06-24;1033;1062;159009;96237;53.6;32.5
18;2021-06-25;892;1745;159901;97982;53.9;33.1
18;2021-06-26;1097;1474;160998;99456;54.3;33.6
18;2021-06-27;31;372;161029;99828;54.3;33.7
18;2021-06-28;422;1922;161451;101750;54.5;34.3
18;2021-06-29;597;2378;162048;104128;54.7;35.1
18;2021-06-30;600;2543;162648;106671;54.9;36.0
18;2021-07-01;963;2155;163611;108826;55.2;36.7
18;2021-07-02;614;1685;164225;110511;55.4;37.3
18;2021-07-03;754;2572;164979;113083;55.7;38.2
18;2021-07-04;164;1032;165143;114115;55.7;38.5
18;2021-07-05;765;1877;165908;115992;56.0;39.1
18;2021-07-06;559;2300;166467;118292;56.2;39.9
18;2021-07-07;766;2115;167233;120407;56.4;40.6
18;2021-07-08;1032;1984;168265;122391;56.8;41.3
18;2021-07-09;703;2305;168968;124696;57.0;42.1
18;2021-07-10;781;3172;169749;127868;57.3;43.1
18;2021-07-11;84;667;169833;128535;57.3;43.4
18;2021-07-12;223;2253;170056;130788;57.4;44.1
18;2021-07-13;619;2904;170675;133692;57.6;45.1
18;2021-07-14;194;936;170869;134628;57.6;45.4
18;2021-07-15;1396;2815;172265;137443;58.1;46.4
18;2021-07-16;1185;2122;173450;139565;58.5;47.1
18;2021-07-17;1130;2470;174580;142035;58.9;47.9
18;2021-07-18;228;332;174808;142367;59.0;48.0
18;2021-07-19;1055;1657;175863;144024;59.3;48.6
18;2021-07-20;1625;2269;177488;146293;59.9;49.4
18;2021-07-21;1901;2061;179389;148354;60.5;50.1
18;2021-07-22;2211;1900;181600;150254;61.3;50.7
18;2021-07-23;1395;1612;182995;151866;61.7;51.2
18;2021-07-24;891;1532;183886;153398;62.0;51.8
18;2021-07-25;192;396;184078;153794;62.1;51.9
18;2021-07-26;1397;1502;185475;155296;62.6;52.4
18;2021-07-27;1824;1535;187299;156831;63.2;52.9
18;2021-07-28;2198;1796;189497;158627;63.9;53.5
18;2021-07-29;2140;1816;191637;160443;64.7;54.1
18;2021-07-30;1585;1344;193222;161787;65.2;54.6
18;2021-07-31;1237;1280;194459;163067;65.6;55.0
18;2021-08-01;90;34;194549;163101;65.6;55.0
18;2021-08-02;1410;765;195959;163866;66.1;55.3
18;2021-08-03;1719;1630;197678;165496;66.7;55.8
18;2021-08-04;2441;1102;200119;166598;67.5;56.2
18;2021-08-05;1529;1247;201648;167845;68.0;56.6
18;2021-08-06;1582;1140;203230;168985;68.6;57.0
18;2021-08-07;609;764;203839;169749;68.8;57.3
18;2021-08-08;49;60;203888;169809;68.8;57.3
18;2021-08-09;1105;874;204993;170683;69.2;57.6
18;2021-08-10;1208;1511;206201;172194;69.6;58.1
18;2021-08-11;1608;1510;207809;173704;70.1;58.6
18;2021-08-12;1554;1594;209363;175298;70.6;59.1
18;2021-08-13;1087;1172;210450;176470;71.0;59.5
18;2021-08-14;759;603;211209;177073;71.3;59.7
18;2021-08-15;35;17;211244;177090;71.3;59.7
18;2021-08-16;830;1201;212074;178291;71.5;60.2
18;2021-08-17;979;1999;213053;180290;71.9;60.8
18;2021-08-18;1158;1961;214211;182251;72.3;61.5
18;2021-08-19;1105;1612;215316;183863;72.6;62.0
18;2021-08-20;911;1758;216227;185621;73.0;62.6
18;2021-08-21;419;705;216646;186326;73.1;62.9
18;2021-08-22;22;73;216668;186399;73.1;62.9
18;2021-08-23;488;1680;217156;188079;73.3;63.5
18;2021-08-24;903;1494;218059;189573;73.6;64.0
18;2021-08-25;840;1864;218899;191437;73.9;64.6
18;2021-08-26;772;1532;219671;192969;74.1;65.1
18;2021-08-27;575;1995;220246;194964;74.3;65.8
18;2021-08-28;501;873;220747;195837;74.5;66.1
18;2021-08-29;92;176;220839;196013;74.5;66.1
18;2021-08-30;528;1443;221367;197456;74.7;66.6
18;2021-08-31;507;1443;221874;198899;74.9;67.1
18;2021-09-01;578;1643;222452;200542;75.1;67.7
18;2021-09-02;398;1268;222850;201810;75.2;68.1
18;2021-09-03;455;1304;223305;203114;75.3;68.5
18;2021-09-04;356;810;223661;203924;75.5;68.8
18;2021-09-05;29;80;223690;204004;75.5;68.8
18;2021-09-06;278;1090;223968;205094;75.6;69.2
18;2021-09-07;280;992;224248;206086;75.7;69.5
18;2021-09-08;402;1137;224650;207223;75.8;69.9
18;2021-09-09;356;1146;225006;208369;75.9;70.3
18;2021-09-10;407;1091;225413;209460;76.0;70.7
18;2021-09-11;262;866;225675;210326;76.1;71.0
18;2021-09-12;8;32;225683;210358;76.1;71.0
18;2021-09-13;310;860;225993;211218;76.2;71.3
18;2021-09-14;273;1014;226266;212232;76.3;71.6
18;2021-09-15;319;1050;226585;213282;76.4;72.0
18;2021-09-16;469;876;227054;214158;76.6;72.3
18;2021-09-17;337;737;227391;214895;76.7;72.5
18;2021-09-18;177;617;227568;215512;76.8;72.7
18;2021-09-19;6;3;227574;215515;76.8;72.7
18;2021-09-20;156;550;227730;216065;76.8;72.9
18;2021-09-21;111;423;227841;216488;76.9;73.0
18;2021-09-22;193;870;228034;217358;76.9;73.3
18;2021-09-23;249;466;228283;217824;77.0;73.5
18;2021-09-24;141;489;228424;218313;77.1;73.7
18;2021-09-25;159;689;228583;219002;77.1;73.9
18;2021-09-26;15;89;228598;219091;77.1;73.9
18;2021-09-27;109;314;228707;219405;77.2;74.0
18;2021-09-28;70;273;228777;219678;77.2;74.1
18;2021-09-29;68;280;228845;219958;77.2;74.2
18;2021-09-30;116;279;228961;220237;77.2;74.3
18;2021-10-01;142;289;229103;220526;77.3;74.4
18;2021-10-02;62;163;229165;220689;77.3;74.5
18;2021-10-03;6;10;229171;220699;77.3;74.5
19;2020-12-27;0;0;0;0;0.0;0.0
19;2020-12-28;0;0;0;0;0.0;0.0
19;2020-12-29;1;0;1;0;0.0;0.0
19;2020-12-30;0;0;1;0;0.0;0.0
19;2020-12-31;0;0;1;0;0.0;0.0
19;2021-01-01;0;0;1;0;0.0;0.0
19;2021-01-02;0;0;1;0;0.0;0.0
19;2021-01-03;0;0;1;0;0.0;0.0
19;2021-01-04;0;0;1;0;0.0;0.0
19;2021-01-05;0;0;1;0;0.0;0.0
19;2021-01-06;0;0;1;0;0.0;0.0
19;2021-01-07;344;1;345;1;0.1;0.0
19;2021-01-08;248;1;593;2;0.2;0.0
19;2021-01-09;1;0;594;2;0.2;0.0
19;2021-01-10;1;0;595;2;0.2;0.0
19;2021-01-11;38;0;633;2;0.3;0.0
19;2021-01-12;416;1;1049;3;0.4;0.0
19;2021-01-13;429;3;1478;6;0.6;0.0
19;2021-01-14;475;0;1953;6;0.8;0.0
19;2021-01-15;226;0;2179;6;0.9;0.0
19;2021-01-16;0;0;2179;6;0.9;0.0
19;2021-01-17;1;0;2180;6;0.9;0.0
19;2021-01-18;251;2;2431;8;1.0;0.0
19;2021-01-19;521;0;2952;8;1.2;0.0
19;2021-01-20;921;7;3873;15;1.6;0.0
19;2021-01-21;507;4;4380;19;1.8;0.0
19;2021-01-22;1318;5;5698;24;2.4;0.0
19;2021-01-23;281;0;5979;24;2.5;0.0
19;2021-01-24;37;0;6016;24;2.5;0.0
19;2021-01-25;233;0;6249;24;2.6;0.0
19;2021-01-26;608;3;6857;27;2.9;0.0
19;2021-01-27;334;3;7191;30;3.0;0.0
19;2021-01-28;297;153;7488;183;3.1;0.1
19;2021-01-29;347;54;7835;237;3.3;0.1
19;2021-01-30;130;24;7965;261;3.3;0.1
19;2021-01-31;41;0;8006;261;3.3;0.1
19;2021-02-01;158;94;8164;355;3.4;0.1
19;2021-02-02;303;424;8467;779;3.5;0.3
19;2021-02-03;285;235;8752;1014;3.6;0.4
19;2021-02-04;255;363;9007;1377;3.7;0.6
19;2021-02-05;311;74;9318;1451;3.9;0.6
19;2021-02-06;214;2;9532;1453;4.0;0.6
19;2021-02-07;48;2;9580;1455;4.0;0.6
19;2021-02-08;177;92;9757;1547;4.1;0.6
19;2021-02-09;333;178;10090;1725;4.2;0.7
19;2021-02-10;517;222;10607;1947;4.4;0.8
19;2021-02-11;414;299;11021;2246;4.6;0.9
19;2021-02-12;799;1124;11820;3370;4.9;1.4
19;2021-02-13;352;140;12172;3510;5.1;1.5
19;2021-02-14;98;5;12270;3515;5.1;1.5
19;2021-02-15;200;213;12470;3728;5.2;1.6
19;2021-02-16;386;149;12856;3877;5.3;1.6
19;2021-02-17;306;392;13162;4269;5.5;1.8
19;2021-02-18;174;422;13336;4691;5.5;2.0
19;2021-02-19;469;257;13805;4948;5.7;2.1
19;2021-02-20;133;158;13938;5106;5.8;2.1
19;2021-02-21;20;33;13958;5139;5.8;2.1
19;2021-02-22;221;190;14179;5329;5.9;2.2
19;2021-02-23;268;311;14447;5640;6.0;2.3
19;2021-02-24;361;179;14808;5819;6.2;2.4
19;2021-02-25;519;342;15327;6161;6.4;2.6
19;2021-02-26;395;270;15722;6431;6.5;2.7
19;2021-02-27;348;133;16070;6564;6.7;2.7
19;2021-02-28;68;32;16138;6596;6.7;2.7
19;2021-03-01;266;196;16404;6792;6.8;2.8
19;2021-03-02;428;224;16832;7016;7.0;2.9
19;2021-03-03;692;303;17524;7319;7.3;3.0
19;2021-03-04;826;325;18350;7644;7.6;3.2
19;2021-03-05;891;667;19241;8311;8.0;3.5
19;2021-03-06;1072;174;20313;8485;8.5;3.5
19;2021-03-07;463;32;20776;8517;8.6;3.5
19;2021-03-08;640;135;21416;8652;8.9;3.6
19;2021-03-09;836;227;22252;8879;9.3;3.7
19;2021-03-10;1155;276;23407;9155;9.7;3.8
19;2021-03-11;1274;291;24681;9446;10.3;3.9
19;2021-03-12;1136;379;25817;9825;10.7;4.1
19;2021-03-13;1110;160;26927;9985;11.2;4.2
19;2021-03-14;161;80;27088;10065;11.3;4.2
19;2021-03-15;699;131;27787;10196;11.6;4.2
19;2021-03-16;688;298;28475;10494;11.8;4.4
19;2021-03-17;839;277;29314;10771;12.2;4.5
19;2021-03-18;767;279;30081;11050;12.5;4.6
19;2021-03-19;1014;483;31095;11533;12.9;4.8
19;2021-03-20;784;131;31879;11664;13.3;4.9
19;2021-03-21;128;3;32007;11667;13.3;4.9
19;2021-03-22;548;174;32555;11841;13.5;4.9
19;2021-03-23;1045;229;33600;12070;14.0;5.0
19;2021-03-24;1172;371;34772;12441;14.5;5.2
19;2021-03-25;1189;404;35961;12845;15.0;5.3
19;2021-03-26;1325;274;37286;13119;15.5;5.5
19;2021-03-27;854;185;38140;13304;15.9;5.5
19;2021-03-28;63;60;38203;13364;15.9;5.6
19;2021-03-29;612;176;38815;13540;16.2;5.6
19;2021-03-30;971;343;39786;13883;16.6;5.8
19;2021-03-31;1157;490;40943;14373;17.0;6.0
19;2021-04-01;1491;424;42434;14797;17.7;6.2
19;2021-04-02;1008;522;43442;15319;18.1;6.4
19;2021-04-03;597;283;44039;15602;18.3;6.5
19;2021-04-04;130;3;44169;15605;18.4;6.5
19;2021-04-05;40;75;44209;15680;18.4;6.5
19;2021-04-06;734;602;44943;16282;18.7;6.8
19;2021-04-07;976;732;45919;17014;19.1;7.1
19;2021-04-08;1116;1016;47035;18030;19.6;7.5
19;2021-04-09;1641;615;48676;18645;20.3;7.8
19;2021-04-10;946;557;49622;19202;20.6;8.0
19;2021-04-11;557;74;50179;19276;20.9;8.0
19;2021-04-12;681;521;50860;19797;21.2;8.2
19;2021-04-13;915;575;51775;20372;21.5;8.5
19;2021-04-14;1333;844;53108;21216;22.1;8.8
19;2021-04-15;1228;871;54336;22087;22.6;9.2
19;2021-04-16;1506;819;55842;22906;23.2;9.5
19;2021-04-17;761;478;56603;23384;23.6;9.7
19;2021-04-18;661;69;57264;23453;23.8;9.8
19;2021-04-19;730;439;57994;23892;24.1;9.9
19;2021-04-20;979;748;58973;24640;24.5;10.3
19;2021-04-21;1271;698;60244;25338;25.1;10.5
19;2021-04-22;1188;898;61432;26236;25.6;10.9
19;2021-04-23;1127;1020;62559;27256;26.0;11.3
19;2021-04-24;678;676;63237;27932;26.3;11.6
19;2021-04-25;675;70;63912;28002;26.6;11.7
19;2021-04-26;1056;332;64968;28334;27.0;11.8
19;2021-04-27;1027;568;65995;28902;27.5;12.0
19;2021-04-28;1553;555;67548;29457;28.1;12.3
19;2021-04-29;1453;1181;69001;30638;28.7;12.7
19;2021-04-30;1876;1056;70877;31694;29.5;13.2
19;2021-05-01;671;173;71548;31867;29.8;13.3
19;2021-05-02;551;152;72099;32019;30.0;13.3
19;2021-05-03;854;547;72953;32566;30.4;13.6
19;2021-05-04;1025;707;73978;33273;30.8;13.8
19;2021-05-05;1256;741;75234;34014;31.3;14.2
19;2021-05-06;1127;1194;76361;35208;31.8;14.6
19;2021-05-07;1663;1190;78024;36398;32.5;15.1
19;2021-05-08;712;205;78736;36603;32.8;15.2
19;2021-05-09;487;547;79223;37150;33.0;15.5
19;2021-05-10;1164;665;80387;37815;33.4;15.7
19;2021-05-11;1639;856;82026;38671;34.1;16.1
19;2021-05-12;1945;1319;83971;39990;34.9;16.6
19;2021-05-13;571;242;84542;40232;35.2;16.7
19;2021-05-14;1646;988;86188;41220;35.9;17.2
19;2021-05-15;1443;592;87631;41812;36.5;17.4
19;2021-05-16;350;82;87981;41894;36.6;17.4
19;2021-05-17;1498;559;89479;42453;37.2;17.7
19;2021-05-18;1669;498;91148;42951;37.9;17.9
19;2021-05-19;2009;822;93157;43773;38.8;18.2
19;2021-05-20;1722;891;94879;44664;39.5;18.6
19;2021-05-21;1964;814;96843;45478;40.3;18.9
19;2021-05-22;1271;651;98114;46129;40.8;19.2
19;2021-05-23;324;131;98438;46260;41.0;19.2
19;2021-05-24;139;46;98577;46306;41.0;19.3
19;2021-05-25;1503;492;100080;46798;41.6;19.5
19;2021-05-26;1924;666;102004;47464;42.4;19.7
19;2021-05-27;1786;834;103790;48298;43.2;20.1
19;2021-05-28;1937;990;105727;49288;44.0;20.5
19;2021-05-29;1375;705;107102;49993;44.6;20.8
19;2021-05-30;191;495;107293;50488;44.6;21.0
19;2021-05-31;1199;537;108492;51025;45.1;21.2
19;2021-06-01;1284;886;109776;51911;45.7;21.6
19;2021-06-02;1816;952;111592;52863;46.4;22.0
19;2021-06-03;1447;1251;113039;54114;47.0;22.5
19;2021-06-04;1847;1349;114886;55463;47.8;23.1
19;2021-06-05;1210;815;116096;56278;48.3;23.4
19;2021-06-06;87;648;116183;56926;48.3;23.7
19;2021-06-07;922;934;117105;57860;48.7;24.1
19;2021-06-08;1103;906;118208;58766;49.2;24.5
19;2021-06-09;1329;1459;119537;60225;49.7;25.1
19;2021-06-10;1283;1580;120820;61805;50.3;25.7
19;2021-06-11;1306;1917;122126;63722;50.8;26.5
19;2021-06-12;1356;1314;123482;65036;51.4;27.1
19;2021-06-13;542;424;124024;65460;51.6;27.2
19;2021-06-14;736;1016;124760;66476;51.9;27.7
19;2021-06-15;979;1143;125739;67619;52.3;28.1
19;2021-06-16;1222;1363;126961;68982;52.8;28.7
19;2021-06-17;868;1788;127829;70770;53.2;29.4
19;2021-06-18;1056;2134;128885;72904;53.6;30.3
19;2021-06-19;919;1302;129804;74206;54.0;30.9
19;2021-06-20;395;327;130199;74533;54.2;31.0
19;2021-06-21;500;1074;130699;75607;54.4;31.5
19;2021-06-22;698;1490;131397;77097;54.7;32.1
19;2021-06-23;744;1989;132141;79086;55.0;32.9
19;2021-06-24;687;1663;132828;80749;55.3;33.6
19;2021-06-25;562;2216;133390;82965;55.5;34.5
19;2021-06-26;474;1741;133864;84706;55.7;35.2
19;2021-06-27;289;446;134153;85152;55.8;35.4
19;2021-06-28;315;1499;134468;86651;56.0;36.1
19;2021-06-29;353;1893;134821;88544;56.1;36.8
19;2021-06-30;795;2152;135616;90696;56.4;37.7
19;2021-07-01;361;2322;135977;93018;56.6;38.7
19;2021-07-02;798;2316;136775;95334;56.9;39.7
19;2021-07-03;513;1744;137288;97078;57.1;40.4
19;2021-07-04;1;73;137289;97151;57.1;40.4
19;2021-07-05;600;1015;137889;98166;57.4;40.8
19;2021-07-06;504;1539;138393;99705;57.6;41.5
19;2021-07-07;706;2046;139099;101751;57.9;42.3
19;2021-07-08;770;2148;139869;103899;58.2;43.2
19;2021-07-09;716;2659;140585;106558;58.5;44.3
19;2021-07-10;586;1705;141171;108263;58.7;45.0
19;2021-07-11;45;212;141216;108475;58.8;45.1
19;2021-07-12;445;1486;141661;109961;58.9;45.8
19;2021-07-13;687;1828;142348;111789;59.2;46.5
19;2021-07-14;201;272;142549;112061;59.3;46.6
19;2021-07-15;870;2050;143419;114111;59.7;47.5
19;2021-07-16;1228;2445;144647;116556;60.2;48.5
19;2021-07-17;703;1718;145350;118274;60.5;49.2
19;2021-07-18;365;672;145715;118946;60.6;49.5
19;2021-07-19;968;1398;146683;120344;61.0;50.1
19;2021-07-20;967;1674;147650;122018;61.4;50.8
19;2021-07-21;1083;1710;148733;123728;61.9;51.5
19;2021-07-22;1392;1854;150125;125582;62.5;52.3
19;2021-07-23;1784;1995;151909;127577;63.2;53.1
19;2021-07-24;908;1753;152817;129330;63.6;53.8
19;2021-07-25;164;513;152981;129843;63.7;54.0
19;2021-07-26;911;911;153892;130754;64.0;54.4
19;2021-07-27;1425;1116;155317;131870;64.6;54.9
19;2021-07-28;2045;1221;157362;133091;65.5;55.4
19;2021-07-29;1623;1204;158985;134295;66.2;55.9
19;2021-07-30;1909;1027;160894;135322;66.9;56.3
19;2021-07-31;1129;1018;162023;136340;67.4;56.7
19;2021-08-01;347;372;162370;136712;67.6;56.9
19;2021-08-02;1194;809;163564;137521;68.1;57.2
19;2021-08-03;1453;1055;165017;138576;68.7;57.7
19;2021-08-04;1983;763;167000;139339;69.5;58.0
19;2021-08-05;1630;958;168630;140297;70.2;58.4
19;2021-08-06;1962;1217;170592;141514;71.0;58.9
19;2021-08-07;1335;1000;171927;142514;71.5;59.3
19;2021-08-08;187;234;172114;142748;71.6;59.4
19;2021-08-09;1008;784;173122;143532;72.0;59.7
19;2021-08-10;1280;1013;174402;144545;72.6;60.1
19;2021-08-11;1356;1006;175758;145551;73.1;60.6
19;2021-08-12;1016;1275;176774;146826;73.6;61.1
19;2021-08-13;1181;1275;177955;148101;74.0;61.6
19;2021-08-14;979;1164;178934;149265;74.5;62.1
19;2021-08-15;30;54;178964;149319;74.5;62.1
19;2021-08-16;592;1029;179556;150348;74.7;62.6
19;2021-08-17;633;1167;180189;151515;75.0;63.0
19;2021-08-18;656;979;180845;152494;75.2;63.5
19;2021-08-19;438;1258;181283;153752;75.4;64.0
19;2021-08-20;867;1927;182150;155679;75.8;64.8
19;2021-08-21;495;1376;182645;157055;76.0;65.3
19;2021-08-22;52;93;182697;157148;76.0;65.4
19;2021-08-23;225;1158;182922;158306;76.1;65.9
19;2021-08-24;538;1317;183460;159623;76.3;66.4
19;2021-08-25;649;1557;184109;161180;76.6;67.1
19;2021-08-26;477;1463;184586;162643;76.8;67.7
19;2021-08-27;502;1690;185088;164333;77.0;68.4
19;2021-08-28;360;1278;185448;165611;77.2;68.9
19;2021-08-29;60;182;185508;165793;77.2;69.0
19;2021-08-30;225;1095;185733;166888;77.3;69.4
19;2021-08-31;326;1454;186059;168342;77.4;70.0
19;2021-09-01;365;1480;186424;169822;77.6;70.7
19;2021-09-02;346;1318;186770;171140;77.7;71.2
19;2021-09-03;412;1515;187182;172655;77.9;71.8
19;2021-09-04;301;1394;187483;174049;78.0;72.4
19;2021-09-05;32;245;187515;174294;78.0;72.5
19;2021-09-06;197;697;187712;174991;78.1;72.8
19;2021-09-07;228;822;187940;175813;78.2;73.2
19;2021-09-08;287;934;188227;176747;78.3;73.5
19;2021-09-09;253;618;188480;177365;78.4;73.8
19;2021-09-10;252;853;188732;178218;78.5;74.2
19;2021-09-11;294;1156;189026;179374;78.7;74.6
19;2021-09-12;42;151;189068;179525;78.7;74.7
19;2021-09-13;106;437;189174;179962;78.7;74.9
19;2021-09-14;168;614;189342;180576;78.8;75.1
19;2021-09-15;242;669;189584;181245;78.9;75.4
19;2021-09-16;230;411;189814;181656;79.0;75.6
19;2021-09-17;254;531;190068;182187;79.1;75.8
19;2021-09-18;183;689;190251;182876;79.2;76.1
19;2021-09-19;17;34;190268;182910;79.2;76.1
19;2021-09-20;112;205;190380;183115;79.2;76.2
19;2021-09-21;143;295;190523;183410;79.3;76.3
19;2021-09-22;152;398;190675;183808;79.3;76.5
19;2021-09-23;87;300;190762;184108;79.4;76.6
19;2021-09-24;121;358;190883;184466;79.4;76.8
19;2021-09-25;140;568;191023;185034;79.5;77.0
19;2021-09-26;14;25;191037;185059;79.5;77.0
19;2021-09-27;43;215;191080;185274;79.5;77.1
19;2021-09-28;67;202;191147;185476;79.5;77.2
19;2021-09-29;82;341;191229;185817;79.6;77.3
19;2021-09-30;104;272;191333;186089;79.6;77.4
19;2021-10-01;115;232;191448;186321;79.7;77.5
19;2021-10-02;151;340;191599;186661;79.7;77.7
19;2021-10-03;9;11;191608;186672;79.7;77.7
21;2020-12-27;4;0;4;0;0.0;0.0
21;2020-12-28;2;0;6;0;0.0;0.0
21;2020-12-29;19;0;25;0;0.0;0.0
21;2020-12-30;22;0;47;0;0.0;0.0
21;2020-12-31;0;0;47;0;0.0;0.0
21;2021-01-01;0;0;47;0;0.0;0.0
21;2021-01-02;1;0;48;0;0.0;0.0
21;2021-01-03;1;0;49;0;0.0;0.0
21;2021-01-04;22;0;71;0;0.0;0.0
21;2021-01-05;250;2;321;2;0.1;0.0
21;2021-01-06;300;0;621;2;0.1;0.0
21;2021-01-07;389;0;1010;2;0.2;0.0
21;2021-01-08;455;2;1465;4;0.3;0.0
21;2021-01-09;252;0;1717;4;0.3;0.0
21;2021-01-10;2;0;1719;4;0.3;0.0
21;2021-01-11;624;1;2343;5;0.4;0.0
21;2021-01-12;655;0;2998;5;0.6;0.0
21;2021-01-13;706;2;3704;7;0.7;0.0
21;2021-01-14;1190;6;4894;13;0.9;0.0
21;2021-01-15;719;5;5613;18;1.1;0.0
21;2021-01-16;162;0;5775;18;1.1;0.0
21;2021-01-17;5;0;5780;18;1.1;0.0
21;2021-01-18;1319;4;7099;22;1.3;0.0
21;2021-01-19;1370;1;8469;23;1.6;0.0
21;2021-01-20;1301;45;9770;68;1.8;0.0
21;2021-01-21;1544;4;11314;72;2.1;0.0
21;2021-01-22;1246;5;12560;77;2.4;0.0
21;2021-01-23;490;0;13050;77;2.4;0.0
21;2021-01-24;124;0;13174;77;2.5;0.0
21;2021-01-25;928;18;14102;95;2.6;0.0
21;2021-01-26;1542;135;15644;230;2.9;0.0
21;2021-01-27;2061;145;17705;375;3.3;0.1
21;2021-01-28;1460;216;19165;591;3.6;0.1
21;2021-01-29;1022;209;20187;800;3.8;0.2
21;2021-01-30;470;26;20657;826;3.9;0.2
21;2021-01-31;97;3;20754;829;3.9;0.2
21;2021-02-01;453;280;21207;1109;4.0;0.2
21;2021-02-02;456;428;21663;1537;4.1;0.3
21;2021-02-03;446;271;22109;1808;4.1;0.3
21;2021-02-04;417;524;22526;2332;4.2;0.4
21;2021-02-05;489;448;23015;2780;4.3;0.5
21;2021-02-06;162;218;23177;2998;4.3;0.6
21;2021-02-07;2;2;23179;3000;4.3;0.6
21;2021-02-08;433;367;23612;3367;4.4;0.6
21;2021-02-09;515;466;24127;3833;4.5;0.7
21;2021-02-10;461;541;24588;4374;4.6;0.8
21;2021-02-11;486;713;25074;5087;4.7;1.0
21;2021-02-12;356;825;25430;5912;4.8;1.1
21;2021-02-13;365;243;25795;6155;4.8;1.2
21;2021-02-14;239;130;26034;6285;4.9;1.2
21;2021-02-15;120;1096;26154;7381;4.9;1.4
21;2021-02-16;207;1307;26361;8688;4.9;1.6
21;2021-02-17;402;1760;26763;10448;5.0;2.0
21;2021-02-18;604;1179;27367;11627;5.1;2.2
21;2021-02-19;217;990;27584;12617;5.2;2.4
21;2021-02-20;121;326;27705;12943;5.2;2.4
21;2021-02-21;1;83;27706;13026;5.2;2.4
21;2021-02-22;84;654;27790;13680;5.2;2.6
21;2021-02-23;170;884;27960;14564;5.2;2.7
21;2021-02-24;226;609;28186;15173;5.3;2.8
21;2021-02-25;647;715;28833;15888;5.4;3.0
21;2021-02-26;926;600;29759;16488;5.6;3.1
21;2021-02-27;532;241;30291;16729;5.7;3.1
21;2021-02-28;24;112;30315;16841;5.7;3.2
21;2021-03-01;679;522;30994;17363;5.8;3.3
21;2021-03-02;1055;490;32049;17853;6.0;3.4
21;2021-03-03;1170;381;33219;18234;6.2;3.4
21;2021-03-04;1688;471;34907;18705;6.6;3.5
21;2021-03-05;2196;626;37103;19331;7.0;3.6
21;2021-03-06;1594;189;38697;19520;7.3;3.7
21;2021-03-07;4;15;38701;19535;7.3;3.7
21;2021-03-08;772;410;39473;19945;7.4;3.7
21;2021-03-09;1571;527;41044;20472;7.7;3.8
21;2021-03-10;1627;524;42671;20996;8.0;3.9
21;2021-03-11;2197;670;44868;21666;8.4;4.1
21;2021-03-12;2905;430;47773;22096;9.0;4.1
21;2021-03-13;1932;155;49705;22251;9.3;4.2
21;2021-03-14;38;41;49743;22292;9.3;4.2
21;2021-03-15;1415;87;51158;22379;9.6;4.2
21;2021-03-16;1883;152;53041;22531;10.0;4.2
21;2021-03-17;1810;112;54851;22643;10.3;4.2
21;2021-03-18;2127;260;56978;22903;10.7;4.3
21;2021-03-19;1964;148;58942;23051;11.1;4.3
21;2021-03-20;1228;38;60170;23089;11.3;4.3
21;2021-03-21;2;0;60172;23089;11.3;4.3
21;2021-03-22;1556;92;61728;23181;11.6;4.4
21;2021-03-23;2696;105;64424;23286;12.1;4.4
21;2021-03-24;2895;163;67319;23449;12.6;4.4
21;2021-03-25;3730;245;71049;23694;13.3;4.4
21;2021-03-26;3655;197;74704;23891;14.0;4.5
21;2021-03-27;1732;60;76436;23951;14.3;4.5
21;2021-03-28;200;38;76636;23989;14.4;4.5
21;2021-03-29;1788;511;78424;24500;14.7;4.6
21;2021-03-30;2347;797;80771;25297;15.2;4.7
21;2021-03-31;2718;645;83489;25942;15.7;4.9
21;2021-04-01;2693;720;86182;26662;16.2;5.0
21;2021-04-02;2249;742;88431;27404;16.6;5.1
21;2021-04-03;1018;280;89449;27684;16.8;5.2
21;2021-04-04;2;12;89451;27696;16.8;5.2
21;2021-04-05;9;0;89460;27696;16.8;5.2
21;2021-04-06;1357;1134;90817;28830;17.0;5.4
21;2021-04-07;1750;968;92567;29798;17.4;5.6
21;2021-04-08;3217;1144;95784;30942;18.0;5.8
21;2021-04-09;3481;1184;99265;32126;18.6;6.0
21;2021-04-10;1374;729;100639;32855;18.9;6.2
21;2021-04-11;145;3;100784;32858;18.9;6.2
21;2021-04-12;1117;1344;101901;34202;19.1;6.4
21;2021-04-13;1654;1778;103555;35980;19.4;6.8
21;2021-04-14;1484;1467;105039;37447;19.7;7.0
21;2021-04-15;1900;1590;106939;39037;20.1;7.3
21;2021-04-16;2322;1310;109261;40347;20.5;7.6
21;2021-04-17;1020;973;110281;41320;20.7;7.8
21;2021-04-18;15;4;110296;41324;20.7;7.8
21;2021-04-19;1110;1318;111406;42642;20.9;8.0
21;2021-04-20;1243;1833;112649;44475;21.1;8.3
21;2021-04-21;1095;1720;113744;46195;21.3;8.7
21;2021-04-22;1275;2210;115019;48405;21.6;9.1
21;2021-04-23;1984;1723;117003;50128;22.0;9.4
21;2021-04-24;1001;871;118004;50999;22.1;9.6
21;2021-04-25;9;168;118013;51167;22.1;9.6
21;2021-04-26;1013;1592;119026;52759;22.3;9.9
21;2021-04-27;1842;1932;120868;54691;22.7;10.3
21;2021-04-28;2230;2221;123098;56912;23.1;10.7
21;2021-04-29;3135;2251;126233;59163;23.7;11.1
21;2021-04-30;3562;1821;129795;60984;24.4;11.4
21;2021-05-01;962;225;130757;61209;24.5;11.5
21;2021-05-02;2;5;130759;61214;24.5;11.5
21;2021-05-03;2081;1349;132840;62563;24.9;11.7
21;2021-05-04;2577;1639;135417;64202;25.4;12.0
21;2021-05-05;2247;1690;137664;65892;25.8;12.4
21;2021-05-06;3015;2246;140679;68138;26.4;12.8
21;2021-05-07;2805;2169;143484;70307;26.9;13.2
21;2021-05-08;1067;271;144551;70578;27.1;13.2
21;2021-05-09;26;177;144577;70755;27.1;13.3
21;2021-05-10;3169;1728;147746;72483;27.7;13.6
21;2021-05-11;4923;2002;152669;74485;28.6;14.0
21;2021-05-12;4805;1747;157474;76232;29.6;14.3
21;2021-05-13;3845;368;161319;76600;30.3;14.4
21;2021-05-14;5197;1469;166516;78069;31.2;14.7
21;2021-05-15;3428;647;169944;78716;31.9;14.8
21;2021-05-16;49;4;169993;78720;31.9;14.8
21;2021-05-17;4128;1256;174121;79976;32.7;15.0
21;2021-05-18;4359;1500;178480;81476;33.5;15.3
21;2021-05-19;3470;1124;181950;82600;34.1;15.5
21;2021-05-20;3898;1359;185848;83959;34.9;15.8
21;2021-05-21;3628;2153;189476;86112;35.6;16.2
21;2021-05-22;1669;768;191145;86880;35.9;16.3
21;2021-05-23;4;17;191149;86897;35.9;16.3
21;2021-05-24;1815;266;192964;87163;36.2;16.4
21;2021-05-25;2648;1960;195612;89123;36.7;16.7
21;2021-05-26;2604;2000;198216;91123;37.2;17.1
21;2021-05-27;4014;2088;202230;93211;37.9;17.5
21;2021-05-28;3572;2813;205802;96024;38.6;18.0
21;2021-05-29;1932;1468;207734;97492;39.0;18.3
21;2021-05-30;98;13;207832;97505;39.0;18.3
21;2021-05-31;2501;1776;210333;99281;39.5;18.6
21;2021-06-01;3449;2247;213782;101528;40.1;19.1
21;2021-06-02;2617;1757;216399;103285;40.6;19.4
21;2021-06-03;3146;2075;219545;105360;41.2;19.8
21;2021-06-04;3286;2585;222831;107945;41.8;20.3
21;2021-06-05;2922;1654;225753;109599;42.4;20.6
21;2021-06-06;51;85;225804;109684;42.4;20.6
21;2021-06-07;4314;1344;230118;111028;43.2;20.8
21;2021-06-08;4935;2144;235053;113172;44.1;21.2
21;2021-06-09;4500;1625;239553;114797;45.0;21.5
21;2021-06-10;3933;2595;243486;117392;45.7;22.0
21;2021-06-11;4164;3096;247650;120488;46.5;22.6
21;2021-06-12;2199;1606;249849;122094;46.9;22.9
21;2021-06-13;29;11;249878;122105;46.9;22.9
21;2021-06-14;2197;2563;252075;124668;47.3;23.4
21;2021-06-15;2958;3088;255033;127756;47.9;24.0
21;2021-06-16;2850;2609;257883;130365;48.4;24.5
21;2021-06-17;3422;3040;261305;133405;49.0;25.0
21;2021-06-18;2424;3796;263729;137201;49.5;25.7
21;2021-06-19;2045;1863;265774;139064;49.9;26.1
21;2021-06-20;26;13;265800;139077;49.9;26.1
21;2021-06-21;1840;3404;267640;142481;50.2;26.7
21;2021-06-22;1885;5828;269525;148309;50.6;27.8
21;2021-06-23;2030;5011;271555;153320;51.0;28.8
21;2021-06-24;2367;4663;273922;157983;51.4;29.6
21;2021-06-25;1530;5894;275452;163877;51.7;30.8
21;2021-06-26;1441;3898;276893;167775;52.0;31.5
21;2021-06-27;18;125;276911;167900;52.0;31.5
21;2021-06-28;1397;4014;278308;171914;52.2;32.3
21;2021-06-29;1633;4174;279941;176088;52.5;33.0
21;2021-06-30;1568;3372;281509;179460;52.8;33.7
21;2021-07-01;1663;4147;283172;183607;53.1;34.5
21;2021-07-02;2179;4229;285351;187836;53.5;35.2
21;2021-07-03;1095;2101;286446;189937;53.8;35.6
21;2021-07-04;37;55;286483;189992;53.8;35.7
21;2021-07-05;1610;3627;288093;193619;54.1;36.3
21;2021-07-06;1349;3580;289442;197199;54.3;37.0
21;2021-07-07;1455;3240;290897;200439;54.6;37.6
21;2021-07-08;1884;4159;292781;204598;54.9;38.4
21;2021-07-09;2081;4346;294862;208944;55.3;39.2
21;2021-07-10;1089;2546;295951;211490;55.5;39.7
21;2021-07-11;21;74;295972;211564;55.5;39.7
21;2021-07-12;1656;3727;297628;215291;55.9;40.4
21;2021-07-13;2343;4885;299971;220176;56.3;41.3
21;2021-07-14;2874;2017;302845;222193;56.8;41.7
21;2021-07-15;3814;4550;306659;226743;57.5;42.6
21;2021-07-16;3890;5250;310549;231993;58.3;43.5
21;2021-07-17;2775;4168;313324;236161;58.8;44.3
21;2021-07-18;157;82;313481;236243;58.8;44.3
21;2021-07-19;2375;4624;315856;240867;59.3;45.2
21;2021-07-20;2760;5486;318616;246353;59.8;46.2
21;2021-07-21;2908;4786;321524;251139;60.3;47.1
21;2021-07-22;3026;4719;324550;255858;60.9;48.0
21;2021-07-23;4352;4896;328902;260754;61.7;48.9
21;2021-07-24;3034;3020;331936;263774;62.3;49.5
21;2021-07-25;68;40;332004;263814;62.3;49.5
21;2021-07-26;2663;3588;334667;267402;62.8;50.2
21;2021-07-27;3412;3772;338079;271174;63.4;50.9
21;2021-07-28;3574;3353;341653;274527;64.1;51.5
21;2021-07-29;4135;3364;345788;277891;64.9;52.1
21;2021-07-30;4622;3346;350410;281237;65.8;52.8
21;2021-07-31;3427;2378;353837;283615;66.4;53.2
21;2021-08-01;330;57;354167;283672;66.5;53.2
21;2021-08-02;2539;3167;356706;286839;66.9;53.8
21;2021-08-03;2624;2761;359330;289600;67.4;54.3
21;2021-08-04;2364;2487;361694;292087;67.9;54.8
21;2021-08-05;2219;3078;363913;295165;68.3;55.4
21;2021-08-06;2590;3308;366503;298473;68.8;56.0
21;2021-08-07;1905;2660;368408;301133;69.1;56.5
21;2021-08-08;75;70;368483;301203;69.1;56.5
21;2021-08-09;1650;2930;370133;304133;69.5;57.1
21;2021-08-10;1413;2715;371546;306848;69.7;57.6
21;2021-08-11;1666;2446;373212;309294;70.0;58.0
21;2021-08-12;1174;2417;374386;311711;70.3;58.5
21;2021-08-13;1521;2747;375907;314458;70.5;59.0
21;2021-08-14;860;2435;376767;316893;70.7;59.5
21;2021-08-15;51;64;376818;316957;70.7;59.5
21;2021-08-16;1400;2823;378218;319780;71.0;60.0
21;2021-08-17;1205;2775;379423;322555;71.2;60.5
21;2021-08-18;1030;2872;380453;325427;71.4;61.1
21;2021-08-19;957;3067;381410;328494;71.6;61.6
21;2021-08-20;1063;4192;382473;332686;71.8;62.4
21;2021-08-21;844;3143;383317;335829;71.9;63.0
21;2021-08-22;34;116;383351;335945;71.9;63.0
21;2021-08-23;938;3220;384289;339165;72.1;63.6
21;2021-08-24;988;2877;385277;342042;72.3;64.2
21;2021-08-25;870;2551;386147;344593;72.5;64.7
21;2021-08-26;728;2426;386875;347019;72.6;65.1
21;2021-08-27;1035;3398;387910;350417;72.8;65.8
21;2021-08-28;711;2756;388621;353173;72.9;66.3
21;2021-08-29;45;215;388666;353388;72.9;66.3
21;2021-08-30;789;2270;389455;355658;73.1;66.7
21;2021-08-31;943;2107;390398;357765;73.3;67.1
21;2021-09-01;625;1783;391023;359548;73.4;67.5
21;2021-09-02;546;1462;391569;361010;73.5;67.7
21;2021-09-03;787;2034;392356;363044;73.6;68.1
21;2021-09-04;752;1676;393108;364720;73.8;68.4
21;2021-09-05;69;107;393177;364827;73.8;68.5
21;2021-09-06;409;1478;393586;366305;73.9;68.7
21;2021-09-07;389;1311;393975;367616;73.9;69.0
21;2021-09-08;550;1606;394525;369222;74.0;69.3
21;2021-09-09;397;1382;394922;370604;74.1;69.5
21;2021-09-10;661;1766;395583;372370;74.2;69.9
21;2021-09-11;472;1462;396055;373832;74.3;70.2
21;2021-09-12;19;35;396074;373867;74.3;70.2
21;2021-09-13;250;891;396324;374758;74.4;70.3
21;2021-09-14;459;1317;396783;376075;74.5;70.6
21;2021-09-15;485;905;397268;376980;74.6;70.7
21;2021-09-16;337;758;397605;377738;74.6;70.9
21;2021-09-17;549;1056;398154;378794;74.7;71.1
21;2021-09-18;327;1004;398481;379798;74.8;71.3
21;2021-09-19;5;21;398486;379819;74.8;71.3
21;2021-09-20;248;619;398734;380438;74.8;71.4
21;2021-09-21;366;664;399100;381102;74.9;71.5
21;2021-09-22;336;905;399436;382007;75.0;71.7
21;2021-09-23;273;521;399709;382528;75.0;71.8
21;2021-09-24;359;806;400068;383334;75.1;71.9
21;2021-09-25;216;866;400284;384200;75.1;72.1
21;2021-09-26;6;21;400290;384221;75.1;72.1
21;2021-09-27;242;447;400532;384668;75.2;72.2
21;2021-09-28;208;486;400740;385154;75.2;72.3
21;2021-09-29;242;532;400982;385686;75.2;72.4
21;2021-09-30;287;402;401269;386088;75.3;72.5
21;2021-10-01;341;828;401610;386916;75.4;72.6
21;2021-10-02;221;569;401831;387485;75.4;72.7
21;2021-10-03;6;22;401837;387507;75.4;72.7
22;2020-12-27;0;0;0;0;0.0;0.0
22;2020-12-28;0;0;0;0;0.0;0.0
22;2020-12-29;0;0;0;0;0.0;0.0
22;2020-12-30;0;0;0;0;0.0;0.0
22;2020-12-31;0;0;0;0;0.0;0.0
22;2021-01-01;0;0;0;0;0.0;0.0
22;2021-01-02;2;0;2;0;0.0;0.0
22;2021-01-03;0;0;2;0;0.0;0.0
22;2021-01-04;5;0;7;0;0.0;0.0
22;2021-01-05;61;0;68;0;0.0;0.0
22;2021-01-06;114;1;182;1;0.0;0.0
22;2021-01-07;67;0;249;1;0.0;0.0
22;2021-01-08;174;0;423;1;0.1;0.0
22;2021-01-09;1;0;424;1;0.1;0.0
22;2021-01-10;0;0;424;1;0.1;0.0
22;2021-01-11;234;1;658;2;0.1;0.0
22;2021-01-12;627;0;1285;2;0.2;0.0
22;2021-01-13;677;1;1962;3;0.3;0.0
22;2021-01-14;717;8;2679;11;0.4;0.0
22;2021-01-15;529;2;3208;13;0.5;0.0
22;2021-01-16;96;0;3304;13;0.6;0.0
22;2021-01-17;1;0;3305;13;0.6;0.0
22;2021-01-18;312;1;3617;14;0.6;0.0
22;2021-01-19;686;0;4303;14;0.7;0.0
22;2021-01-20;598;1;4901;15;0.8;0.0
22;2021-01-21;947;1;5848;16;1.0;0.0
22;2021-01-22;840;2;6688;18;1.1;0.0
22;2021-01-23;219;0;6907;18;1.2;0.0
22;2021-01-24;2;0;6909;18;1.2;0.0
22;2021-01-25;751;9;7660;27;1.3;0.0
22;2021-01-26;1018;59;8678;86;1.5;0.0
22;2021-01-27;3858;109;12536;195;2.1;0.0
22;2021-01-28;4511;83;17047;278;2.9;0.0
22;2021-01-29;1898;120;18945;398;3.2;0.1
22;2021-01-30;289;0;19234;398;3.2;0.1
22;2021-01-31;3;0;19237;398;3.2;0.1
22;2021-02-01;642;75;19879;473;3.3;0.1
22;2021-02-02;903;414;20782;887;3.5;0.1
22;2021-02-03;691;472;21473;1359;3.6;0.2
22;2021-02-04;964;611;22437;1970;3.8;0.3
22;2021-02-05;722;512;23159;2482;3.9;0.4
22;2021-02-06;256;0;23415;2482;3.9;0.4
22;2021-02-07;0;0;23415;2482;3.9;0.4
22;2021-02-08;531;112;23946;2594;4.0;0.4
22;2021-02-09;614;264;24560;2858;4.1;0.5
22;2021-02-10;425;180;24985;3038;4.2;0.5
22;2021-02-11;1085;299;26070;3337;4.4;0.6
22;2021-02-12;594;296;26664;3633;4.5;0.6
22;2021-02-13;319;70;26983;3703;4.5;0.6
22;2021-02-14;0;4;26983;3707;4.5;0.6
22;2021-02-15;672;363;27655;4070;4.6;0.7
22;2021-02-16;1042;597;28697;4667;4.8;0.8
22;2021-02-17;1203;2311;29900;6978;5.0;1.2
22;2021-02-18;2147;2651;32047;9629;5.4;1.6
22;2021-02-19;1637;1753;33684;11382;5.6;1.9
22;2021-02-20;480;157;34164;11539;5.7;1.9
22;2021-02-21;6;49;34170;11588;5.7;1.9
22;2021-02-22;401;570;34571;12158;5.8;2.0
22;2021-02-23;665;766;35236;12924;5.9;2.2
22;2021-02-24;695;767;35931;13691;6.0;2.3
22;2021-02-25;1200;1003;37131;14694;6.2;2.5
22;2021-02-26;1066;601;38197;15295;6.4;2.6
22;2021-02-27;564;219;38761;15514;6.5;2.6
22;2021-02-28;16;8;38777;15522;6.5;2.6
22;2021-03-01;958;455;39735;15977;6.7;2.7
22;2021-03-02;1207;748;40942;16725;6.9;2.8
22;2021-03-03;1325;737;42267;17462;7.1;2.9
22;2021-03-04;1602;796;43869;18258;7.4;3.1
22;2021-03-05;2108;692;45977;18950;7.7;3.2
22;2021-03-06;1114;244;47091;19194;7.9;3.2
22;2021-03-07;219;1;47310;19195;7.9;3.2
22;2021-03-08;1291;585;48601;19780;8.2;3.3
22;2021-03-09;1824;670;50425;20450;8.5;3.4
22;2021-03-10;1988;927;52413;21377;8.8;3.6
22;2021-03-11;2375;1544;54788;22921;9.2;3.8
22;2021-03-12;3101;908;57889;23829;9.7;4.0
22;2021-03-13;1721;277;59610;24106;10.0;4.0
22;2021-03-14;245;23;59855;24129;10.0;4.0
22;2021-03-15;1620;555;61475;24684;10.3;4.1
22;2021-03-16;1603;837;63078;25521;10.6;4.3
22;2021-03-17;2651;689;65729;26210;11.0;4.4
22;2021-03-18;2552;1095;68281;27305;11.5;4.6
22;2021-03-19;3281;792;71562;28097;12.0;4.7
22;2021-03-20;2208;282;73770;28379;12.4;4.8
22;2021-03-21;16;0;73786;28379;12.4;4.8
22;2021-03-22;2363;359;76149;28738;12.8;4.8
22;2021-03-23;3142;780;79291;29518;13.3;5.0
22;2021-03-24;3485;682;82776;30200;13.9;5.1
22;2021-03-25;3961;606;86737;30806;14.5;5.2
22;2021-03-26;4003;483;90740;31289;15.2;5.2
22;2021-03-27;2092;179;92832;31468;15.6;5.3
22;2021-03-28;67;1;92899;31469;15.6;5.3
22;2021-03-29;2766;905;95665;32374;16.0;5.4
22;2021-03-30;3567;1149;99232;33523;16.6;5.6
22;2021-03-31;3674;1080;102906;34603;17.3;5.8
22;2021-04-01;4944;1129;107850;35732;18.1;6.0
22;2021-04-02;4390;1034;112240;36766;18.8;6.2
22;2021-04-03;1998;403;114238;37169;19.2;6.2
22;2021-04-04;37;0;114275;37169;19.2;6.2
22;2021-04-05;15;0;114290;37169;19.2;6.2
22;2021-04-06;3288;1135;117578;38304;19.7;6.4
22;2021-04-07;3429;1364;121007;39668;20.3;6.7
22;2021-04-08;4447;1322;125454;40990;21.0;6.9
22;2021-04-09;5183;1361;130637;42351;21.9;7.1
22;2021-04-10;2447;365;133084;42716;22.3;7.2
22;2021-04-11;485;10;133569;42726;22.4;7.2
22;2021-04-12;2988;1007;136557;43733;22.9;7.3
22;2021-04-13;3318;1516;139875;45249;23.5;7.6
22;2021-04-14;3167;2483;143042;47732;24.0;8.0
22;2021-04-15;3600;2430;146642;50162;24.6;8.4
22;2021-04-16;3633;2485;150275;52647;25.2;8.8
22;2021-04-17;1920;1792;152195;54439;25.5;9.1
22;2021-04-18;17;0;152212;54439;25.5;9.1
22;2021-04-19;3021;2145;155233;56584;26.0;9.5
22;2021-04-20;3310;2793;158543;59377;26.6;10.0
22;2021-04-21;3223;2731;161766;62108;27.1;10.4
22;2021-04-22;3593;3128;165359;65236;27.7;10.9
22;2021-04-23;3726;3172;169085;68408;28.4;11.5
22;2021-04-24;2005;1962;171090;70370;28.7;11.8
22;2021-04-25;17;0;171107;70370;28.7;11.8
22;2021-04-26;3213;2854;174320;73224;29.2;12.3
22;2021-04-27;3371;3128;177691;76352;29.8;12.8
22;2021-04-28;3488;3149;181179;79501;30.4;13.3
22;2021-04-29;4080;3245;185259;82746;31.1;13.9
22;2021-04-30;3906;3216;189165;85962;31.7;14.4
22;2021-05-01;60;69;189225;86031;31.7;14.4
22;2021-05-02;1237;59;190462;86090;31.9;14.4
22;2021-05-03;2029;2711;192491;88801;32.3;14.9
22;2021-05-04;2155;2893;194646;91694;32.6;15.4
22;2021-05-05;2049;3006;196695;94700;33.0;15.9
22;2021-05-06;2508;3488;199203;98188;33.4;16.5
22;2021-05-07;2829;3383;202032;101571;33.9;17.0
22;2021-05-08;45;120;202077;101691;33.9;17.1
22;2021-05-09;602;438;202679;102129;34.0;17.1
22;2021-05-10;4473;2728;207152;104857;34.7;17.6
22;2021-05-11;5106;2889;212258;107746;35.6;18.1
22;2021-05-12;6599;1016;218857;108762;36.7;18.2
22;2021-05-13;528;35;219385;108797;36.8;18.2
22;2021-05-14;6406;1075;225791;109872;37.9;18.4
22;2021-05-15;3988;419;229779;110291;38.5;18.5
22;2021-05-16;419;37;230198;110328;38.6;18.5
22;2021-05-17;5668;517;235866;110845;39.6;18.6
22;2021-05-18;6011;947;241877;111792;40.6;18.8
22;2021-05-19;6130;705;248007;112497;41.6;18.9
22;2021-05-20;6587;1369;254594;113866;42.7;19.1
22;2021-05-21;5899;1449;260493;115315;43.7;19.3
22;2021-05-22;4093;768;264586;116083;44.4;19.5
22;2021-05-23;407;17;264993;116100;44.4;19.5
22;2021-05-24;5315;226;270308;116326;45.3;19.5
22;2021-05-25;5637;1170;275945;117496;46.3;19.7
22;2021-05-26;4226;2808;280171;120304;47.0;20.2
22;2021-05-27;4503;3830;284674;124134;47.7;20.8
22;2021-05-28;4384;4417;289058;128551;48.5;21.6
22;2021-05-29;3046;1770;292104;130321;49.0;21.9
22;2021-05-30;19;7;292123;130328;49.0;21.9
22;2021-05-31;3653;3148;295776;133476;49.6;22.4
22;2021-06-01;3520;3685;299296;137161;50.2;23.0
22;2021-06-02;3085;3375;302381;140536;50.7;23.6
22;2021-06-03;3196;4085;305577;144621;51.3;24.3
22;2021-06-04;3371;4535;308948;149156;51.8;25.0
22;2021-06-05;3543;2025;312491;151181;52.4;25.4
22;2021-06-06;214;30;312705;151211;52.5;25.4
22;2021-06-07;3042;3254;315747;154465;53.0;25.9
22;2021-06-08;2798;3525;318545;157990;53.4;26.5
22;2021-06-09;2543;3506;321088;161496;53.9;27.1
22;2021-06-10;2516;4242;323604;165738;54.3;27.8
22;2021-06-11;2551;4226;326155;169964;54.7;28.5
22;2021-06-12;2411;1453;328566;171417;55.1;28.8
22;2021-06-13;134;1093;328700;172510;55.1;28.9
22;2021-06-14;2644;2462;331344;174972;55.6;29.3
22;2021-06-15;3095;2995;334439;177967;56.1;29.9
22;2021-06-16;3007;2806;337446;180773;56.6;30.3
22;2021-06-17;2560;3174;340006;183947;57.0;30.9
22;2021-06-18;3101;4111;343107;188058;57.6;31.5
22;2021-06-19;2984;1453;346091;189511;58.1;31.8
22;2021-06-20;157;8;346248;189519;58.1;31.8
22;2021-06-21;1783;5020;348031;194539;58.4;32.6
22;2021-06-22;2403;5547;350434;200086;58.8;33.6
22;2021-06-23;1284;6202;351718;206288;59.0;34.6
22;2021-06-24;2578;3912;354296;210200;59.4;35.3
22;2021-06-25;1568;6808;355864;217008;59.7;36.4
22;2021-06-26;783;3853;356647;220861;59.8;37.0
22;2021-06-27;4;511;356651;221372;59.8;37.1
22;2021-06-28;1051;5586;357702;226958;60.0;38.1
22;2021-06-29;1375;5949;359077;232907;60.2;39.1
22;2021-06-30;1129;5735;360206;238642;60.4;40.0
22;2021-07-01;1383;6034;361589;244676;60.7;41.0
22;2021-07-02;1708;6089;363297;250765;60.9;42.1
22;2021-07-03;1009;3818;364306;254583;61.1;42.7
22;2021-07-04;149;365;364455;254948;61.1;42.8
22;2021-07-05;1598;5804;366053;260752;61.4;43.7
22;2021-07-06;2313;5992;368366;266744;61.8;44.7
22;2021-07-07;2291;4933;370657;271677;62.2;45.6
22;2021-07-08;2503;5096;373160;276773;62.6;46.4
22;2021-07-09;2496;5377;375656;282150;63.0;47.3
22;2021-07-10;1808;3356;377464;285506;63.3;47.9
22;2021-07-11;484;75;377948;285581;63.4;47.9
22;2021-07-12;2334;4722;380282;290303;63.8;48.7
22;2021-07-13;3782;5054;384064;295357;64.4;49.5
22;2021-07-14;700;2494;384764;297851;64.5;50.0
22;2021-07-15;3869;4619;388633;302470;65.2;50.7
22;2021-07-16;3836;5290;392469;307760;65.8;51.6
22;2021-07-17;2558;3410;395027;311170;66.3;52.2
22;2021-07-18;570;88;395597;311258;66.4;52.2
22;2021-07-19;2773;4103;398370;315361;66.8;52.9
22;2021-07-20;3923;4129;402293;319490;67.5;53.6
22;2021-07-21;3998;3406;406291;322896;68.1;54.2
22;2021-07-22;4858;3704;411149;326600;69.0;54.8
22;2021-07-23;4452;4219;415601;330819;69.7;55.5
22;2021-07-24;2260;2614;417861;333433;70.1;55.9
22;2021-07-25;118;150;417979;333583;70.1;56.0
22;2021-07-26;3022;3918;421001;337501;70.6;56.6
22;2021-07-27;3725;4912;424726;342413;71.2;57.4
22;2021-07-28;3706;3661;428432;346074;71.9;58.0
22;2021-07-29;4294;3779;432726;349853;72.6;58.7
22;2021-07-30;4039;3971;436765;353824;73.3;59.3
22;2021-07-31;2402;2805;439167;356629;73.7;59.8
22;2021-08-01;118;150;439285;356779;73.7;59.8
22;2021-08-02;4670;2552;443955;359331;74.5;60.3
22;2021-08-03;4787;3426;448742;362757;75.3;60.8
22;2021-08-04;5773;2494;454515;365251;76.2;61.3
22;2021-08-05;4127;3802;458642;369053;76.9;61.9
22;2021-08-06;3654;3810;462296;372863;77.5;62.5
22;2021-08-07;2355;2269;464651;375132;77.9;62.9
22;2021-08-08;427;71;465078;375203;78.0;62.9
22;2021-08-09;2722;2707;467800;377910;78.5;63.4
22;2021-08-10;2735;3513;470535;381423;78.9;64.0
22;2021-08-11;2429;3114;472964;384537;79.3;64.5
22;2021-08-12;2216;3476;475180;388013;79.7;65.1
22;2021-08-13;1935;2970;477115;390983;80.0;65.6
22;2021-08-14;1343;1911;478458;392894;80.3;65.9
22;2021-08-15;87;198;478545;393092;80.3;65.9
22;2021-08-16;1470;3177;480015;396269;80.5;66.5
22;2021-08-17;1757;3459;481772;399728;80.8;67.0
22;2021-08-18;1406;3302;483178;403030;81.0;67.6
22;2021-08-19;1348;3609;484526;406639;81.3;68.2
22;2021-08-20;1462;3605;485988;410244;81.5;68.8
22;2021-08-21;816;2261;486804;412505;81.7;69.2
22;2021-08-22;151;308;486955;412813;81.7;69.2
22;2021-08-23;1967;3608;488922;416421;82.0;69.8
22;2021-08-24;1431;3246;490353;419667;82.2;70.4
22;2021-08-25;844;2507;491197;422174;82.4;70.8
22;2021-08-26;1055;4294;492252;426468;82.6;71.5
22;2021-08-27;1326;4602;493578;431070;82.8;72.3
22;2021-08-28;738;2517;494316;433587;82.9;72.7
22;2021-08-29;35;26;494351;433613;82.9;72.7
22;2021-08-30;925;2964;495276;436577;83.1;73.2
22;2021-08-31;966;3798;496242;440375;83.2;73.9
22;2021-09-01;969;3419;497211;443794;83.4;74.4
22;2021-09-02;838;3062;498049;446856;83.5;75.0
22;2021-09-03;943;3067;498992;449923;83.7;75.5
22;2021-09-04;782;2736;499774;452659;83.8;75.9
22;2021-09-05;96;47;499870;452706;83.8;75.9
22;2021-09-06;489;2184;500359;454890;83.9;76.3
22;2021-09-07;513;2302;500872;457192;84.0;76.7
22;2021-09-08;631;2189;501503;459381;84.1;77.1
22;2021-09-09;677;2314;502180;461695;84.2;77.4
22;2021-09-10;705;2438;502885;464133;84.4;77.9
22;2021-09-11;583;1821;503468;465954;84.4;78.2
22;2021-09-12;31;85;503499;466039;84.5;78.2
22;2021-09-13;481;2589;503980;468628;84.5;78.6
22;2021-09-14;585;2311;504565;470939;84.6;79.0
22;2021-09-15;450;1703;505015;472642;84.7;79.3
22;2021-09-16;551;1041;505566;473683;84.8;79.5
22;2021-09-17;619;1630;506185;475313;84.9;79.7
22;2021-09-18;283;2161;506468;477474;85.0;80.1
22;2021-09-19;1;8;506469;477482;85.0;80.1
22;2021-09-20;362;708;506831;478190;85.0;80.2
22;2021-09-21;363;956;507194;479146;85.1;80.4
22;2021-09-22;298;1160;507492;480306;85.1;80.6
22;2021-09-23;398;718;507890;481024;85.2;80.7
22;2021-09-24;362;1099;508252;482123;85.3;80.9
22;2021-09-25;218;1386;508470;483509;85.3;81.1
22;2021-09-26;12;70;508482;483579;85.3;81.1
22;2021-09-27;334;744;508816;484323;85.3;81.2
22;2021-09-28;203;576;509019;484899;85.4;81.3
22;2021-09-29;231;887;509250;485786;85.4;81.5
22;2021-09-30;271;740;509521;486526;85.5;81.6
22;2021-10-01;277;777;509798;487303;85.5;81.7
22;2021-10-02;317;915;510115;488218;85.6;81.9
22;2021-10-03;0;0;510115;488218;85.6;81.9
23;2020-12-27;0;0;0;0;0.0;0.0
23;2020-12-28;2;0;2;0;0.0;0.0
23;2020-12-29;0;0;2;0;0.0;0.0
23;2020-12-30;0;0;2;0;0.0;0.0
23;2020-12-31;0;0;2;0;0.0;0.0
23;2021-01-01;0;0;2;0;0.0;0.0
23;2021-01-02;1;0;3;0;0.0;0.0
23;2021-01-03;1;0;4;0;0.0;0.0
23;2021-01-04;1;0;5;0;0.0;0.0
23;2021-01-05;3;0;8;0;0.0;0.0
23;2021-01-06;10;0;18;0;0.0;0.0
23;2021-01-07;116;1;134;1;0.1;0.0
23;2021-01-08;117;0;251;1;0.2;0.0
23;2021-01-09;36;0;287;1;0.2;0.0
23;2021-01-10;1;0;288;1;0.2;0.0
23;2021-01-11;176;1;464;2;0.4;0.0
23;2021-01-12;237;3;701;5;0.6;0.0
23;2021-01-13;310;0;1011;5;0.9;0.0
23;2021-01-14;293;4;1304;9;1.1;0.0
23;2021-01-15;334;5;1638;14;1.4;0.0
23;2021-01-16;163;1;1801;15;1.5;0.0
23;2021-01-17;0;0;1801;15;1.5;0.0
23;2021-01-18;342;3;2143;18;1.8;0.0
23;2021-01-19;498;2;2641;20;2.3;0.0
23;2021-01-20;363;1;3004;21;2.6;0.0
23;2021-01-21;700;1;3704;22;3.2;0.0
23;2021-01-22;479;0;4183;22;3.6;0.0
23;2021-01-23;368;1;4551;23;3.9;0.0
23;2021-01-24;0;0;4551;23;3.9;0.0
23;2021-01-25;382;16;4933;39;4.2;0.0
23;2021-01-26;301;5;5234;44;4.5;0.0
23;2021-01-27;226;2;5460;46;4.7;0.0
23;2021-01-28;232;30;5692;76;4.9;0.1
23;2021-01-29;304;98;5996;174;5.2;0.1
23;2021-01-30;100;24;6096;198;5.2;0.2
23;2021-01-31;2;33;6098;231;5.2;0.2
23;2021-02-01;148;80;6246;311;5.4;0.3
23;2021-02-02;157;107;6403;418;5.5;0.4
23;2021-02-03;105;178;6508;596;5.6;0.5
23;2021-02-04;77;247;6585;843;5.7;0.7
23;2021-02-05;117;274;6702;1117;5.8;1.0
23;2021-02-06;14;127;6716;1244;5.8;1.1
23;2021-02-07;1;0;6717;1244;5.8;1.1
23;2021-02-08;123;166;6840;1410;5.9;1.2
23;2021-02-09;89;254;6929;1664;6.0;1.4
23;2021-02-10;92;227;7021;1891;6.0;1.6
23;2021-02-11;246;513;7267;2404;6.3;2.1
23;2021-02-12;174;258;7441;2662;6.4;2.3
23;2021-02-13;8;178;7449;2840;6.4;2.4
23;2021-02-14;8;0;7457;2840;6.4;2.4
23;2021-02-15;157;300;7614;3140;6.5;2.7
23;2021-02-16;103;368;7717;3508;6.6;3.0
23;2021-02-17;65;403;7782;3911;6.7;3.4
23;2021-02-18;142;304;7924;4215;6.8;3.6
23;2021-02-19;109;203;8033;4418;6.9;3.8
23;2021-02-20;2;81;8035;4499;6.9;3.9
23;2021-02-21;0;0;8035;4499;6.9;3.9
23;2021-02-22;104;178;8139;4677;7.0;4.0
23;2021-02-23;108;174;8247;4851;7.1;4.2
23;2021-02-24;176;140;8423;4991;7.2;4.3
23;2021-02-25;184;86;8607;5077;7.4;4.4
23;2021-02-26;287;149;8894;5226;7.6;4.5
23;2021-02-27;112;11;9006;5237;7.7;4.5
23;2021-02-28;1;31;9007;5268;7.7;4.5
23;2021-03-01;88;172;9095;5440;7.8;4.7
23;2021-03-02;229;115;9324;5555;8.0;4.8
23;2021-03-03;133;79;9457;5634;8.1;4.8
23;2021-03-04;307;129;9764;5763;8.4;5.0
23;2021-03-05;517;104;10281;5867;8.8;5.0
23;2021-03-06;494;6;10775;5873;9.3;5.1
23;2021-03-07;313;3;11088;5876;9.5;5.1
23;2021-03-08;197;70;11285;5946;9.7;5.1
23;2021-03-09;421;102;11706;6048;10.1;5.2
23;2021-03-10;348;37;12054;6085;10.4;5.2
23;2021-03-11;324;44;12378;6129;10.6;5.3
23;2021-03-12;621;34;12999;6163;11.2;5.3
23;2021-03-13;287;12;13286;6175;11.4;5.3
23;2021-03-14;47;34;13333;6209;11.5;5.3
23;2021-03-15;220;124;13553;6333;11.7;5.4
23;2021-03-16;192;80;13745;6413;11.8;5.5
23;2021-03-17;131;99;13876;6512;11.9;5.6
23;2021-03-18;192;92;14068;6604;12.1;5.7
23;2021-03-19;207;117;14275;6721;12.3;5.8
23;2021-03-20;631;37;14906;6758;12.8;5.8
23;2021-03-21;128;0;15034;6758;12.9;5.8
23;2021-03-22;274;156;15308;6914;13.2;5.9
23;2021-03-23;504;101;15812;7015;13.6;6.0
23;2021-03-24;422;124;16234;7139;14.0;6.1
23;2021-03-25;821;188;17055;7327;14.7;6.3
23;2021-03-26;735;193;17790;7520;15.3;6.5
23;2021-03-27;507;50;18297;7570;15.7;6.5
23;2021-03-28;3;9;18300;7579;15.7;6.5
23;2021-03-29;358;108;18658;7687;16.0;6.6
23;2021-03-30;537;178;19195;7865;16.5;6.8
23;2021-03-31;411;171;19606;8036;16.9;6.9
23;2021-04-01;600;172;20206;8208;17.4;7.1
23;2021-04-02;498;296;20704;8504;17.8;7.3
23;2021-04-03;715;44;21419;8548;18.4;7.4
23;2021-04-04;4;0;21423;8548;18.4;7.4
23;2021-04-05;2;3;21425;8551;18.4;7.4
23;2021-04-06;382;293;21807;8844;18.8;7.6
23;2021-04-07;706;309;22513;9153;19.4;7.9
23;2021-04-08;805;237;23318;9390;20.1;8.1
23;2021-04-09;940;366;24258;9756;20.9;8.4
23;2021-04-10;1097;111;25355;9867;21.8;8.5
23;2021-04-11;21;2;25376;9869;21.8;8.5
23;2021-04-12;692;236;26068;10105;22.4;8.7
23;2021-04-13;670;302;26738;10407;23.0;9.0
23;2021-04-14;586;178;27324;10585;23.5;9.1
23;2021-04-15;928;185;28252;10770;24.3;9.3
23;2021-04-16;905;213;29157;10983;25.1;9.4
23;2021-04-17;996;553;30153;11536;25.9;9.9
23;2021-04-18;3;136;30156;11672;25.9;10.0
23;2021-04-19;612;297;30768;11969;26.5;10.3
23;2021-04-20;721;292;31489;12261;27.1;10.5
23;2021-04-21;733;397;32222;12658;27.7;10.9
23;2021-04-22;655;472;32877;13130;28.3;11.3
23;2021-04-23;596;346;33473;13476;28.8;11.6
23;2021-04-24;855;449;34328;13925;29.5;12.0
23;2021-04-25;0;0;34328;13925;29.5;12.0
23;2021-04-26;615;253;34943;14178;30.1;12.2
23;2021-04-27;675;419;35618;14597;30.6;12.6
23;2021-04-28;628;276;36246;14873;31.2;12.8
23;2021-04-29;883;379;37129;15252;31.9;13.1
23;2021-04-30;719;784;37848;16036;32.6;13.8
23;2021-05-01;1229;42;39077;16078;33.6;13.8
23;2021-05-02;14;0;39091;16078;33.6;13.8
23;2021-05-03;430;520;39521;16598;34.0;14.3
23;2021-05-04;617;513;40138;17111;34.5;14.7
23;2021-05-05;540;713;40678;17824;35.0;15.3
23;2021-05-06;728;698;41406;18522;35.6;15.9
23;2021-05-07;685;643;42091;19165;36.2;16.5
23;2021-05-08;1411;588;43502;19753;37.4;17.0
23;2021-05-09;4;0;43506;19753;37.4;17.0
23;2021-05-10;555;656;44061;20409;37.9;17.6
23;2021-05-11;560;764;44621;21173;38.4;18.2
23;2021-05-12;720;662;45341;21835;39.0;18.8
23;2021-05-13;538;56;45879;21891;39.5;18.8
23;2021-05-14;787;458;46666;22349;40.1;19.2
23;2021-05-15;995;235;47661;22584;41.0;19.4
23;2021-05-16;0;0;47661;22584;41.0;19.4
23;2021-05-17;566;448;48227;23032;41.5;19.8
23;2021-05-18;777;292;49004;23324;42.1;20.1
23;2021-05-19;1051;259;50055;23583;43.1;20.3
23;2021-05-20;838;314;50893;23897;43.8;20.6
23;2021-05-21;1108;311;52001;24208;44.7;20.8
23;2021-05-22;740;125;52741;24333;45.4;20.9
23;2021-05-23;3;20;52744;24353;45.4;20.9
23;2021-05-24;363;166;53107;24519;45.7;21.1
23;2021-05-25;908;336;54015;24855;46.5;21.4
23;2021-05-26;1077;227;55092;25082;47.4;21.6
23;2021-05-27;931;437;56023;25519;48.2;21.9
23;2021-05-28;781;743;56804;26262;48.9;22.6
23;2021-05-29;638;1099;57442;27361;49.4;23.5
23;2021-05-30;6;63;57448;27424;49.4;23.6
23;2021-05-31;433;539;57881;27963;49.8;24.1
23;2021-06-01;582;827;58463;28790;50.3;24.8
23;2021-06-02;624;515;59087;29305;50.8;25.2
23;2021-06-03;708;551;59795;29856;51.4;25.7
23;2021-06-04;778;614;60573;30470;52.1;26.2
23;2021-06-05;543;777;61116;31247;52.6;26.9
23;2021-06-06;0;0;61116;31247;52.6;26.9
23;2021-06-07;393;696;61509;31943;52.9;27.5
23;2021-06-08;323;776;61832;32719;53.2;28.1
23;2021-06-09;287;648;62119;33367;53.4;28.7
23;2021-06-10;374;690;62493;34057;53.7;29.3
23;2021-06-11;384;807;62877;34864;54.1;30.0
23;2021-06-12;376;1265;63253;36129;54.4;31.1
23;2021-06-13;13;5;63266;36134;54.4;31.1
23;2021-06-14;235;589;63501;36723;54.6;31.6
23;2021-06-15;229;860;63730;37583;54.8;32.3
23;2021-06-16;362;579;64092;38162;55.1;32.8
23;2021-06-17;339;810;64431;38972;55.4;33.5
23;2021-06-18;356;767;64787;39739;55.7;34.2
23;2021-06-19;493;1523;65280;41262;56.1;35.5
23;2021-06-20;2;11;65282;41273;56.1;35.5
23;2021-06-21;205;620;65487;41893;56.3;36.0
23;2021-06-22;216;687;65703;42580;56.5;36.6
23;2021-06-23;221;750;65924;43330;56.7;37.3
23;2021-06-24;200;606;66124;43936;56.9;37.8
23;2021-06-25;302;815;66426;44751;57.1;38.5
23;2021-06-26;221;999;66647;45750;57.3;39.3
23;2021-06-27;3;0;66650;45750;57.3;39.3
23;2021-06-28;115;690;66765;46440;57.4;39.9
23;2021-06-29;189;823;66954;47263;57.6;40.6
23;2021-06-30;169;944;67123;48207;57.7;41.5
23;2021-07-01;168;870;67291;49077;57.9;42.2
23;2021-07-02;192;1069;67483;50146;58.0;43.1
23;2021-07-03;250;979;67733;51125;58.3;44.0
23;2021-07-04;1;0;67734;51125;58.3;44.0
23;2021-07-05;160;804;67894;51929;58.4;44.7
23;2021-07-06;215;1043;68109;52972;58.6;45.6
23;2021-07-07;210;848;68319;53820;58.8;46.3
23;2021-07-08;254;740;68573;54560;59.0;46.9
23;2021-07-09;275;1012;68848;55572;59.2;47.8
23;2021-07-10;234;644;69082;56216;59.4;48.3
23;2021-07-11;0;0;69082;56216;59.4;48.3
23;2021-07-12;232;702;69314;56918;59.6;49.0
23;2021-07-13;471;917;69785;57835;60.0;49.7
23;2021-07-14;212;320;69997;58155;60.2;50.0
23;2021-07-15;483;810;70480;58965;60.6;50.7
23;2021-07-16;764;566;71244;59531;61.3;51.2
23;2021-07-17;220;478;71464;60009;61.5;51.6
23;2021-07-18;0;1;71464;60010;61.5;51.6
23;2021-07-19;704;628;72168;60638;62.1;52.2
23;2021-07-20;633;569;72801;61207;62.6;52.6
23;2021-07-21;702;636;73503;61843;63.2;53.2
23;2021-07-22;945;438;74448;62281;64.0;53.6
23;2021-07-23;841;508;75289;62789;64.8;54.0
23;2021-07-24;1013;439;76302;63228;65.6;54.4
23;2021-07-25;13;16;76315;63244;65.6;54.4
23;2021-07-26;788;563;77103;63807;66.3;54.9
23;2021-07-27;928;436;78031;64243;67.1;55.3
23;2021-07-28;877;411;78908;64654;67.9;55.6
23;2021-07-29;1049;400;79957;65054;68.8;56.0
23;2021-07-30;947;521;80904;65575;69.6;56.4
23;2021-07-31;1165;306;82069;65881;70.6;56.7
23;2021-08-01;19;8;82088;65889;70.6;56.7
23;2021-08-02;674;506;82762;66395;71.2;57.1
23;2021-08-03;767;458;83529;66853;71.8;57.5
23;2021-08-04;612;297;84141;67150;72.4;57.8
23;2021-08-05;692;365;84833;67515;73.0;58.1
23;2021-08-06;421;482;85254;67997;73.3;58.5
23;2021-08-07;299;188;85553;68185;73.6;58.6
23;2021-08-08;146;38;85699;68223;73.7;58.7
23;2021-08-09;492;492;86191;68715;74.1;59.1
23;2021-08-10;467;608;86658;69323;74.5;59.6
23;2021-08-11;428;487;87086;69810;74.9;60.0
23;2021-08-12;514;567;87600;70377;75.3;60.5
23;2021-08-13;420;578;88020;70955;75.7;61.0
23;2021-08-14;287;390;88307;71345;75.9;61.4
23;2021-08-15;27;9;88334;71354;76.0;61.4
23;2021-08-16;276;710;88610;72064;76.2;62.0
23;2021-08-17;278;729;88888;72793;76.4;62.6
23;2021-08-18;180;637;89068;73430;76.6;63.2
23;2021-08-19;257;726;89325;74156;76.8;63.8
23;2021-08-20;215;682;89540;74838;77.0;64.4
23;2021-08-21;140;500;89680;75338;77.1;64.8
23;2021-08-22;54;48;89734;75386;77.2;64.8
23;2021-08-23;149;816;89883;76202;77.3;65.5
23;2021-08-24;265;911;90148;77113;77.5;66.3
23;2021-08-25;187;791;90335;77904;77.7;67.0
23;2021-08-26;220;744;90555;78648;77.9;67.6
23;2021-08-27;213;639;90768;79287;78.1;68.2
23;2021-08-28;221;454;90989;79741;78.3;68.6
23;2021-08-29;15;88;91004;79829;78.3;68.7
23;2021-08-30;187;665;91191;80494;78.4;69.2
23;2021-08-31;228;672;91419;81166;78.6;69.8
23;2021-09-01;160;429;91579;81595;78.8;70.2
23;2021-09-02;118;346;91697;81941;78.9;70.5
23;2021-09-03;209;583;91906;82524;79.0;71.0
23;2021-09-04;178;846;92084;83370;79.2;71.7
23;2021-09-05;5;7;92089;83377;79.2;71.7
23;2021-09-06;132;489;92221;83866;79.3;72.1
23;2021-09-07;98;527;92319;84393;79.4;72.6
23;2021-09-08;121;486;92440;84879;79.5;73.0
23;2021-09-09;115;393;92555;85272;79.6;73.3
23;2021-09-10;150;450;92705;85722;79.7;73.7
23;2021-09-11;102;224;92807;85946;79.8;73.9
23;2021-09-12;5;16;92812;85962;79.8;73.9
23;2021-09-13;111;401;92923;86363;79.9;74.3
23;2021-09-14;111;464;93034;86827;80.0;74.7
23;2021-09-15;94;242;93128;87069;80.1;74.9
23;2021-09-16;127;152;93255;87221;80.2;75.0
23;2021-09-17;140;227;93395;87448;80.3;75.2
23;2021-09-18;44;224;93439;87672;80.4;75.4
23;2021-09-19;0;1;93439;87673;80.4;75.4
23;2021-09-20;59;217;93498;87890;80.4;75.6
23;2021-09-21;85;184;93583;88074;80.5;75.7
23;2021-09-22;71;260;93654;88334;80.5;76.0
23;2021-09-23;58;133;93712;88467;80.6;76.1
23;2021-09-24;64;234;93776;88701;80.7;76.3
23;2021-09-25;27;138;93803;88839;80.7;76.4
23;2021-09-26;0;1;93803;88840;80.7;76.4
23;2021-09-27;34;159;93837;88999;80.7;76.5
23;2021-09-28;34;133;93871;89132;80.7;76.7
23;2021-09-29;64;156;93935;89288;80.8;76.8
23;2021-09-30;43;64;93978;89352;80.8;76.8
23;2021-10-01;81;178;94059;89530;80.9;77.0
23;2021-10-02;22;97;94081;89627;80.9;77.1
23;2021-10-03;1;4;94082;89631;80.9;77.1
24;2020-12-27;1;0;1;0;0.0;0.0
24;2020-12-28;1;0;2;0;0.0;0.0
24;2020-12-29;2;0;4;0;0.0;0.0
24;2020-12-30;1;0;5;0;0.0;0.0
24;2020-12-31;1;0;6;0;0.0;0.0
24;2021-01-01;2;0;8;0;0.0;0.0
24;2021-01-02;1;0;9;0;0.0;0.0
24;2021-01-03;0;0;9;0;0.0;0.0
24;2021-01-04;1;0;10;0;0.0;0.0
24;2021-01-05;1;0;11;0;0.0;0.0
24;2021-01-06;2;0;13;0;0.0;0.0
24;2021-01-07;190;0;203;0;0.0;0.0
24;2021-01-08;282;0;485;0;0.1;0.0
24;2021-01-09;185;13;670;13;0.2;0.0
24;2021-01-10;35;0;705;13;0.2;0.0
24;2021-01-11;269;0;974;13;0.2;0.0
24;2021-01-12;280;0;1254;13;0.3;0.0
24;2021-01-13;233;0;1487;13;0.4;0.0
24;2021-01-14;1023;21;2510;34;0.6;0.0
24;2021-01-15;605;4;3115;38;0.8;0.0
24;2021-01-16;88;0;3203;38;0.8;0.0
24;2021-01-17;2;1;3205;39;0.8;0.0
24;2021-01-18;300;0;3505;39;0.9;0.0
24;2021-01-19;467;1;3972;40;1.0;0.0
24;2021-01-20;557;0;4529;40;1.1;0.0
24;2021-01-21;646;6;5175;46;1.3;0.0
24;2021-01-22;516;1;5691;47;1.4;0.0
24;2021-01-23;154;1;5845;48;1.4;0.0
24;2021-01-24;4;0;5849;48;1.4;0.0
24;2021-01-25;443;0;6292;48;1.5;0.0
24;2021-01-26;638;65;6930;113;1.7;0.0
24;2021-01-27;1267;14;8197;127;2.0;0.0
24;2021-01-28;986;126;9183;253;2.2;0.1
24;2021-01-29;932;128;10115;381;2.5;0.1
24;2021-01-30;282;1;10397;382;2.5;0.1
24;2021-01-31;0;0;10397;382;2.5;0.1
24;2021-02-01;379;164;10776;546;2.6;0.1
24;2021-02-02;616;289;11392;835;2.8;0.2
24;2021-02-03;653;435;12045;1270;2.9;0.3
24;2021-02-04;978;382;13023;1652;3.2;0.4
24;2021-02-05;689;355;13712;2007;3.4;0.5
24;2021-02-06;141;35;13853;2042;3.4;0.5
24;2021-02-07;33;1;13886;2043;3.4;0.5
24;2021-02-08;310;222;14196;2265;3.5;0.6
24;2021-02-09;454;230;14650;2495;3.6;0.6
24;2021-02-10;378;101;15028;2596;3.7;0.6
24;2021-02-11;561;487;15589;3083;3.8;0.8
24;2021-02-12;496;373;16085;3456;3.9;0.8
24;2021-02-13;202;41;16287;3497;4.0;0.9
24;2021-02-14;89;0;16376;3497;4.0;0.9
24;2021-02-15;188;197;16564;3694;4.1;0.9
24;2021-02-16;336;450;16900;4144;4.1;1.0
24;2021-02-17;586;784;17486;4928;4.3;1.2
24;2021-02-18;446;648;17932;5576;4.4;1.4
24;2021-02-19;462;640;18394;6216;4.5;1.5
24;2021-02-20;164;107;18558;6323;4.5;1.5
24;2021-02-21;111;0;18669;6323;4.6;1.5
24;2021-02-22;427;454;19096;6777;4.7;1.7
24;2021-02-23;562;598;19658;7375;4.8;1.8
24;2021-02-24;539;734;20197;8109;4.9;2.0
24;2021-02-25;727;771;20924;8880;5.1;2.2
24;2021-02-26;978;830;21902;9710;5.4;2.4
24;2021-02-27;363;228;22265;9938;5.5;2.4
24;2021-02-28;25;4;22290;9942;5.5;2.4
24;2021-03-01;291;318;22581;10260;5.5;2.5
24;2021-03-02;541;380;23122;10640;5.7;2.6
24;2021-03-03;681;297;23803;10937;5.8;2.7
24;2021-03-04;914;468;24717;11405;6.1;2.8
24;2021-03-05;1067;519;25784;11924;6.3;2.9
24;2021-03-06;1125;126;26909;12050;6.6;3.0
24;2021-03-07;232;63;27141;12113;6.6;3.0
24;2021-03-08;530;217;27671;12330;6.8;3.0
24;2021-03-09;1174;395;28845;12725;7.1;3.1
24;2021-03-10;1142;413;29987;13138;7.3;3.2
24;2021-03-11;1609;443;31596;13581;7.7;3.3
24;2021-03-12;2058;429;33654;14010;8.2;3.4
24;2021-03-13;1348;181;35002;14191;8.6;3.5
24;2021-03-14;141;88;35143;14279;8.6;3.5
24;2021-03-15;953;163;36096;14442;8.8;3.5
24;2021-03-16;1144;228;37240;14670;9.1;3.6
24;2021-03-17;1217;280;38457;14950;9.4;3.7
24;2021-03-18;1054;550;39511;15500;9.7;3.8
24;2021-03-19;1251;526;40762;16026;10.0;3.9
24;2021-03-20;1054;143;41816;16169;10.2;4.0
24;2021-03-21;25;11;41841;16180;10.2;4.0
24;2021-03-22;1224;406;43065;16586;10.5;4.1
24;2021-03-23;1878;388;44943;16974;11.0;4.2
24;2021-03-24;1892;379;46835;17353;11.5;4.2
24;2021-03-25;1991;468;48826;17821;12.0;4.4
24;2021-03-26;2374;278;51200;18099;12.5;4.4
24;2021-03-27;1349;42;52549;18141;12.9;4.4
24;2021-03-28;63;9;52612;18150;12.9;4.4
24;2021-03-29;1673;327;54285;18477;13.3;4.5
24;2021-03-30;2410;390;56695;18867;13.9;4.6
24;2021-03-31;2187;308;58882;19175;14.4;4.7
24;2021-04-01;2195;309;61077;19484;15.0;4.8
24;2021-04-02;2073;391;63150;19875;15.5;4.9
24;2021-04-03;1376;121;64526;19996;15.8;4.9
24;2021-04-04;74;1;64600;19997;15.8;4.9
24;2021-04-05;948;60;65548;20057;16.1;4.9
24;2021-04-06;2355;700;67903;20757;16.6;5.1
24;2021-04-07;2717;691;70620;21448;17.3;5.3
24;2021-04-08;3001;959;73621;22407;18.0;5.5
24;2021-04-09;3488;1004;77109;23411;18.9;5.7
24;2021-04-10;2596;313;79705;23724;19.5;5.8
24;2021-04-11;1103;20;80808;23744;19.8;5.8
24;2021-04-12;2498;808;83306;24552;20.4;6.0
24;2021-04-13;2902;1201;86208;25753;21.1;6.3
24;2021-04-14;2938;1196;89146;26949;21.8;6.6
24;2021-04-15;2790;1104;91936;28053;22.5;6.9
24;2021-04-16;3265;975;95201;29028;23.3;7.1
24;2021-04-17;2272;500;97473;29528;23.9;7.2
24;2021-04-18;424;6;97897;29534;24.0;7.2
24;2021-04-19;1598;1011;99495;30545;24.4;7.5
24;2021-04-20;2268;1432;101763;31977;24.9;7.8
24;2021-04-21;2146;1443;103909;33420;25.4;8.2
24;2021-04-22;2061;1257;105970;34677;25.9;8.5
24;2021-04-23;1960;1336;107930;36013;26.4;8.8
24;2021-04-24;863;724;108793;36737;26.6;9.0
24;2021-04-25;54;4;108847;36741;26.7;9.0
24;2021-04-26;1295;1476;110142;38217;27.0;9.4
24;2021-04-27;1848;1879;111990;40096;27.4;9.8
24;2021-04-28;1506;1942;113496;42038;27.8;10.3
24;2021-04-29;1730;1883;115226;43921;28.2;10.8
24;2021-04-30;2271;1768;117497;45689;28.8;11.2
24;2021-05-01;2059;1062;119556;46751;29.3;11.4
24;2021-05-02;1925;218;121481;46969;29.7;11.5
24;2021-05-03;1475;1830;122956;48799;30.1;11.9
24;2021-05-04;2227;2295;125183;51094;30.7;12.5
24;2021-05-05;1891;2716;127074;53810;31.1;13.2
24;2021-05-06;1890;2795;128964;56605;31.6;13.9
24;2021-05-07;2263;2786;131227;59391;32.1;14.5
24;2021-05-08;1285;1150;132512;60541;32.4;14.8
24;2021-05-09;1169;903;133681;61444;32.7;15.0
24;2021-05-10;1097;2622;134778;64066;33.0;15.7
24;2021-05-11;2037;2783;136815;66849;33.5;16.4
24;2021-05-12;1924;2246;138739;69095;34.0;16.9
24;2021-05-13;1465;1215;140204;70310;34.3;17.2
24;2021-05-14;2378;1333;142582;71643;34.9;17.5
24;2021-05-15;2048;816;144630;72459;35.4;17.7
24;2021-05-16;1171;346;145801;72805;35.7;17.8
24;2021-05-17;2240;1250;148041;74055;36.2;18.1
24;2021-05-18;2485;1817;150526;75872;36.9;18.6
24;2021-05-19;2283;1376;152809;77248;37.4;18.9
24;2021-05-20;2376;1572;155185;78820;38.0;19.3
24;2021-05-21;2434;1415;157619;80235;38.6;19.6
24;2021-05-22;1719;409;159338;80644;39.0;19.7
24;2021-05-23;952;72;160290;80716;39.2;19.8
24;2021-05-24;1517;331;161807;81047;39.6;19.8
24;2021-05-25;2297;1383;164104;82430;40.2;20.2
24;2021-05-26;2148;1319;166252;83749;40.7;20.5
24;2021-05-27;1749;2192;168001;85941;41.1;21.0
24;2021-05-28;2144;2000;170145;87941;41.7;21.5
24;2021-05-29;1153;2082;171298;90023;41.9;22.0
24;2021-05-30;1418;169;172716;90192;42.3;22.1
24;2021-05-31;1740;1363;174456;91555;42.7;22.4
24;2021-06-01;2581;1977;177037;93532;43.3;22.9
24;2021-06-02;2654;1782;179691;95314;44.0;23.3
24;2021-06-03;2289;1458;181980;96772;44.6;23.7
24;2021-06-04;2378;1899;184358;98671;45.1;24.2
24;2021-06-05;2007;1413;186365;100084;45.6;24.5
24;2021-06-06;766;222;187131;100306;45.8;24.6
24;2021-06-07;1432;1497;188563;101803;46.2;24.9
24;2021-06-08;1677;1905;190240;103708;46.6;25.4
24;2021-06-09;1322;1596;191562;105304;46.9;25.8
24;2021-06-10;1578;1909;193140;107213;47.3;26.3
24;2021-06-11;1334;2077;194474;109290;47.6;26.8
24;2021-06-12;1118;2538;195592;111828;47.9;27.4
24;2021-06-13;1238;921;196830;112749;48.2;27.6
24;2021-06-14;1166;1858;197996;114607;48.5;28.1
24;2021-06-15;1488;2991;199484;117598;48.8;28.8
24;2021-06-16;1670;2732;201154;120330;49.3;29.5
24;2021-06-17;1544;2176;202698;122506;49.6;30.0
24;2021-06-18;1400;2859;204098;125365;50.0;30.7
24;2021-06-19;1273;1522;205371;126887;50.3;31.1
24;2021-06-20;514;501;205885;127388;50.4;31.2
24;2021-06-21;931;1833;206816;129221;50.6;31.6
24;2021-06-22;1451;2591;208267;131812;51.0;32.3
24;2021-06-23;1425;2418;209692;134230;51.3;32.9
24;2021-06-24;1137;1916;210829;136146;51.6;33.3
24;2021-06-25;968;2817;211797;138963;51.9;34.0
24;2021-06-26;866;2099;212663;141062;52.1;34.5
24;2021-06-27;402;979;213065;142041;52.2;34.8
24;2021-06-28;818;2482;213883;144523;52.4;35.4
24;2021-06-29;938;2867;214821;147390;52.6;36.1
24;2021-06-30;1111;2455;215932;149845;52.9;36.7
24;2021-07-01;1131;2303;217063;152148;53.2;37.3
24;2021-07-02;1096;2745;218159;154893;53.4;37.9
24;2021-07-03;810;1903;218969;156796;53.6;38.4
24;2021-07-04;411;1013;219380;157809;53.7;38.6
24;2021-07-05;793;2316;220173;160125;53.9;39.2
24;2021-07-06;879;3354;221052;163479;54.1;40.0
24;2021-07-07;1086;3040;222138;166519;54.4;40.8
24;2021-07-08;1339;2118;223477;168637;54.7;41.3
24;2021-07-09;1178;3216;224655;171853;55.0;42.1
24;2021-07-10;481;1963;225136;173816;55.1;42.6
24;2021-07-11;587;1189;225723;175005;55.3;42.9
24;2021-07-12;906;2516;226629;177521;55.5;43.5
24;2021-07-13;1323;3217;227952;180738;55.8;44.3
24;2021-07-14;619;1189;228571;181927;56.0;44.5
24;2021-07-15;1697;2776;230268;184703;56.4;45.2
24;2021-07-16;2149;2598;232417;187301;56.9;45.9
24;2021-07-17;1528;2239;233945;189540;57.3;46.4
24;2021-07-18;709;887;234654;190427;57.5;46.6
24;2021-07-19;1580;2187;236234;192614;57.8;47.2
24;2021-07-20;2017;2435;238251;195049;58.3;47.8
24;2021-07-21;1875;2329;240126;197378;58.8;48.3
24;2021-07-22;2350;2439;242476;199817;59.4;48.9
24;2021-07-23;2303;2623;244779;202440;59.9;49.6
24;2021-07-24;1807;1545;246586;203985;60.4;49.9
24;2021-07-25;816;875;247402;204860;60.6;50.2
24;2021-07-26;1572;2015;248974;206875;61.0;50.7
24;2021-07-27;2848;2289;251822;209164;61.7;51.2
24;2021-07-28;2765;1936;254587;211100;62.3;51.7
24;2021-07-29;3063;2238;257650;213338;63.1;52.2
24;2021-07-30;2466;1919;260116;215257;63.7;52.7
24;2021-07-31;1654;1566;261770;216823;64.1;53.1
24;2021-08-01;1117;658;262887;217481;64.4;53.3
24;2021-08-02;1946;1623;264833;219104;64.8;53.7
24;2021-08-03;2887;1908;267720;221012;65.6;54.1
24;2021-08-04;3077;1631;270797;222643;66.3;54.5
24;2021-08-05;3047;1440;273844;224083;67.1;54.9
24;2021-08-06;2537;1540;276381;225623;67.7;55.2
24;2021-08-07;1792;1121;278173;226744;68.1;55.5
24;2021-08-08;1108;687;279281;227431;68.4;55.7
24;2021-08-09;1740;1383;281021;228814;68.8;56.0
24;2021-08-10;2267;1785;283288;230599;69.4;56.5
24;2021-08-11;2279;1698;285567;232297;69.9;56.9
24;2021-08-12;1916;1956;287483;234253;70.4;57.4
24;2021-08-13;1530;1625;289013;235878;70.8;57.8
24;2021-08-14;1171;1242;290184;237120;71.1;58.1
24;2021-08-15;741;583;290925;237703;71.2;58.2
24;2021-08-16;1123;1705;292048;239408;71.5;58.6
24;2021-08-17;1632;2108;293680;241516;71.9;59.1
24;2021-08-18;1562;1925;295242;243441;72.3;59.6
24;2021-08-19;1125;2636;296367;246077;72.6;60.3
24;2021-08-20;1107;2429;297474;248506;72.8;60.8
24;2021-08-21;874;1634;298348;250140;73.1;61.2
24;2021-08-22;351;1102;298699;251242;73.1;61.5
24;2021-08-23;671;2036;299370;253278;73.3;62.0
24;2021-08-24;818;2395;300188;255673;73.5;62.6
24;2021-08-25;814;2323;301002;257996;73.7;63.2
24;2021-08-26;746;2839;301748;260835;73.9;63.9
24;2021-08-27;801;2764;302549;263599;74.1;64.5
24;2021-08-28;523;1910;303072;265509;74.2;65.0
24;2021-08-29;171;1029;303243;266538;74.3;65.3
24;2021-08-30;376;1965;303619;268503;74.3;65.7
24;2021-08-31;591;2489;304210;270992;74.5;66.4
24;2021-09-01;625;2480;304835;273472;74.6;67.0
24;2021-09-02;465;1900;305300;275372;74.8;67.4
24;2021-09-03;550;2236;305850;277608;74.9;68.0
24;2021-09-04;365;1995;306215;279603;75.0;68.5
24;2021-09-05;245;974;306460;280577;75.0;68.7
24;2021-09-06;344;1622;306804;282199;75.1;69.1
24;2021-09-07;477;1892;307281;284091;75.2;69.6
24;2021-09-08;401;1927;307682;286018;75.3;70.0
24;2021-09-09;335;1345;308017;287363;75.4;70.4
24;2021-09-10;386;1785;308403;289148;75.5;70.8
24;2021-09-11;317;1686;308720;290834;75.6;71.2
24;2021-09-12;92;432;308812;291266;75.6;71.3
24;2021-09-13;292;1232;309104;292498;75.7;71.6
24;2021-09-14;429;1134;309533;293632;75.8;71.9
24;2021-09-15;412;1267;309945;294899;75.9;72.2
24;2021-09-16;247;890;310192;295789;76.0;72.4
24;2021-09-17;409;1037;310601;296826;76.1;72.7
24;2021-09-18;311;1111;310912;297937;76.1;73.0
24;2021-09-19;45;347;310957;298284;76.1;73.0
24;2021-09-20;154;577;311111;298861;76.2;73.2
24;2021-09-21;379;407;311490;299268;76.3;73.3
24;2021-09-22;226;697;311716;299965;76.3;73.5
24;2021-09-23;135;389;311851;300354;76.4;73.5
24;2021-09-24;248;812;312099;301166;76.4;73.7
24;2021-09-25;215;592;312314;301758;76.5;73.9
24;2021-09-26;32;106;312346;301864;76.5;73.9
24;2021-09-27;179;493;312525;302357;76.5;74.0
24;2021-09-28;208;327;312733;302684;76.6;74.1
24;2021-09-29;227;586;312960;303270;76.6;74.3
24;2021-09-30;250;439;313210;303709;76.7;74.4
24;2021-10-01;219;484;313429;304193;76.7;74.5
24;2021-10-02;193;481;313622;304674;76.8;74.6
24;2021-10-03;16;39;313638;304713;76.8;74.6
25;2020-12-27;0;0;0;0;0.0;0.0
25;2020-12-28;1;0;1;0;0.0;0.0
25;2020-12-29;0;0;1;0;0.0;0.0
25;2020-12-30;0;0;1;0;0.0;0.0
25;2020-12-31;3;0;4;0;0.0;0.0
25;2021-01-01;0;0;4;0;0.0;0.0
25;2021-01-02;1;0;5;0;0.0;0.0
25;2021-01-03;0;0;5;0;0.0;0.0
25;2021-01-04;1;0;6;0;0.0;0.0
25;2021-01-05;1;0;7;0;0.0;0.0
25;2021-01-06;75;1;82;1;0.0;0.0
25;2021-01-07;235;1;317;2;0.1;0.0
25;2021-01-08;345;1;662;3;0.1;0.0
25;2021-01-09;102;0;764;3;0.1;0.0
25;2021-01-10;0;0;764;3;0.1;0.0
25;2021-01-11;503;5;1267;8;0.2;0.0
25;2021-01-12;682;2;1949;10;0.4;0.0
25;2021-01-13;627;2;2576;12;0.5;0.0
25;2021-01-14;896;12;3472;24;0.6;0.0
25;2021-01-15;786;9;4258;33;0.8;0.0
25;2021-01-16;206;0;4464;33;0.8;0.0
25;2021-01-17;112;0;4576;33;0.8;0.0
25;2021-01-18;1297;6;5873;39;1.1;0.0
25;2021-01-19;1414;5;7287;44;1.4;0.0
25;2021-01-20;1421;4;8708;48;1.6;0.0
25;2021-01-21;1843;3;10551;51;2.0;0.0
25;2021-01-22;1509;5;12060;56;2.2;0.0
25;2021-01-23;499;0;12559;56;2.3;0.0
25;2021-01-24;119;0;12678;56;2.4;0.0
25;2021-01-25;990;0;13668;56;2.5;0.0
25;2021-01-26;1490;41;15158;97;2.8;0.0
25;2021-01-27;1248;67;16406;164;3.0;0.0
25;2021-01-28;1089;74;17495;238;3.2;0.0
25;2021-01-29;906;200;18401;438;3.4;0.1
25;2021-01-30;293;82;18694;520;3.5;0.1
25;2021-01-31;2;0;18696;520;3.5;0.1
25;2021-02-01;612;201;19308;721;3.6;0.1
25;2021-02-02;674;363;19982;1084;3.7;0.2
25;2021-02-03;758;214;20740;1298;3.8;0.2
25;2021-02-04;715;365;21455;1663;4.0;0.3
25;2021-02-05;520;425;21975;2088;4.1;0.4
25;2021-02-06;197;138;22172;2226;4.1;0.4
25;2021-02-07;2;34;22174;2260;4.1;0.4
25;2021-02-08;612;454;22786;2714;4.2;0.5
25;2021-02-09;615;422;23401;3136;4.3;0.6
25;2021-02-10;818;427;24219;3563;4.5;0.7
25;2021-02-11;589;734;24808;4297;4.6;0.8
25;2021-02-12;413;466;25221;4763;4.7;0.9
25;2021-02-13;97;113;25318;4876;4.7;0.9
25;2021-02-14;0;0;25318;4876;4.7;0.9
25;2021-02-15;186;811;25504;5687;4.7;1.1
25;2021-02-16;211;1178;25715;6865;4.8;1.3
25;2021-02-17;107;1027;25822;7892;4.8;1.5
25;2021-02-18;147;1139;25969;9031;4.8;1.7
25;2021-02-19;102;999;26071;10030;4.8;1.9
25;2021-02-20;27;364;26098;10394;4.8;1.9
25;2021-02-21;1;102;26099;10496;4.8;1.9
25;2021-02-22;83;875;26182;11371;4.9;2.1
25;2021-02-23;195;862;26377;12233;4.9;2.3
25;2021-02-24;104;804;26481;13037;4.9;2.4
25;2021-02-25;522;798;27003;13835;5.0;2.6
25;2021-02-26;607;817;27610;14652;5.1;2.7
25;2021-02-27;228;313;27838;14965;5.2;2.8
25;2021-02-28;6;1;27844;14966;5.2;2.8
25;2021-03-01;442;532;28286;15498;5.2;2.9
25;2021-03-02;654;709;28940;16207;5.4;3.0
25;2021-03-03;544;657;29484;16864;5.5;3.1
25;2021-03-04;1158;601;30642;17465;5.7;3.2
25;2021-03-05;1854;349;32496;17814;6.0;3.3
25;2021-03-06;1170;208;33666;18022;6.2;3.3
25;2021-03-07;9;7;33675;18029;6.2;3.3
25;2021-03-08;548;632;34223;18661;6.3;3.5
25;2021-03-09;1040;712;35263;19373;6.5;3.6
25;2021-03-10;1150;595;36413;19968;6.8;3.7
25;2021-03-11;1657;547;38070;20515;7.1;3.8
25;2021-03-12;1996;442;40066;20957;7.4;3.9
25;2021-03-13;1121;97;41187;21054;7.6;3.9
25;2021-03-14;35;0;41222;21054;7.6;3.9
25;2021-03-15;1125;138;42347;21192;7.9;3.9
25;2021-03-16;1288;123;43635;21315;8.1;4.0
25;2021-03-17;1414;137;45049;21452;8.4;4.0
25;2021-03-18;1526;85;46575;21537;8.6;4.0
25;2021-03-19;1595;127;48170;21664;8.9;4.0
25;2021-03-20;822;38;48992;21702;9.1;4.0
25;2021-03-21;24;0;49016;21702;9.1;4.0
25;2021-03-22;1485;85;50501;21787;9.4;4.0
25;2021-03-23;2162;158;52663;21945;9.8;4.1
25;2021-03-24;2418;97;55081;22042;10.2;4.1
25;2021-03-25;2837;195;57918;22237;10.7;4.1
25;2021-03-26;3160;182;61078;22419;11.3;4.2
25;2021-03-27;1112;89;62190;22508;11.5;4.2
25;2021-03-28;121;65;62311;22573;11.6;4.2
25;2021-03-29;1791;276;64102;22849;11.9;4.2
25;2021-03-30;2214;397;66316;23246;12.3;4.3
25;2021-03-31;2220;359;68536;23605;12.7;4.4
25;2021-04-01;2451;524;70987;24129;13.2;4.5
25;2021-04-02;2026;602;73013;24731;13.5;4.6
25;2021-04-03;447;110;73460;24841;13.6;4.6
25;2021-04-04;39;19;73499;24860;13.6;4.6
25;2021-04-05;145;4;73644;24864;13.7;4.6
25;2021-04-06;1937;685;75581;25549;14.0;4.7
25;2021-04-07;1878;850;77459;26399;14.4;4.9
25;2021-04-08;2435;822;79894;27221;14.8;5.0
25;2021-04-09;2597;998;82491;28219;15.3;5.2
25;2021-04-10;978;288;83469;28507;15.5;5.3
25;2021-04-11;105;28;83574;28535;15.5;5.3
25;2021-04-12;1556;966;85130;29501;15.8;5.5
25;2021-04-13;1988;1320;87118;30821;16.1;5.7
25;2021-04-14;1750;1215;88868;32036;16.5;5.9
25;2021-04-15;1997;1326;90865;33362;16.8;6.2
25;2021-04-16;2085;1007;92950;34369;17.2;6.4
25;2021-04-17;1104;415;94054;34784;17.4;6.4
25;2021-04-18;118;18;94172;34802;17.5;6.5
25;2021-04-19;1327;1243;95499;36045;17.7;6.7
25;2021-04-20;1615;1461;97114;37506;18.0;7.0
25;2021-04-21;1717;1631;98831;39137;18.3;7.3
25;2021-04-22;1855;1709;100686;40846;18.7;7.6
25;2021-04-23;1903;1769;102589;42615;19.0;7.9
25;2021-04-24;1278;703;103867;43318;19.3;8.0
25;2021-04-25;140;114;104007;43432;19.3;8.1
25;2021-04-26;1721;1686;105728;45118;19.6;8.4
25;2021-04-27;2804;1521;108532;46639;20.1;8.6
25;2021-04-28;2425;1554;110957;48193;20.6;8.9
25;2021-04-29;2648;1822;113605;50015;21.1;9.3
25;2021-04-30;3107;1559;116712;51574;21.6;9.6
25;2021-05-01;1789;334;118501;51908;22.0;9.6
25;2021-05-02;442;22;118943;51930;22.0;9.6
25;2021-05-03;2901;847;121844;52777;22.6;9.8
25;2021-05-04;2639;1881;124483;54658;23.1;10.1
25;2021-05-05;2597;1666;127080;56324;23.6;10.4
25;2021-05-06;2927;2164;130007;58488;24.1;10.8
25;2021-05-07;3063;2115;133070;60603;24.7;11.2
25;2021-05-08;1334;229;134404;60832;24.9;11.3
25;2021-05-09;244;87;134648;60919;25.0;11.3
25;2021-05-10;3129;1635;137777;62554;25.5;11.6
25;2021-05-11;3747;2038;141524;64592;26.2;12.0
25;2021-05-12;3688;1789;145212;66381;26.9;12.3
25;2021-05-13;3523;598;148735;66979;27.6;12.4
25;2021-05-14;4482;1305;153217;68284;28.4;12.7
25;2021-05-15;3282;710;156499;68994;29.0;12.8
25;2021-05-16;723;93;157222;69087;29.1;12.8
25;2021-05-17;4089;1098;161311;70185;29.9;13.0
25;2021-05-18;5205;1194;166516;71379;30.9;13.2
25;2021-05-19;5247;1134;171763;72513;31.8;13.4
25;2021-05-20;5134;1451;176897;73964;32.8;13.7
25;2021-05-21;5762;1981;182659;75945;33.9;14.1
25;2021-05-22;3174;722;185833;76667;34.4;14.2
25;2021-05-23;781;157;186614;76824;34.6;14.2
25;2021-05-24;1529;152;188143;76976;34.9;14.3
25;2021-05-25;3513;1651;191656;78627;35.5;14.6
25;2021-05-26;3974;1560;195630;80187;36.3;14.9
25;2021-05-27;4519;1895;200149;82082;37.1;15.2
25;2021-05-28;3994;2651;204143;84733;37.8;15.7
25;2021-05-29;2016;1021;206159;85754;38.2;15.9
25;2021-05-30;174;96;206333;85850;38.2;15.9
25;2021-05-31;2672;1705;209005;87555;38.7;16.2
25;2021-06-01;2729;2155;211734;89710;39.3;16.6
25;2021-06-02;2608;2247;214342;91957;39.7;17.0
25;2021-06-03;3274;2045;217616;94002;40.3;17.4
25;2021-06-04;3209;2408;220825;96410;40.9;17.9
25;2021-06-05;1491;1401;222316;97811;41.2;18.1
25;2021-06-06;987;259;223303;98070;41.4;18.2
25;2021-06-07;2782;2575;226085;100645;41.9;18.7
25;2021-06-08;2603;2761;228688;103406;42.4;19.2
25;2021-06-09;2382;2763;231070;106169;42.8;19.7
25;2021-06-10;2325;2653;233395;108822;43.3;20.2
25;2021-06-11;2709;3302;236104;112124;43.8;20.8
25;2021-06-12;1571;1855;237675;113979;44.1;21.1
25;2021-06-13;497;257;238172;114236;44.2;21.2
25;2021-06-14;1421;3753;239593;117989;44.4;21.9
25;2021-06-15;1643;3566;241236;121555;44.7;22.5
25;2021-06-16;1954;3273;243190;124828;45.1;23.1
25;2021-06-17;1474;3321;244664;128149;45.4;23.8
25;2021-06-18;2286;4297;246950;132446;45.8;24.6
25;2021-06-19;1349;1978;248299;134424;46.0;24.9
25;2021-06-20;59;239;248358;134663;46.0;25.0
25;2021-06-21;1139;4139;249497;138802;46.3;25.7
25;2021-06-22;1151;4672;250648;143474;46.5;26.6
25;2021-06-23;1404;4072;252052;147546;46.7;27.4
25;2021-06-24;1191;4085;253243;151631;46.9;28.1
25;2021-06-25;1640;5603;254883;157234;47.2;29.1
25;2021-06-26;626;3384;255509;160618;47.4;29.8
25;2021-06-27;451;877;255960;161495;47.4;29.9
25;2021-06-28;907;4476;256867;165971;47.6;30.8
25;2021-06-29;1130;5469;257997;171440;47.8;31.8
25;2021-06-30;1311;5371;259308;176811;48.1;32.8
25;2021-07-01;1706;5230;261014;182041;48.4;33.7
25;2021-07-02;1748;5061;262762;187102;48.7;34.7
25;2021-07-03;1042;2692;263804;189794;48.9;35.2
25;2021-07-04;409;722;264213;190516;49.0;35.3
25;2021-07-05;1299;2579;265512;193095;49.2;35.8
25;2021-07-06;1568;4746;267080;197841;49.5;36.7
25;2021-07-07;1597;4501;268677;202342;49.8;37.5
25;2021-07-08;1554;3932;270231;206274;50.1;38.2
25;2021-07-09;1796;4589;272027;210863;50.4;39.1
25;2021-07-10;781;2371;272808;213234;50.6;39.5
25;2021-07-11;127;307;272935;213541;50.6;39.6
25;2021-07-12;1404;3859;274339;217400;50.9;40.3
25;2021-07-13;2470;4769;276809;222169;51.3;41.2
25;2021-07-14;379;561;277188;222730;51.4;41.3
25;2021-07-15;2402;3656;279590;226386;51.8;42.0
25;2021-07-16;3485;3831;283075;230217;52.5;42.7
25;2021-07-17;2207;2040;285282;232257;52.9;43.1
25;2021-07-18;808;1300;286090;233557;53.0;43.3
25;2021-07-19;2543;4207;288633;237764;53.5;44.1
25;2021-07-20;3384;3714;292017;241478;54.1;44.8
25;2021-07-21;3300;3367;295317;244845;54.7;45.4
25;2021-07-22;3351;2983;298668;247828;55.4;45.9
25;2021-07-23;3566;3357;302234;251185;56.0;46.6
25;2021-07-24;1413;2270;303647;253455;56.3;47.0
25;2021-07-25;679;710;304326;254165;56.4;47.1
25;2021-07-26;3056;3009;307382;257174;57.0;47.7
25;2021-07-27;3835;2124;311217;259298;57.7;48.1
25;2021-07-28;3692;2120;314909;261418;58.4;48.5
25;2021-07-29;4320;2093;319229;263511;59.2;48.8
25;2021-07-30;4291;2489;323520;266000;60.0;49.3
25;2021-07-31;1821;1469;325341;267469;60.3;49.6
25;2021-08-01;1352;201;326693;267670;60.6;49.6
25;2021-08-02;2743;2211;329436;269881;61.1;50.0
25;2021-08-03;2839;2203;332275;272084;61.6;50.4
25;2021-08-04;2941;1429;335216;273513;62.1;50.7
25;2021-08-05;2205;1732;337421;275245;62.5;51.0
25;2021-08-06;2289;2349;339710;277594;63.0;51.5
25;2021-08-07;1294;1206;341004;278800;63.2;51.7
25;2021-08-08;325;477;341329;279277;63.3;51.8
25;2021-08-09;2024;2229;343353;281506;63.6;52.2
25;2021-08-10;1975;2524;345328;284030;64.0;52.7
25;2021-08-11;1832;2033;347160;286063;64.4;53.0
25;2021-08-12;2148;2503;349308;288566;64.8;53.5
25;2021-08-13;1712;2023;351020;290589;65.1;53.9
25;2021-08-14;969;1791;351989;292380;65.2;54.2
25;2021-08-15;9;45;351998;292425;65.3;54.2
25;2021-08-16;1262;3261;353260;295686;65.5;54.8
25;2021-08-17;1458;3285;354718;298971;65.8;55.4
25;2021-08-18;1235;2804;355953;301775;66.0;55.9
25;2021-08-19;987;2867;356940;304642;66.2;56.5
25;2021-08-20;1432;3691;358372;308333;66.4;57.2
25;2021-08-21;568;1782;358940;310115;66.5;57.5
25;2021-08-22;212;1273;359152;311388;66.6;57.7
25;2021-08-23;1113;3335;360265;314723;66.8;58.3
25;2021-08-24;1069;3234;361334;317957;67.0;58.9
25;2021-08-25;1015;3061;362349;321018;67.2;59.5
25;2021-08-26;1143;3006;363492;324024;67.4;60.1
25;2021-08-27;1202;3063;364694;327087;67.6;60.6
25;2021-08-28;588;1791;365282;328878;67.7;61.0
25;2021-08-29;160;513;365442;329391;67.7;61.1
25;2021-08-30;939;2824;366381;332215;67.9;61.6
25;2021-08-31;969;2420;367350;334635;68.1;62.0
25;2021-09-01;842;2574;368192;337209;68.3;62.5
25;2021-09-02;775;1953;368967;339162;68.4;62.9
25;2021-09-03;798;2216;369765;341378;68.5;63.3
25;2021-09-04;691;1556;370456;342934;68.7;63.6
25;2021-09-05;128;234;370584;343168;68.7;63.6
25;2021-09-06;631;1845;371215;345013;68.8;64.0
25;2021-09-07;490;1418;371705;346431;68.9;64.2
25;2021-09-08;623;2000;372328;348431;69.0;64.6
25;2021-09-09;425;1366;372753;349797;69.1;64.8
25;2021-09-10;848;2070;373601;351867;69.3;65.2
25;2021-09-11;375;1144;373976;353011;69.3;65.4
25;2021-09-12;110;231;374086;353242;69.3;65.5
25;2021-09-13;723;1340;374809;354582;69.5;65.7
25;2021-09-14;617;1324;375426;355906;69.6;66.0
25;2021-09-15;756;1478;376182;357384;69.7;66.2
25;2021-09-16;499;829;376681;358213;69.8;66.4
25;2021-09-17;740;1338;377421;359551;70.0;66.7
25;2021-09-18;319;870;377740;360421;70.0;66.8
25;2021-09-19;78;163;377818;360584;70.0;66.8
25;2021-09-20;453;741;378271;361325;70.1;67.0
25;2021-09-21;202;590;378473;361915;70.2;67.1
25;2021-09-22;450;1190;378923;363105;70.2;67.3
25;2021-09-23;252;456;379175;363561;70.3;67.4
25;2021-09-24;490;1052;379665;364613;70.4;67.6
25;2021-09-25;281;895;379946;365508;70.4;67.8
25;2021-09-26;8;5;379954;365513;70.4;67.8
25;2021-09-27;293;586;380247;366099;70.5;67.9
25;2021-09-28;209;441;380456;366540;70.5;67.9
25;2021-09-29;458;820;380914;367360;70.6;68.1
25;2021-09-30;224;362;381138;367722;70.7;68.2
25;2021-10-01;421;885;381559;368607;70.7;68.3
25;2021-10-02;275;578;381834;369185;70.8;68.4
25;2021-10-03;9;6;381843;369191;70.8;68.4
26;2020-12-27;0;0;0;0;0.0;0.0
26;2020-12-28;0;0;0;0;0.0;0.0
26;2020-12-29;0;0;0;0;0.0;0.0
26;2020-12-30;0;0;0;0;0.0;0.0
26;2020-12-31;0;0;0;0;0.0;0.0
26;2021-01-01;1;0;1;0;0.0;0.0
26;2021-01-02;0;0;1;0;0.0;0.0
26;2021-01-03;0;0;1;0;0.0;0.0
26;2021-01-04;0;0;1;0;0.0;0.0
26;2021-01-05;0;0;1;0;0.0;0.0
26;2021-01-06;0;0;1;0;0.0;0.0
26;2021-01-07;168;0;169;0;0.0;0.0
26;2021-01-08;125;0;294;0;0.1;0.0
26;2021-01-09;2;0;296;0;0.1;0.0
26;2021-01-10;0;0;296;0;0.1;0.0
26;2021-01-11;266;2;562;2;0.1;0.0
26;2021-01-12;176;1;738;3;0.1;0.0
26;2021-01-13;418;1;1156;4;0.2;0.0
26;2021-01-14;489;0;1645;4;0.3;0.0
26;2021-01-15;563;1;2208;5;0.4;0.0
26;2021-01-16;250;1;2458;6;0.5;0.0
26;2021-01-17;0;0;2458;6;0.5;0.0
26;2021-01-18;637;1;3095;7;0.6;0.0
26;2021-01-19;786;2;3881;9;0.7;0.0
26;2021-01-20;742;0;4623;9;0.9;0.0
26;2021-01-21;807;2;5430;11;1.0;0.0
26;2021-01-22;787;4;6217;15;1.2;0.0
26;2021-01-23;563;3;6780;18;1.3;0.0
26;2021-01-24;24;0;6804;18;1.3;0.0
26;2021-01-25;696;2;7500;20;1.4;0.0
26;2021-01-26;801;4;8301;24;1.6;0.0
26;2021-01-27;823;6;9124;30;1.8;0.0
26;2021-01-28;1330;104;10454;134;2.0;0.0
26;2021-01-29;971;63;11425;197;2.2;0.0
26;2021-01-30;606;5;12031;202;2.3;0.0
26;2021-01-31;24;0;12055;202;2.3;0.0
26;2021-02-01;709;175;12764;377;2.5;0.1
26;2021-02-02;1276;199;14040;576;2.7;0.1
26;2021-02-03;1265;245;15305;821;2.9;0.2
26;2021-02-04;985;402;16290;1223;3.1;0.2
26;2021-02-05;674;291;16964;1514;3.3;0.3
26;2021-02-06;407;170;17371;1684;3.3;0.3
26;2021-02-07;57;2;17428;1686;3.3;0.3
26;2021-02-08;545;351;17973;2037;3.5;0.4
26;2021-02-09;617;405;18590;2442;3.6;0.5
26;2021-02-10;665;288;19255;2730;3.7;0.5
26;2021-02-11;753;252;20008;2982;3.8;0.6
26;2021-02-12;591;387;20599;3369;4.0;0.6
26;2021-02-13;388;237;20987;3606;4.0;0.7
26;2021-02-14;36;0;21023;3606;4.0;0.7
26;2021-02-15;414;397;21437;4003;4.1;0.8
26;2021-02-16;294;437;21731;4440;4.2;0.9
26;2021-02-17;194;579;21925;5019;4.2;1.0
26;2021-02-18;337;754;22262;5773;4.3;1.1
26;2021-02-19;341;690;22603;6463;4.3;1.2
26;2021-02-20;95;371;22698;6834;4.4;1.3
26;2021-02-21;3;17;22701;6851;4.4;1.3
26;2021-02-22;144;530;22845;7381;4.4;1.4
26;2021-02-23;398;879;23243;8260;4.5;1.6
26;2021-02-24;346;1082;23589;9342;4.5;1.8
26;2021-02-25;746;912;24335;10254;4.7;2.0
26;2021-02-26;925;529;25260;10783;4.9;2.1
26;2021-02-27;278;416;25538;11199;4.9;2.2
26;2021-02-28;3;28;25541;11227;4.9;2.2
26;2021-03-01;458;566;25999;11793;5.0;2.3
26;2021-03-02;742;534;26741;12327;5.1;2.4
26;2021-03-03;731;603;27472;12930;5.3;2.5
26;2021-03-04;1045;504;28517;13434;5.5;2.6
26;2021-03-05;1710;473;30227;13907;5.8;2.7
26;2021-03-06;2772;427;32999;14334;6.3;2.8
26;2021-03-07;2989;218;35988;14552;6.9;2.8
26;2021-03-08;908;582;36896;15134;7.1;2.9
26;2021-03-09;1325;501;38221;15635;7.3;3.0
26;2021-03-10;1218;470;39439;16105;7.6;3.1
26;2021-03-11;1609;613;41048;16718;7.9;3.2
26;2021-03-12;2215;458;43263;17176;8.3;3.3
26;2021-03-13;1886;317;45149;17493;8.7;3.4
26;2021-03-14;69;39;45218;17532;8.7;3.4
26;2021-03-15;1653;245;46871;17777;9.0;3.4
26;2021-03-16;1232;510;48103;18287;9.2;3.5
26;2021-03-17;1369;295;49472;18582;9.5;3.6
26;2021-03-18;1587;277;51059;18859;9.8;3.6
26;2021-03-19;2444;342;53503;19201;10.3;3.7
26;2021-03-20;1290;152;54793;19353;10.5;3.7
26;2021-03-21;61;20;54854;19373;10.5;3.7
26;2021-03-22;1847;196;56701;19569;10.9;3.8
26;2021-03-23;2474;277;59175;19846;11.4;3.8
26;2021-03-24;2551;245;61726;20091;11.9;3.9
26;2021-03-25;3044;339;64770;20430;12.4;3.9
26;2021-03-26;3050;355;67820;20785;13.0;4.0
26;2021-03-27;1244;162;69064;20947;13.3;4.0
26;2021-03-28;94;7;69158;20954;13.3;4.0
26;2021-03-29;1908;406;71066;21360;13.7;4.1
26;2021-03-30;2383;548;73449;21908;14.1;4.2
26;2021-03-31;2229;582;75678;22490;14.5;4.3
26;2021-04-01;2279;779;77957;23269;15.0;4.5
26;2021-04-02;2213;987;80170;24256;15.4;4.7
26;2021-04-03;551;1199;80721;25455;15.5;4.9
26;2021-04-04;215;883;80936;26338;15.5;5.1
26;2021-04-05;557;52;81493;26390;15.7;5.1
26;2021-04-06;1486;832;82979;27222;15.9;5.2
26;2021-04-07;1793;894;84772;28116;16.3;5.4
26;2021-04-08;3008;937;87780;29053;16.9;5.6
26;2021-04-09;3415;1009;91195;30062;17.5;5.8
26;2021-04-10;1356;924;92551;30986;17.8;6.0
26;2021-04-11;88;35;92639;31021;17.8;6.0
26;2021-04-12;1713;1125;94352;32146;18.1;6.2
26;2021-04-13;2797;1450;97149;33596;18.7;6.5
26;2021-04-14;2206;1484;99355;35080;19.1;6.7
26;2021-04-15;2282;1589;101637;36669;19.5;7.0
26;2021-04-16;2272;1589;103909;38258;20.0;7.3
26;2021-04-17;1095;840;105004;39098;20.2;7.5
26;2021-04-18;36;52;105040;39150;20.2;7.5
26;2021-04-19;1547;1570;106587;40720;20.5;7.8
26;2021-04-20;1797;1724;108384;42444;20.8;8.2
26;2021-04-21;2012;1509;110396;43953;21.2;8.4
26;2021-04-22;2289;1599;112685;45552;21.6;8.8
26;2021-04-23;2011;1637;114696;47189;22.0;9.1
26;2021-04-24;1655;844;116351;48033;22.4;9.2
26;2021-04-25;629;97;116980;48130;22.5;9.2
26;2021-04-26;1377;1595;118357;49725;22.7;9.6
26;2021-04-27;1986;1684;120343;51409;23.1;9.9
26;2021-04-28;1865;1540;122208;52949;23.5;10.2
26;2021-04-29;2866;1892;125074;54841;24.0;10.5
26;2021-04-30;2626;1762;127700;56603;24.5;10.9
26;2021-05-01;1538;380;129238;56983;24.8;10.9
26;2021-05-02;1084;118;130322;57101;25.0;11.0
26;2021-05-03;2200;1786;132522;58887;25.5;11.3
26;2021-05-04;2614;2363;135136;61250;26.0;11.8
26;2021-05-05;2772;2196;137908;63446;26.5;12.2
26;2021-05-06;3321;2225;141229;65671;27.1;12.6
26;2021-05-07;2860;2257;144089;67928;27.7;13.0
26;2021-05-08;1960;619;146049;68547;28.1;13.2
26;2021-05-09;713;123;146762;68670;28.2;13.2
26;2021-05-10;3022;1827;149784;70497;28.8;13.5
26;2021-05-11;4445;2182;154229;72679;29.6;14.0
26;2021-05-12;4828;1694;159057;74373;30.6;14.3
26;2021-05-13;4363;617;163420;74990;31.4;14.4
26;2021-05-14;4640;1549;168060;76539;32.3;14.7
26;2021-05-15;4468;625;172528;77164;33.1;14.8
26;2021-05-16;3629;344;176157;77508;33.8;14.9
26;2021-05-17;3657;1486;179814;78994;34.5;15.2
26;2021-05-18;4474;1741;184288;80735;35.4;15.5
26;2021-05-19;4486;1450;188774;82185;36.3;15.8
26;2021-05-20;4685;1767;193459;83952;37.2;16.1
26;2021-05-21;4729;1798;198188;85750;38.1;16.5
26;2021-05-22;3189;690;201377;86440;38.7;16.6
26;2021-05-23;1597;183;202974;86623;39.0;16.6
26;2021-05-24;3788;742;206762;87365;39.7;16.8
26;2021-05-25;3591;2345;210353;89710;40.4;17.2
26;2021-05-26;4177;2271;214530;91981;41.2;17.7
26;2021-05-27;4211;2459;218741;94440;42.0;18.1
26;2021-05-28;3776;2766;222517;97206;42.7;18.7
26;2021-05-29;3088;1654;225605;98860;43.3;19.0
26;2021-05-30;320;70;225925;98930;43.4;19.0
26;2021-05-31;3082;1854;229007;100784;44.0;19.4
26;2021-06-01;3110;2308;232117;103092;44.6;19.8
26;2021-06-02;2868;2219;234985;105311;45.1;20.2
26;2021-06-03;2850;2487;237835;107798;45.7;20.7
26;2021-06-04;2658;2908;240493;110706;46.2;21.3
26;2021-06-05;1806;1694;242299;112400;46.5;21.6
26;2021-06-06;9;0;242308;112400;46.5;21.6
26;2021-06-07;2346;2430;244654;114830;47.0;22.1
26;2021-06-08;2453;2293;247107;117123;47.5;22.5
26;2021-06-09;2096;2387;249203;119510;47.9;23.0
26;2021-06-10;1981;2763;251184;122273;48.3;23.5
26;2021-06-11;1896;3273;253080;125546;48.6;24.1
26;2021-06-12;1219;1790;254299;127336;48.9;24.5
26;2021-06-13;97;214;254396;127550;48.9;24.5
26;2021-06-14;1415;3498;255811;131048;49.1;25.2
26;2021-06-15;1586;3963;257397;135011;49.4;25.9
26;2021-06-16;1784;3472;259181;138483;49.8;26.6
26;2021-06-17;1509;3166;260690;141649;50.1;27.2
26;2021-06-18;1797;4368;262487;146017;50.4;28.0
26;2021-06-19;933;3177;263420;149194;50.6;28.7
26;2021-06-20;263;876;263683;150070;50.7;28.8
26;2021-06-21;1005;4557;264688;154627;50.8;29.7
26;2021-06-22;1061;5120;265749;159747;51.1;30.7
26;2021-06-23;1168;5072;266917;164819;51.3;31.7
26;2021-06-24;1258;4544;268175;169363;51.5;32.5
26;2021-06-25;1014;5541;269189;174904;51.7;33.6
26;2021-06-26;662;3823;269851;178727;51.8;34.3
26;2021-06-27;299;1273;270150;180000;51.9;34.6
26;2021-06-28;778;4757;270928;184757;52.0;35.5
26;2021-06-29;1097;4955;272025;189712;52.3;36.4
26;2021-06-30;1411;4890;273436;194602;52.5;37.4
26;2021-07-01;1651;4388;275087;198990;52.8;38.2
26;2021-07-02;1333;5163;276420;204153;53.1;39.2
26;2021-07-03;769;3321;277189;207474;53.2;39.9
26;2021-07-04;331;633;277520;208107;53.3;40.0
26;2021-07-05;887;4673;278407;212780;53.5;40.9
26;2021-07-06;1266;4199;279673;216979;53.7;41.7
26;2021-07-07;1440;3796;281113;220775;54.0;42.4
26;2021-07-08;2387;3330;283500;224105;54.5;43.1
26;2021-07-09;1558;4787;285058;228892;54.8;44.0
26;2021-07-10;910;2913;285968;231805;54.9;44.5
26;2021-07-11;332;347;286300;232152;55.0;44.6
26;2021-07-12;1113;4218;287413;236370;55.2;45.4
26;2021-07-13;2301;4343;289714;240713;55.7;46.2
26;2021-07-14;1060;814;290774;241527;55.9;46.4
26;2021-07-15;3166;3656;293940;245183;56.5;47.1
26;2021-07-16;2999;3688;296939;248871;57.0;47.8
26;2021-07-17;1876;1814;298815;250685;57.4;48.2
26;2021-07-18;20;24;298835;250709;57.4;48.2
26;2021-07-19;2724;3264;301559;253973;57.9;48.8
26;2021-07-20;3706;3370;305265;257343;58.6;49.4
26;2021-07-21;3588;3087;308853;260430;59.3;50.0
26;2021-07-22;4119;2970;312972;263400;60.1;50.6
26;2021-07-23;3860;3401;316832;266801;60.9;51.3
26;2021-07-24;2344;1363;319176;268164;61.3;51.5
26;2021-07-25;608;97;319784;268261;61.4;51.5
26;2021-07-26;3429;2581;323213;270842;62.1;52.0
26;2021-07-27;4838;2621;328051;273463;63.0;52.5
26;2021-07-28;4533;2387;332584;275850;63.9;53.0
26;2021-07-29;3902;2896;336486;278746;64.6;53.5
26;2021-07-30;3484;2671;339970;281417;65.3;54.1
26;2021-07-31;1144;1008;341114;282425;65.5;54.3
26;2021-08-01;419;108;341533;282533;65.6;54.3
26;2021-08-02;2953;2362;344486;284895;66.2;54.7
26;2021-08-03;3298;2295;347784;287190;66.8;55.2
26;2021-08-04;3999;2016;351783;289206;67.6;55.6
26;2021-08-05;3154;2205;354937;291411;68.2;56.0
26;2021-08-06;3174;2639;358111;294050;68.8;56.5
26;2021-08-07;640;844;358751;294894;68.9;56.6
26;2021-08-08;29;13;358780;294907;68.9;56.7
26;2021-08-09;2191;3062;360971;297969;69.3;57.2
26;2021-08-10;2341;3049;363312;301018;69.8;57.8
26;2021-08-11;2078;2719;365390;303737;70.2;58.3
26;2021-08-12;1775;2586;367165;306323;70.5;58.8
26;2021-08-13;1742;2424;368907;308747;70.9;59.3
26;2021-08-14;272;872;369179;309619;70.9;59.5
26;2021-08-15;6;8;369185;309627;70.9;59.5
26;2021-08-16;1190;3291;370375;312918;71.1;60.1
26;2021-08-17;1520;3154;371895;316072;71.4;60.7
26;2021-08-18;1631;3375;373526;319447;71.8;61.4
26;2021-08-19;1552;3069;375078;322516;72.1;62.0
26;2021-08-20;1446;2980;376524;325496;72.3;62.5
26;2021-08-21;599;1090;377123;326586;72.4;62.7
26;2021-08-22;58;379;377181;326965;72.5;62.8
26;2021-08-23;1601;3621;378782;330586;72.8;63.5
26;2021-08-24;1748;3595;380530;334181;73.1;64.2
26;2021-08-25;1605;3659;382135;337840;73.4;64.9
26;2021-08-26;1493;3160;383628;341000;73.7;65.5
26;2021-08-27;1570;3607;385198;344607;74.0;66.2
26;2021-08-28;395;1104;385593;345711;74.1;66.4
26;2021-08-29;10;25;385603;345736;74.1;66.4
26;2021-08-30;1464;3441;387067;349177;74.4;67.1
26;2021-08-31;1286;3434;388353;352611;74.6;67.7
26;2021-09-01;1374;2815;389727;355426;74.9;68.3
26;2021-09-02;1114;2153;390841;357579;75.1;68.7
26;2021-09-03;1103;2753;391944;360332;75.3;69.2
26;2021-09-04;429;740;392373;361072;75.4;69.4
26;2021-09-05;25;24;392398;361096;75.4;69.4
26;2021-09-06;734;1777;393132;362873;75.5;69.7
26;2021-09-07;758;1695;393890;364568;75.7;70.0
26;2021-09-08;851;1926;394741;366494;75.8;70.4
26;2021-09-09;515;1607;395256;368101;75.9;70.7
26;2021-09-10;835;2058;396091;370159;76.1;71.1
26;2021-09-11;305;800;396396;370959;76.1;71.3
26;2021-09-12;0;5;396396;370964;76.1;71.3
26;2021-09-13;540;1730;396936;372694;76.3;71.6
26;2021-09-14;720;1699;397656;374393;76.4;71.9
26;2021-09-15;712;1828;398368;376221;76.5;72.3
26;2021-09-16;497;1007;398865;377228;76.6;72.5
26;2021-09-17;613;1731;399478;378959;76.7;72.8
26;2021-09-18;271;742;399749;379701;76.8;72.9
26;2021-09-19;4;13;399753;379714;76.8;72.9
26;2021-09-20;333;1095;400086;380809;76.9;73.2
26;2021-09-21;415;1013;400501;381822;76.9;73.3
26;2021-09-22;424;1519;400925;383341;77.0;73.6
26;2021-09-23;360;779;401285;384120;77.1;73.8
26;2021-09-24;441;1431;401726;385551;77.2;74.1
26;2021-09-25;180;596;401906;386147;77.2;74.2
26;2021-09-26;2;19;401908;386166;77.2;74.2
26;2021-09-27;312;811;402220;386977;77.3;74.3
26;2021-09-28;245;610;402465;387587;77.3;74.5
26;2021-09-29;383;1010;402848;388597;77.4;74.6
26;2021-09-30;226;515;403074;389112;77.4;74.7
26;2021-10-01;445;999;403519;390111;77.5;74.9
26;2021-10-02;188;339;403707;390450;77.6;75.0
26;2021-10-03;3;2;403710;390452;77.6;75.0
27;2020-12-27;2;0;2;0;0.0;0.0
27;2020-12-28;1;0;3;0;0.0;0.0
27;2020-12-29;2;0;5;0;0.0;0.0
27;2020-12-30;0;0;5;0;0.0;0.0
27;2020-12-31;0;0;5;0;0.0;0.0
27;2021-01-01;0;0;5;0;0.0;0.0
27;2021-01-02;0;0;5;0;0.0;0.0
27;2021-01-03;2;0;7;0;0.0;0.0
27;2021-01-04;0;0;7;0;0.0;0.0
27;2021-01-05;15;0;22;0;0.0;0.0
27;2021-01-06;161;0;183;0;0.0;0.0
27;2021-01-07;371;1;554;1;0.1;0.0
27;2021-01-08;443;0;997;1;0.2;0.0
27;2021-01-09;72;1;1069;2;0.2;0.0
27;2021-01-10;100;0;1169;2;0.2;0.0
27;2021-01-11;384;0;1553;2;0.3;0.0
27;2021-01-12;409;2;1962;4;0.3;0.0
27;2021-01-13;840;1;2802;5;0.5;0.0
27;2021-01-14;1629;24;4431;29;0.7;0.0
27;2021-01-15;1222;3;5653;32;0.9;0.0
27;2021-01-16;332;1;5985;33;1.0;0.0
27;2021-01-17;205;0;6190;33;1.0;0.0
27;2021-01-18;800;2;6990;35;1.2;0.0
27;2021-01-19;772;3;7762;38;1.3;0.0
27;2021-01-20;871;1;8633;39;1.4;0.0
27;2021-01-21;654;4;9287;43;1.5;0.0
27;2021-01-22;779;4;10066;47;1.7;0.0
27;2021-01-23;350;0;10416;47;1.7;0.0
27;2021-01-24;169;2;10585;49;1.8;0.0
27;2021-01-25;635;13;11220;62;1.9;0.0
27;2021-01-26;462;16;11682;78;1.9;0.0
27;2021-01-27;506;98;12188;176;2.0;0.0
27;2021-01-28;517;234;12705;410;2.1;0.1
27;2021-01-29;509;99;13214;509;2.2;0.1
27;2021-01-30;242;23;13456;532;2.2;0.1
27;2021-01-31;27;18;13483;550;2.2;0.1
27;2021-02-01;348;178;13831;728;2.3;0.1
27;2021-02-02;308;237;14139;965;2.4;0.2
27;2021-02-03;487;350;14626;1315;2.4;0.2
27;2021-02-04;717;795;15343;2110;2.6;0.4
27;2021-02-05;664;963;16007;3073;2.7;0.5
27;2021-02-06;126;190;16133;3263;2.7;0.5
27;2021-02-07;25;35;16158;3298;2.7;0.5
27;2021-02-08;312;299;16470;3597;2.7;0.6
27;2021-02-09;341;410;16811;4007;2.8;0.7
27;2021-02-10;305;445;17116;4452;2.8;0.7
27;2021-02-11;318;365;17434;4817;2.9;0.8
27;2021-02-12;230;436;17664;5253;2.9;0.9
27;2021-02-13;151;101;17815;5354;3.0;0.9
27;2021-02-14;6;64;17821;5418;3.0;0.9
27;2021-02-15;390;442;18211;5860;3.0;1.0
27;2021-02-16;296;522;18507;6382;3.1;1.1
27;2021-02-17;247;464;18754;6846;3.1;1.1
27;2021-02-18;363;493;19117;7339;3.2;1.2
27;2021-02-19;218;531;19335;7870;3.2;1.3
27;2021-02-20;129;202;19464;8072;3.2;1.3
27;2021-02-21;12;96;19476;8168;3.2;1.4
27;2021-02-22;482;446;19958;8614;3.3;1.4
27;2021-02-23;496;515;20454;9129;3.4;1.5
27;2021-02-24;543;530;20997;9659;3.5;1.6
27;2021-02-25;847;627;21844;10286;3.6;1.7
27;2021-02-26;955;600;22799;10886;3.8;1.8
27;2021-02-27;408;131;23207;11017;3.9;1.8
27;2021-02-28;174;24;23381;11041;3.9;1.8
27;2021-03-01;488;375;23869;11416;4.0;1.9
27;2021-03-02;765;282;24634;11698;4.1;1.9
27;2021-03-03;853;283;25487;11981;4.2;2.0
27;2021-03-04;887;206;26374;12187;4.4;2.0
27;2021-03-05;1304;203;27678;12390;4.6;2.1
27;2021-03-06;1637;100;29315;12490;4.9;2.1
27;2021-03-07;619;17;29934;12507;5.0;2.1
27;2021-03-08;1204;265;31138;12772;5.2;2.1
27;2021-03-09;1828;230;32966;13002;5.5;2.2
27;2021-03-10;2116;326;35082;13328;5.8;2.2
27;2021-03-11;2162;200;37244;13528;6.2;2.3
27;2021-03-12;2817;192;40061;13720;6.7;2.3
27;2021-03-13;1919;120;41980;13840;7.0;2.3
27;2021-03-14;655;16;42635;13856;7.1;2.3
27;2021-03-15;1558;212;44193;14068;7.4;2.3
27;2021-03-16;1489;236;45682;14304;7.6;2.4
27;2021-03-17;1856;361;47538;14665;7.9;2.4
27;2021-03-18;1687;344;49225;15009;8.2;2.5
27;2021-03-19;1834;161;51059;15170;8.5;2.5
27;2021-03-20;905;41;51964;15211;8.7;2.5
27;2021-03-21;258;3;52222;15214;8.7;2.5
27;2021-03-22;1235;534;53457;15748;8.9;2.6
27;2021-03-23;1627;439;55084;16187;9.2;2.7
27;2021-03-24;1523;469;56607;16656;9.4;2.8
27;2021-03-25;2165;506;58772;17162;9.8;2.9
27;2021-03-26;2531;433;61303;17595;10.2;2.9
27;2021-03-27;1568;200;62871;17795;10.5;3.0
27;2021-03-28;1149;49;64020;17844;10.7;3.0
27;2021-03-29;1375;820;65395;18664;10.9;3.1
27;2021-03-30;1391;835;66786;19499;11.1;3.2
27;2021-03-31;1485;866;68271;20365;11.4;3.4
27;2021-04-01;1956;809;70227;21174;11.7;3.5
27;2021-04-02;1999;1170;72226;22344;12.0;3.7
27;2021-04-03;1563;732;73789;23076;12.3;3.8
27;2021-04-04;978;176;74767;23252;12.4;3.9
27;2021-04-05;283;6;75050;23258;12.5;3.9
27;2021-04-06;1413;1791;76463;25049;12.7;4.2
27;2021-04-07;1322;1742;77785;26791;12.9;4.5
27;2021-04-08;1684;1677;79469;28468;13.2;4.7
27;2021-04-09;2945;1558;82414;30026;13.7;5.0
27;2021-04-10;2033;985;84447;31011;14.1;5.2
27;2021-04-11;946;211;85393;31222;14.2;5.2
27;2021-04-12;2434;1507;87827;32729;14.6;5.4
27;2021-04-13;2394;1547;90221;34276;15.0;5.7
27;2021-04-14;2085;1623;92306;35899;15.4;6.0
27;2021-04-15;1874;1658;94180;37557;15.7;6.3
27;2021-04-16;2751;1109;96931;38666;16.1;6.4
27;2021-04-17;2168;496;99099;39162;16.5;6.5
27;2021-04-18;452;16;99551;39178;16.6;6.5
27;2021-04-19;1712;1174;101263;40352;16.9;6.7
27;2021-04-20;2387;1300;103650;41652;17.3;6.9
27;2021-04-21;2210;1081;105860;42733;17.6;7.1
27;2021-04-22;2180;1418;108040;44151;18.0;7.4
27;2021-04-23;2446;1174;110486;45325;18.4;7.5
27;2021-04-24;3260;1147;113746;46472;18.9;7.7
27;2021-04-25;1130;1051;114876;47523;19.1;7.9
27;2021-04-26;1925;1147;116801;48670;19.4;8.1
27;2021-04-27;2528;1082;119329;49752;19.9;8.3
27;2021-04-28;2395;1310;121724;51062;20.3;8.5
27;2021-04-29;2491;1472;124215;52534;20.7;8.7
27;2021-04-30;2371;1604;126586;54138;21.1;9.0
27;2021-05-01;2638;890;129224;55028;21.5;9.2
27;2021-05-02;1952;897;131176;55925;21.8;9.3
27;2021-05-03;3064;872;134240;56797;22.3;9.5
27;2021-05-04;2782;1648;137022;58445;22.8;9.7
27;2021-05-05;2816;1649;139838;60094;23.3;10.0
27;2021-05-06;3184;1280;143022;61374;23.8;10.2
27;2021-05-07;3322;1979;146344;63353;24.4;10.5
27;2021-05-08;2805;1329;149149;64682;24.8;10.8
27;2021-05-09;1696;297;150845;64979;25.1;10.8
27;2021-05-10;2950;2269;153795;67248;25.6;11.2
27;2021-05-11;3358;1752;157153;69000;26.2;11.5
27;2021-05-12;3463;1726;160616;70726;26.7;11.8
27;2021-05-13;1892;254;162508;70980;27.1;11.8
27;2021-05-14;3884;1784;166392;72764;27.7;12.1
27;2021-05-15;6601;951;172993;73715;28.8;12.3
27;2021-05-16;3668;438;176661;74153;29.4;12.3
27;2021-05-17;2774;1161;179435;75314;29.9;12.5
27;2021-05-18;3845;1296;183280;76610;30.5;12.8
27;2021-05-19;3967;1154;187247;77764;31.2;12.9
27;2021-05-20;3874;1171;191121;78935;31.8;13.1
27;2021-05-21;3967;1789;195088;80724;32.5;13.4
27;2021-05-22;4367;802;199455;81526;33.2;13.6
27;2021-05-23;799;173;200254;81699;33.3;13.6
27;2021-05-24;1489;342;201743;82041;33.6;13.7
27;2021-05-25;3511;1606;205254;83647;34.2;13.9
27;2021-05-26;3855;1740;209109;85387;34.8;14.2
27;2021-05-27;3789;1478;212898;86865;35.4;14.5
27;2021-05-28;3403;2621;216301;89486;36.0;14.9
27;2021-05-29;4822;2293;221123;91779;36.8;15.3
27;2021-05-30;1117;247;222240;92026;37.0;15.3
27;2021-05-31;3465;2272;225705;94298;37.6;15.7
27;2021-06-01;3813;2239;229518;96537;38.2;16.1
27;2021-06-02;3341;2175;232859;98712;38.8;16.4
27;2021-06-03;4430;2115;237289;100827;39.5;16.8
27;2021-06-04;3603;2962;240892;103789;40.1;17.3
27;2021-06-05;3207;3347;244099;107136;40.6;17.8
27;2021-06-06;2004;1005;246103;108141;41.0;18.0
27;2021-06-07;2570;2353;248673;110494;41.4;18.4
27;2021-06-08;3126;2371;251799;112865;41.9;18.8
27;2021-06-09;2305;2470;254104;115335;42.3;19.2
27;2021-06-10;2431;2038;256535;117373;42.7;19.5
27;2021-06-11;2889;3766;259424;121139;43.2;20.2
27;2021-06-12;1982;4191;261406;125330;43.5;20.9
27;2021-06-13;1084;2687;262490;128017;43.7;21.3
27;2021-06-14;1995;3110;264485;131127;44.0;21.8
27;2021-06-15;2688;3018;267173;134145;44.5;22.3
27;2021-06-16;2501;3254;269674;137399;44.9;22.9
27;2021-06-17;2296;3288;271970;140687;45.3;23.4
27;2021-06-18;2746;4418;274716;145105;45.7;24.2
27;2021-06-19;1863;3392;276579;148497;46.0;24.7
27;2021-06-20;607;710;277186;149207;46.1;24.8
27;2021-06-21;1703;3495;278889;152702;46.4;25.4
27;2021-06-22;2385;3710;281274;156412;46.8;26.0
27;2021-06-23;2073;3568;283347;159980;47.2;26.6
27;2021-06-24;2256;3412;285603;163392;47.5;27.2
27;2021-06-25;1936;4459;287539;167851;47.9;27.9
27;2021-06-26;884;5352;288423;173203;48.0;28.8
27;2021-06-27;377;1427;288800;174630;48.1;29.1
27;2021-06-28;1129;3403;289929;178033;48.3;29.6
27;2021-06-29;1703;4363;291632;182396;48.5;30.4
27;2021-06-30;2115;4096;293747;186492;48.9;31.0
27;2021-07-01;2224;3908;295971;190400;49.3;31.7
27;2021-07-02;1589;4620;297560;195020;49.5;32.5
27;2021-07-03;1309;4773;298869;199793;49.8;33.3
27;2021-07-04;504;1403;299373;201196;49.8;33.5
27;2021-07-05;1417;3528;300790;204724;50.1;34.1
27;2021-07-06;1366;4180;302156;208904;50.3;34.8
27;2021-07-07;1756;4901;303912;213805;50.6;35.6
27;2021-07-08;2089;4349;306001;218154;50.9;36.3
27;2021-07-09;1984;5287;307985;223441;51.3;37.2
27;2021-07-10;1167;4179;309152;227620;51.5;37.9
27;2021-07-11;426;1139;309578;228759;51.5;38.1
27;2021-07-12;1253;4372;310831;233131;51.7;38.8
27;2021-07-13;2759;5345;313590;238476;52.2;39.7
27;2021-07-14;1518;1753;315108;240229;52.5;40.0
27;2021-07-15;3033;5464;318141;245693;53.0;40.9
27;2021-07-16;3820;5286;321961;250979;53.6;41.8
27;2021-07-17;2732;3878;324693;254857;54.1;42.4
27;2021-07-18;552;1266;325245;256123;54.1;42.6
27;2021-07-19;3687;3787;328932;259910;54.8;43.3
27;2021-07-20;3459;3591;332391;263501;55.3;43.9
27;2021-07-21;4251;3900;336642;267401;56.0;44.5
27;2021-07-22;4750;3714;341392;271115;56.8;45.1
27;2021-07-23;3592;3398;344984;274513;57.4;45.7
27;2021-07-24;3114;2325;348098;276838;57.9;46.1
27;2021-07-25;493;545;348591;277383;58.0;46.2
27;2021-07-26;3071;3175;351662;280558;58.5;46.7
27;2021-07-27;3596;3101;355258;283659;59.1;47.2
27;2021-07-28;3592;3241;358850;286900;59.7;47.8
27;2021-07-29;4590;3510;363440;290410;60.5;48.3
27;2021-07-30;3816;3142;367256;293552;61.1;48.9
27;2021-07-31;3062;2585;370318;296137;61.6;49.3
27;2021-08-01;539;498;370857;296635;61.7;49.4
27;2021-08-02;3319;2584;374176;299219;62.3;49.8
27;2021-08-03;3427;2770;377603;301989;62.9;50.3
27;2021-08-04;3059;2334;380662;304323;63.4;50.7
27;2021-08-05;2676;2358;383338;306681;63.8;51.1
27;2021-08-06;3270;3244;386608;309925;64.4;51.6
27;2021-08-07;1801;2553;388409;312478;64.7;52.0
27;2021-08-08;218;197;388627;312675;64.7;52.1
27;2021-08-09;2210;2807;390837;315482;65.1;52.5
27;2021-08-10;2811;3512;393648;318994;65.5;53.1
27;2021-08-11;2637;3099;396285;322093;66.0;53.6
27;2021-08-12;2363;3905;398648;325998;66.4;54.3
27;2021-08-13;1745;2571;400393;328569;66.7;54.7
27;2021-08-14;1163;2889;401556;331458;66.8;55.2
27;2021-08-15;18;23;401574;331481;66.9;55.2
27;2021-08-16;1811;3816;403385;335297;67.2;55.8
27;2021-08-17;2046;3441;405431;338738;67.5;56.4
27;2021-08-18;1457;2986;406888;341724;67.7;56.9
27;2021-08-19;1711;3356;408599;345080;68.0;57.4
27;2021-08-20;1636;3440;410235;348520;68.3;58.0
27;2021-08-21;987;2842;411222;351362;68.5;58.5
27;2021-08-22;184;162;411406;351524;68.5;58.5
27;2021-08-23;1080;4007;412486;355531;68.7;59.2
27;2021-08-24;1440;3969;413926;359500;68.9;59.8
27;2021-08-25;1718;3414;415644;362914;69.2;60.4
27;2021-08-26;1157;2932;416801;365846;69.4;60.9
27;2021-08-27;1262;3218;418063;369064;69.6;61.4
27;2021-08-28;911;2869;418974;371933;69.7;61.9
27;2021-08-29;87;135;419061;372068;69.8;61.9
27;2021-08-30;906;3315;419967;375383;69.9;62.5
27;2021-08-31;1224;3206;421191;378589;70.1;63.0
27;2021-09-01;996;3177;422187;381766;70.3;63.6
27;2021-09-02;872;2489;423059;384255;70.4;64.0
27;2021-09-03;847;2469;423906;386724;70.6;64.4
27;2021-09-04;727;2087;424633;388811;70.7;64.7
27;2021-09-05;36;162;424669;388973;70.7;64.8
27;2021-09-06;537;1804;425206;390777;70.8;65.1
27;2021-09-07;697;2367;425903;393144;70.9;65.4
27;2021-09-08;770;2401;426673;395545;71.0;65.8
27;2021-09-09;681;1932;427354;397477;71.1;66.2
27;2021-09-10;898;2372;428252;399849;71.3;66.6
27;2021-09-11;607;1945;428859;401794;71.4;66.9
27;2021-09-12;42;184;428901;401978;71.4;66.9
27;2021-09-13;350;1335;429251;403313;71.5;67.1
27;2021-09-14;593;1475;429844;404788;71.6;67.4
27;2021-09-15;552;1668;430396;406456;71.7;67.7
27;2021-09-16;594;1132;430990;407588;71.7;67.9
27;2021-09-17;790;1289;431780;408877;71.9;68.1
27;2021-09-18;365;1248;432145;410125;71.9;68.3
27;2021-09-19;56;161;432201;410286;72.0;68.3
27;2021-09-20;260;773;432461;411059;72.0;68.4
27;2021-09-21;428;963;432889;412022;72.1;68.6
27;2021-09-22;300;1029;433189;413051;72.1;68.8
27;2021-09-23;344;757;433533;413808;72.2;68.9
27;2021-09-24;575;1244;434108;415052;72.3;69.1
27;2021-09-25;292;1122;434400;416174;72.3;69.3
27;2021-09-26;4;12;434404;416186;72.3;69.3
27;2021-09-27;190;472;434594;416658;72.3;69.4
27;2021-09-28;313;724;434907;417382;72.4;69.5
27;2021-09-29;239;724;435146;418106;72.4;69.6
27;2021-09-30;162;521;435308;418627;72.5;69.7
27;2021-10-01;337;999;435645;419626;72.5;69.9
27;2021-10-02;357;795;436002;420421;72.6;70.0
27;2021-10-03;13;12;436015;420433;72.6;70.0
28;2020-12-27;0;0;0;0;0.0;0.0
28;2020-12-28;0;0;0;0;0.0;0.0
28;2020-12-29;0;0;0;0;0.0;0.0
28;2020-12-30;0;0;0;0;0.0;0.0
28;2020-12-31;0;0;0;0;0.0;0.0
28;2021-01-01;1;0;1;0;0.0;0.0
28;2021-01-02;0;0;1;0;0.0;0.0
28;2021-01-03;0;0;1;0;0.0;0.0
28;2021-01-04;0;0;1;0;0.0;0.0
28;2021-01-05;5;0;6;0;0.0;0.0
28;2021-01-06;84;0;90;0;0.0;0.0
28;2021-01-07;102;0;192;0;0.0;0.0
28;2021-01-08;134;2;326;2;0.1;0.0
28;2021-01-09;79;0;405;2;0.1;0.0
28;2021-01-10;1;0;406;2;0.1;0.0
28;2021-01-11;204;0;610;2;0.1;0.0
28;2021-01-12;265;1;875;3;0.2;0.0
28;2021-01-13;398;3;1273;6;0.3;0.0
28;2021-01-14;451;5;1724;11;0.4;0.0
28;2021-01-15;374;3;2098;14;0.5;0.0
28;2021-01-16;206;2;2304;16;0.5;0.0
28;2021-01-17;21;0;2325;16;0.5;0.0
28;2021-01-18;372;2;2697;18;0.6;0.0
28;2021-01-19;503;4;3200;22;0.7;0.0
28;2021-01-20;636;1;3836;23;0.9;0.0
28;2021-01-21;796;3;4632;26;1.1;0.0
28;2021-01-22;478;1;5110;27;1.2;0.0
28;2021-01-23;353;0;5463;27;1.3;0.0
28;2021-01-24;1;0;5464;27;1.3;0.0
28;2021-01-25;456;4;5920;31;1.4;0.0
28;2021-01-26;717;4;6637;35;1.5;0.0
28;2021-01-27;1211;50;7848;85;1.8;0.0
28;2021-01-28;1587;89;9435;174;2.2;0.0
28;2021-01-29;896;87;10331;261;2.4;0.1
28;2021-01-30;249;46;10580;307;2.5;0.1
28;2021-01-31;2;22;10582;329;2.5;0.1
28;2021-02-01;325;115;10907;444;2.5;0.1
28;2021-02-02;368;197;11275;641;2.6;0.1
28;2021-02-03;473;247;11748;888;2.7;0.2
28;2021-02-04;525;263;12273;1151;2.9;0.3
28;2021-02-05;436;210;12709;1361;3.0;0.3
28;2021-02-06;201;128;12910;1489;3.0;0.3
28;2021-02-07;0;0;12910;1489;3.0;0.3
28;2021-02-08;331;207;13241;1696;3.1;0.4
28;2021-02-09;281;262;13522;1958;3.1;0.5
28;2021-02-10;443;324;13965;2282;3.3;0.5
28;2021-02-11;562;412;14527;2694;3.4;0.6
28;2021-02-12;453;332;14980;3026;3.5;0.7
28;2021-02-13;181;157;15161;3183;3.5;0.7
28;2021-02-14;0;2;15161;3185;3.5;0.7
28;2021-02-15;280;341;15441;3526;3.6;0.8
28;2021-02-16;396;594;15837;4120;3.7;1.0
28;2021-02-17;584;1036;16421;5156;3.8;1.2
28;2021-02-18;665;1295;17086;6451;4.0;1.5
28;2021-02-19;548;661;17634;7112;4.1;1.7
28;2021-02-20;114;116;17748;7228;4.1;1.7
28;2021-02-21;7;32;17755;7260;4.1;1.7
28;2021-02-22;223;424;17978;7684;4.2;1.8
28;2021-02-23;203;310;18181;7994;4.2;1.9
28;2021-02-24;244;377;18425;8371;4.3;1.9
28;2021-02-25;574;345;18999;8716;4.4;2.0
28;2021-02-26;764;306;19763;9022;4.6;2.1
28;2021-02-27;265;74;20028;9096;4.7;2.1
28;2021-02-28;23;17;20051;9113;4.7;2.1
28;2021-03-01;292;180;20343;9293;4.7;2.2
28;2021-03-02;396;246;20739;9539;4.8;2.2
28;2021-03-03;369;339;21108;9878;4.9;2.3
28;2021-03-04;720;426;21828;10304;5.1;2.4
28;2021-03-05;1319;368;23147;10672;5.4;2.5
28;2021-03-06;1998;81;25145;10753;5.9;2.5
28;2021-03-07;974;31;26119;10784;6.1;2.5
28;2021-03-08;398;262;26517;11046;6.2;2.6
28;2021-03-09;981;329;27498;11375;6.4;2.6
28;2021-03-10;1358;486;28856;11861;6.7;2.8
28;2021-03-11;1535;663;30391;12524;7.1;2.9
28;2021-03-12;2255;606;32646;13130;7.6;3.1
28;2021-03-13;1235;113;33881;13243;7.9;3.1
28;2021-03-14;519;17;34400;13260;8.0;3.1
28;2021-03-15;755;225;35155;13485;8.2;3.1
28;2021-03-16;716;217;35871;13702;8.4;3.2
28;2021-03-17;746;283;36617;13985;8.5;3.3
28;2021-03-18;1203;265;37820;14250;8.8;3.3
28;2021-03-19;1558;321;39378;14571;9.2;3.4
28;2021-03-20;639;21;40017;14592;9.3;3.4
28;2021-03-21;29;8;40046;14600;9.3;3.4
28;2021-03-22;766;317;40812;14917;9.5;3.5
28;2021-03-23;1027;189;41839;15106;9.7;3.5
28;2021-03-24;1315;274;43154;15380;10.0;3.6
28;2021-03-25;1796;286;44950;15666;10.5;3.6
28;2021-03-26;2084;346;47034;16012;11.0;3.7
28;2021-03-27;402;38;47436;16050;11.0;3.7
28;2021-03-28;12;0;47448;16050;11.0;3.7
28;2021-03-29;1139;349;48587;16399;11.3;3.8
28;2021-03-30;1711;252;50298;16651;11.7;3.9
28;2021-03-31;2017;474;52315;17125;12.2;4.0
28;2021-04-01;1796;586;54111;17711;12.6;4.1
28;2021-04-02;1583;1315;55694;19026;13.0;4.4
28;2021-04-03;607;1070;56301;20096;13.1;4.7
28;2021-04-04;33;299;56334;20395;13.1;4.7
28;2021-04-05;40;3;56374;20398;13.1;4.8
28;2021-04-06;1221;459;57595;20857;13.4;4.9
28;2021-04-07;1890;1005;59485;21862;13.9;5.1
28;2021-04-08;2086;1070;61571;22932;14.3;5.3
28;2021-04-09;3230;916;64801;23848;15.1;5.6
28;2021-04-10;1581;201;66382;24049;15.5;5.6
28;2021-04-11;141;450;66523;24499;15.5;5.7
28;2021-04-12;1673;558;68196;25057;15.9;5.8
28;2021-04-13;1875;673;70071;25730;16.3;6.0
28;2021-04-14;2771;903;72842;26633;17.0;6.2
28;2021-04-15;2557;1147;75399;27780;17.6;6.5
28;2021-04-16;2554;806;77953;28586;18.2;6.7
28;2021-04-17;2309;133;80262;28719;18.7;6.7
28;2021-04-18;45;8;80307;28727;18.7;6.7
28;2021-04-19;1576;648;81883;29375;19.1;6.8
28;2021-04-20;1836;596;83719;29971;19.5;7.0
28;2021-04-21;2680;962;86399;30933;20.1;7.2
28;2021-04-22;1783;1218;88182;32151;20.5;7.5
28;2021-04-23;2325;1104;90507;33255;21.1;7.7
28;2021-04-24;3656;137;94163;33392;21.9;7.8
28;2021-04-25;1012;37;95175;33429;22.2;7.8
28;2021-04-26;1331;929;96506;34358;22.5;8.0
28;2021-04-27;1436;1268;97942;35626;22.8;8.3
28;2021-04-28;2373;1828;100315;37454;23.4;8.7
28;2021-04-29;2130;1511;102445;38965;23.9;9.1
28;2021-04-30;2973;1225;105418;40190;24.5;9.4
28;2021-05-01;127;115;105545;40305;24.6;9.4
28;2021-05-02;2;65;105547;40370;24.6;9.4
28;2021-05-03;1048;1015;106595;41385;24.8;9.6
28;2021-05-04;1359;1671;107954;43056;25.1;10.0
28;2021-05-05;2830;1649;110784;44705;25.8;10.4
28;2021-05-06;2456;1473;113240;46178;26.4;10.8
28;2021-05-07;2311;1923;115551;48101;26.9;11.2
28;2021-05-08;1078;112;116629;48213;27.2;11.2
28;2021-05-09;105;610;116734;48823;27.2;11.4
28;2021-05-10;1308;1891;118042;50714;27.5;11.8
28;2021-05-11;2024;2328;120066;53042;28.0;12.4
28;2021-05-12;2620;3232;122686;56274;28.6;13.1
28;2021-05-13;289;451;122975;56725;28.6;13.2
28;2021-05-14;1900;1612;124875;58337;29.1;13.6
28;2021-05-15;1433;1673;126308;60010;29.4;14.0
28;2021-05-16;1986;131;128294;60141;29.9;14.0
28;2021-05-17;2874;1485;131168;61626;30.5;14.4
28;2021-05-18;3382;1378;134550;63004;31.3;14.7
28;2021-05-19;5090;1279;139640;64283;32.5;15.0
28;2021-05-20;4149;1231;143789;65514;33.5;15.3
28;2021-05-21;3464;1579;147253;67093;34.3;15.6
28;2021-05-22;729;1161;147982;68254;34.5;15.9
28;2021-05-23;1956;137;149938;68391;34.9;15.9
28;2021-05-24;1428;395;151366;68786;35.2;16.0
28;2021-05-25;1876;1403;153242;70189;35.7;16.3
28;2021-05-26;2765;1341;156007;71530;36.3;16.7
28;2021-05-27;2754;1233;158761;72763;37.0;16.9
28;2021-05-28;3080;1726;161841;74489;37.7;17.3
28;2021-05-29;1868;872;163709;75361;38.1;17.5
28;2021-05-30;16;47;163725;75408;38.1;17.6
28;2021-05-31;2014;934;165739;76342;38.6;17.8
28;2021-06-01;2133;1653;167872;77995;39.1;18.2
28;2021-06-02;2077;2457;169949;80452;39.6;18.7
28;2021-06-03;2498;1560;172447;82012;40.2;19.1
28;2021-06-04;2608;2353;175055;84365;40.8;19.6
28;2021-06-05;1909;2519;176964;86884;41.2;20.2
28;2021-06-06;1060;1046;178024;87930;41.5;20.5
28;2021-06-07;3575;1574;181599;89504;42.3;20.8
28;2021-06-08;3196;1519;184795;91023;43.0;21.2
28;2021-06-09;3675;2123;188470;93146;43.9;21.7
28;2021-06-10;3140;1257;191610;94403;44.6;22.0
28;2021-06-11;3791;2130;195401;96533;45.5;22.5
28;2021-06-12;1304;560;196705;97093;45.8;22.6
28;2021-06-13;385;108;197090;97201;45.9;22.6
28;2021-06-14;2207;1992;199297;99193;46.4;23.1
28;2021-06-15;2092;2225;201389;101418;46.9;23.6
28;2021-06-16;2508;3972;203897;105390;47.5;24.5
28;2021-06-17;1940;3135;205837;108525;47.9;25.3
28;2021-06-18;2487;3788;208324;112313;48.5;26.2
28;2021-06-19;776;1612;209100;113925;48.7;26.5
28;2021-06-20;23;24;209123;113949;48.7;26.5
28;2021-06-21;1682;1989;210805;115938;49.1;27.0
28;2021-06-22;1372;2106;212177;118044;49.4;27.5
28;2021-06-23;1782;3164;213959;121208;49.8;28.2
28;2021-06-24;734;929;214693;122137;50.0;28.4
28;2021-06-25;1888;3025;216581;125162;50.4;29.1
28;2021-06-26;310;2110;216891;127272;50.5;29.6
28;2021-06-27;588;1284;217479;128556;50.6;29.9
28;2021-06-28;1225;3654;218704;132210;50.9;30.8
28;2021-06-29;1342;3790;220046;136000;51.2;31.7
28;2021-06-30;1493;4261;221539;140261;51.6;32.7
28;2021-07-01;1277;3500;222816;143761;51.9;33.5
28;2021-07-02;1312;4651;224128;148412;52.2;34.6
28;2021-07-03;1131;2370;225259;150782;52.5;35.1
28;2021-07-04;145;1325;225404;152107;52.5;35.4
28;2021-07-05;1360;2511;226764;154618;52.8;36.0
28;2021-07-06;1508;2868;228272;157486;53.2;36.7
28;2021-07-07;1636;4140;229908;161626;53.5;37.6
28;2021-07-08;1467;3240;231375;164866;53.9;38.4
28;2021-07-09;1393;4516;232768;169382;54.2;39.4
28;2021-07-10;528;2205;233296;171587;54.3;40.0
28;2021-07-11;2;1;233298;171588;54.3;40.0
28;2021-07-12;1526;3928;234824;175516;54.7;40.9
28;2021-07-13;2261;4143;237085;179659;55.2;41.8
28;2021-07-14;1328;1395;238413;181054;55.5;42.2
28;2021-07-15;2986;3974;241399;185028;56.2;43.1
28;2021-07-16;2444;4751;243843;189779;56.8;44.2
28;2021-07-17;1263;2430;245106;192209;57.1;44.8
28;2021-07-18;368;945;245474;193154;57.2;45.0
28;2021-07-19;1806;4331;247280;197485;57.6;46.0
28;2021-07-20;2476;4090;249756;201575;58.2;46.9
28;2021-07-21;2959;4285;252715;205860;58.8;47.9
28;2021-07-22;3670;3430;256385;209290;59.7;48.7
28;2021-07-23;2960;3996;259345;213286;60.4;49.7
28;2021-07-24;1715;1484;261060;214770;60.8;50.0
28;2021-07-25;67;60;261127;214830;60.8;50.0
28;2021-07-26;2930;3386;264057;218216;61.5;50.8
28;2021-07-27;3885;2622;267942;220838;62.4;51.4
28;2021-07-28;3947;2745;271889;223583;63.3;52.1
28;2021-07-29;4466;2091;276355;225674;64.4;52.6
28;2021-07-30;3824;2845;280179;228519;65.2;53.2
28;2021-07-31;763;822;280942;229341;65.4;53.4
28;2021-08-01;378;65;281320;229406;65.5;53.4
28;2021-08-02;1793;1520;283113;230926;65.9;53.8
28;2021-08-03;2684;2166;285797;233092;66.6;54.3
28;2021-08-04;1932;2300;287729;235392;67.0;54.8
28;2021-08-05;1663;1730;289392;237122;67.4;55.2
28;2021-08-06;1618;1969;291010;239091;67.8;55.7
28;2021-08-07;798;1001;291808;240092;68.0;55.9
28;2021-08-08;22;33;291830;240125;68.0;55.9
28;2021-08-09;1388;1102;293218;241227;68.3;56.2
28;2021-08-10;1714;2027;294932;243254;68.7;56.6
28;2021-08-11;1273;1572;296205;244826;69.0;57.0
28;2021-08-12;1165;1881;297370;246707;69.2;57.5
28;2021-08-13;1321;1649;298691;248356;69.6;57.8
28;2021-08-14;659;844;299350;249200;69.7;58.0
28;2021-08-15;264;59;299614;249259;69.8;58.0
28;2021-08-16;862;2145;300476;251404;70.0;58.5
28;2021-08-17;1126;2798;301602;254202;70.2;59.2
28;2021-08-18;891;2412;302493;256614;70.4;59.8
28;2021-08-19;889;2616;303382;259230;70.6;60.4
28;2021-08-20;939;2753;304321;261983;70.9;61.0
28;2021-08-21;381;1001;304702;262984;71.0;61.2
28;2021-08-22;9;31;304711;263015;71.0;61.2
28;2021-08-23;1041;2148;305752;265163;71.2;61.7
28;2021-08-24;867;2582;306619;267745;71.4;62.3
28;2021-08-25;1075;2208;307694;269953;71.7;62.9
28;2021-08-26;701;1817;308395;271770;71.8;63.3
28;2021-08-27;749;2368;309144;274138;72.0;63.8
28;2021-08-28;524;1097;309668;275235;72.1;64.1
28;2021-08-29;7;23;309675;275258;72.1;64.1
28;2021-08-30;994;2184;310669;277442;72.3;64.6
28;2021-08-31;798;2248;311467;279690;72.5;65.1
28;2021-09-01;748;2603;312215;282293;72.7;65.7
28;2021-09-02;542;2112;312757;284405;72.8;66.2
28;2021-09-03;664;2563;313421;286968;73.0;66.8
28;2021-09-04;584;2603;314005;289571;73.1;67.4
28;2021-09-05;210;247;314215;289818;73.2;67.5
28;2021-09-06;404;1619;314619;291437;73.3;67.9
28;2021-09-07;352;1452;314971;292889;73.3;68.2
28;2021-09-08;544;1588;315515;294477;73.5;68.6
28;2021-09-09;318;1143;315833;295620;73.5;68.8
28;2021-09-10;588;1659;316421;297279;73.7;69.2
28;2021-09-11;298;1329;316719;298608;73.8;69.5
28;2021-09-12;39;32;316758;298640;73.8;69.5
28;2021-09-13;312;1032;317070;299672;73.8;69.8
28;2021-09-14;321;1271;317391;300943;73.9;70.1
28;2021-09-15;525;1023;317916;301966;74.0;70.3
28;2021-09-16;247;687;318163;302653;74.1;70.5
28;2021-09-17;301;1046;318464;303699;74.2;70.7
28;2021-09-18;124;237;318588;303936;74.2;70.8
28;2021-09-19;7;17;318595;303953;74.2;70.8
28;2021-09-20;154;458;318749;304411;74.2;70.9
28;2021-09-21;392;934;319141;305345;74.3;71.1
28;2021-09-22;328;1067;319469;306412;74.4;71.4
28;2021-09-23;190;507;319659;306919;74.4;71.5
28;2021-09-24;255;969;319914;307888;74.5;71.7
28;2021-09-25;98;326;320012;308214;74.5;71.8
28;2021-09-26;21;34;320033;308248;74.5;71.8
28;2021-09-27;167;665;320200;308913;74.6;71.9
28;2021-09-28;172;440;320372;309353;74.6;72.0
28;2021-09-29;348;687;320720;310040;74.7;72.2
28;2021-09-30;233;451;320953;310491;74.7;72.3
28;2021-10-01;235;724;321188;311215;74.8;72.5
28;2021-10-02;75;151;321263;311366;74.8;72.5
28;2021-10-03;0;6;321263;311372;74.8;72.5
29;2020-12-27;0;0;0;0;0.0;0.0
29;2020-12-28;1;0;1;0;0.0;0.0
29;2020-12-29;0;0;1;0;0.0;0.0
29;2020-12-30;0;0;1;0;0.0;0.0
29;2020-12-31;0;0;1;0;0.0;0.0
29;2021-01-01;3;0;4;0;0.0;0.0
29;2021-01-02;0;0;4;0;0.0;0.0
29;2021-01-03;1;0;5;0;0.0;0.0
29;2021-01-04;33;0;38;0;0.0;0.0
29;2021-01-05;32;0;70;0;0.0;0.0
29;2021-01-06;43;0;113;0;0.0;0.0
29;2021-01-07;139;0;252;0;0.0;0.0
29;2021-01-08;408;0;660;0;0.1;0.0
29;2021-01-09;2;0;662;0;0.1;0.0
29;2021-01-10;2;0;664;0;0.1;0.0
29;2021-01-11;667;0;1331;0;0.1;0.0
29;2021-01-12;1121;0;2452;0;0.3;0.0
29;2021-01-13;1101;1;3553;1;0.4;0.0
29;2021-01-14;893;4;4446;5;0.5;0.0
29;2021-01-15;1221;6;5667;11;0.6;0.0
29;2021-01-16;168;1;5835;12;0.6;0.0
29;2021-01-17;111;1;5946;13;0.7;0.0
29;2021-01-18;842;3;6788;16;0.7;0.0
29;2021-01-19;1314;1;8102;17;0.9;0.0
29;2021-01-20;2393;2;10495;19;1.2;0.0
29;2021-01-21;5660;8;16155;27;1.8;0.0
29;2021-01-22;3784;4;19939;31;2.2;0.0
29;2021-01-23;538;0;20477;31;2.3;0.0
29;2021-01-24;200;1;20677;32;2.3;0.0
29;2021-01-25;574;7;21251;39;2.3;0.0
29;2021-01-26;951;34;22202;73;2.4;0.0
29;2021-01-27;1286;51;23488;124;2.6;0.0
29;2021-01-28;803;134;24291;258;2.7;0.0
29;2021-01-29;779;195;25070;453;2.8;0.0
29;2021-01-30;281;4;25351;457;2.8;0.1
29;2021-01-31;80;5;25431;462;2.8;0.1
29;2021-02-01;429;370;25860;832;2.9;0.1
29;2021-02-02;879;661;26739;1493;2.9;0.2
29;2021-02-03;810;807;27549;2300;3.0;0.3
29;2021-02-04;869;603;28418;2903;3.1;0.3
29;2021-02-05;676;569;29094;3472;3.2;0.4
29;2021-02-06;249;86;29343;3558;3.2;0.4
29;2021-02-07;78;91;29421;3649;3.2;0.4
29;2021-02-08;384;420;29805;4069;3.3;0.4
29;2021-02-09;864;813;30669;4882;3.4;0.5
29;2021-02-10;1150;945;31819;5827;3.5;0.6
29;2021-02-11;1797;3851;33616;9678;3.7;1.1
29;2021-02-12;2326;2428;35942;12106;4.0;1.3
29;2021-02-13;639;388;36581;12494;4.0;1.4
29;2021-02-14;12;201;36593;12695;4.0;1.4
29;2021-02-15;267;763;36860;13458;4.1;1.5
29;2021-02-16;887;869;37747;14327;4.2;1.6
29;2021-02-17;800;648;38547;14975;4.3;1.7
29;2021-02-18;1530;696;40077;15671;4.4;1.7
29;2021-02-19;1417;798;41494;16469;4.6;1.8
29;2021-02-20;204;268;41698;16737;4.6;1.8
29;2021-02-21;163;139;41861;16876;4.6;1.9
29;2021-02-22;773;441;42634;17317;4.7;1.9
29;2021-02-23;1270;704;43904;18021;4.8;2.0
29;2021-02-24;1473;629;45377;18650;5.0;2.1
29;2021-02-25;2511;695;47888;19345;5.3;2.1
29;2021-02-26;2678;557;50566;19902;5.6;2.2
29;2021-02-27;1285;209;51851;20111;5.7;2.2
29;2021-02-28;200;56;52051;20167;5.7;2.2
29;2021-03-01;946;375;52997;20542;5.8;2.3
29;2021-03-02;1815;651;54812;21193;6.0;2.3
29;2021-03-03;2094;857;56906;22050;6.3;2.4
29;2021-03-04;2842;1400;59748;23450;6.6;2.6
29;2021-03-05;3539;1537;63287;24987;7.0;2.8
29;2021-03-06;2000;397;65287;25384;7.2;2.8
29;2021-03-07;412;73;65699;25457;7.2;2.8
29;2021-03-08;1273;519;66972;25976;7.4;2.9
29;2021-03-09;2603;866;69575;26842;7.7;3.0
29;2021-03-10;2426;777;72001;27619;7.9;3.0
29;2021-03-11;4520;906;76521;28525;8.4;3.1
29;2021-03-12;5272;893;81793;29418;9.0;3.2
29;2021-03-13;2825;384;84618;29802;9.3;3.3
29;2021-03-14;367;3;84985;29805;9.4;3.3
29;2021-03-15;2050;266;87035;30071;9.6;3.3
29;2021-03-16;1825;727;88860;30798;9.8;3.4
29;2021-03-17;1862;692;90722;31490;10.0;3.5
29;2021-03-18;1866;1019;92588;32509;10.2;3.6
29;2021-03-19;3270;870;95858;33379;10.6;3.7
29;2021-03-20;1914;214;97772;33593;10.8;3.7
29;2021-03-21;132;11;97904;33604;10.8;3.7
29;2021-03-22;1647;550;99551;34154;11.0;3.8
29;2021-03-23;3442;1028;102993;35182;11.4;3.9
29;2021-03-24;3781;1017;106774;36199;11.8;4.0
29;2021-03-25;4822;1061;111596;37260;12.3;4.1
29;2021-03-26;5423;1157;117019;38417;12.9;4.2
29;2021-03-27;2429;330;119448;38747;13.2;4.3
29;2021-03-28;198;50;119646;38797;13.2;4.3
29;2021-03-29;2042;813;121688;39610;13.4;4.4
29;2021-03-30;3977;1325;125665;40935;13.9;4.5
29;2021-03-31;3937;1152;129602;42087;14.3;4.6
29;2021-04-01;5029;1139;134631;43226;14.9;4.8
29;2021-04-02;4765;1167;139396;44393;15.4;4.9
29;2021-04-03;2500;535;141896;44928;15.7;5.0
29;2021-04-04;146;33;142042;44961;15.7;5.0
29;2021-04-05;972;331;143014;45292;15.8;5.0
29;2021-04-06;3200;1234;146214;46526;16.1;5.1
29;2021-04-07;3653;941;149867;47467;16.5;5.2
29;2021-04-08;5285;2053;155152;49520;17.1;5.5
29;2021-04-09;6759;1562;161911;51082;17.9;5.6
29;2021-04-10;3503;710;165414;51792;18.2;5.7
29;2021-04-11;120;80;165534;51872;18.3;5.7
29;2021-04-12;3853;1480;169387;53352;18.7;5.9
29;2021-04-13;5865;1753;175252;55105;19.3;6.1
29;2021-04-14;4759;1742;180011;56847;19.9;6.3
29;2021-04-15;7174;1730;187185;58577;20.6;6.5
29;2021-04-16;6703;1353;193888;59930;21.4;6.6
29;2021-04-17;3829;968;197717;60898;21.8;6.7
29;2021-04-18;489;40;198206;60938;21.9;6.7
29;2021-04-19;3881;1464;202087;62402;22.3;6.9
29;2021-04-20;4397;2135;206484;64537;22.8;7.1
29;2021-04-21;4378;2195;210862;66732;23.3;7.4
29;2021-04-22;6638;2848;217500;69580;24.0;7.7
29;2021-04-23;6049;2195;223549;71775;24.7;7.9
29;2021-04-24;4008;1310;227557;73085;25.1;8.1
29;2021-04-25;435;169;227992;73254;25.1;8.1
29;2021-04-26;5260;1859;233252;75113;25.7;8.3
29;2021-04-27;5335;3176;238587;78289;26.3;8.6
29;2021-04-28;5359;2890;243946;81179;26.9;9.0
29;2021-04-29;6593;3303;250539;84482;27.6;9.3
29;2021-04-30;6265;3848;256804;88330;28.3;9.7
29;2021-05-01;1986;978;258790;89308;28.5;9.9
29;2021-05-02;1249;192;260039;89500;28.7;9.9
29;2021-05-03;4540;2278;264579;91778;29.2;10.1
29;2021-05-04;4108;3727;268687;95505;29.6;10.5
29;2021-05-05;4520;3401;273207;98906;30.1;10.9
29;2021-05-06;6240;3713;279447;102619;30.8;11.3
29;2021-05-07;5985;4562;285432;107181;31.5;11.8
29;2021-05-08;2097;561;287529;107742;31.7;11.9
29;2021-05-09;1731;136;289260;107878;31.9;11.9
29;2021-05-10;4760;3751;294020;111629;32.4;12.3
29;2021-05-11;4709;4965;298729;116594;33.0;12.9
29;2021-05-12;5023;4358;303752;120952;33.5;13.3
29;2021-05-13;3441;1498;307193;122450;33.9;13.5
29;2021-05-14;5649;3980;312842;126430;34.5;13.9
29;2021-05-15;4048;2294;316890;128724;35.0;14.2
29;2021-05-16;1588;294;318478;129018;35.1;14.2
29;2021-05-17;5562;3120;324040;132138;35.7;14.6
29;2021-05-18;5732;3070;329772;135208;36.4;14.9
29;2021-05-19;6214;2956;335986;138164;37.1;15.2
29;2021-05-20;7173;4546;343159;142710;37.9;15.7
29;2021-05-21;7212;3797;350371;146507;38.6;16.2
29;2021-05-22;5342;2123;355713;148630;39.2;16.4
29;2021-05-23;1631;65;357344;148695;39.4;16.4
29;2021-05-24;3485;534;360829;149229;39.8;16.5
29;2021-05-25;5835;3027;366664;152256;40.4;16.8
29;2021-05-26;5889;2987;372553;155243;41.1;17.1
29;2021-05-27;6824;3951;379377;159194;41.8;17.6
29;2021-05-28;6544;4389;385921;163583;42.6;18.0
29;2021-05-29;4382;2797;390303;166380;43.1;18.4
29;2021-05-30;1113;360;391416;166740;43.2;18.4
29;2021-05-31;6384;3434;397800;170174;43.9;18.8
29;2021-06-01;6603;4311;404403;174485;44.6;19.2
29;2021-06-02;6162;4125;410565;178610;45.3;19.7
29;2021-06-03;7689;4495;418254;183105;46.1;20.2
29;2021-06-04;6812;6135;425066;189240;46.9;20.9
29;2021-06-05;5350;3023;430416;192263;47.5;21.2
29;2021-06-06;1284;538;431700;192801;47.6;21.3
29;2021-06-07;4658;5562;436358;198363;48.1;21.9
29;2021-06-08;7173;5187;443531;203550;48.9;22.5
29;2021-06-09;6403;4743;449934;208293;49.6;23.0
29;2021-06-10;7775;5046;457709;213339;50.5;23.5
29;2021-06-11;8473;5860;466182;219199;51.4;24.2
29;2021-06-12;6562;2812;472744;222011;52.1;24.5
29;2021-06-13;2351;1370;475095;223381;52.4;24.6
29;2021-06-14;4034;6306;479129;229687;52.9;25.3
29;2021-06-15;5477;6181;484606;235868;53.5;26.0
29;2021-06-16;5571;5622;490177;241490;54.1;26.6
29;2021-06-17;6369;6309;496546;247799;54.8;27.3
29;2021-06-18;6116;7486;502662;255285;55.4;28.2
29;2021-06-19;4619;3522;507281;258807;56.0;28.5
29;2021-06-20;891;1452;508172;260259;56.1;28.7
29;2021-06-21;3761;6492;511933;266751;56.5;29.4
29;2021-06-22;4490;6421;516423;273172;57.0;30.1
29;2021-06-23;4673;6128;521096;279300;57.5;30.8
29;2021-06-24;4810;6744;525906;286044;58.0;31.6
29;2021-06-25;3598;7530;529504;293574;58.4;32.4
29;2021-06-26;2131;4093;531635;297667;58.6;32.8
29;2021-06-27;967;1631;532602;299298;58.8;33.0
29;2021-06-28;2844;6862;535446;306160;59.1;33.8
29;2021-06-29;2813;7723;538259;313883;59.4;34.6
29;2021-06-30;3048;7505;541307;321388;59.7;35.5
29;2021-07-01;3790;8420;545097;329808;60.1;36.4
29;2021-07-02;3607;9650;548704;339458;60.5;37.4
29;2021-07-03;2327;6050;551031;345508;60.8;38.1
29;2021-07-04;814;1771;551845;347279;60.9;38.3
29;2021-07-05;1914;7154;553759;354433;61.1;39.1
29;2021-07-06;1542;8004;555301;362437;61.3;40.0
29;2021-07-07;1706;7035;557007;369472;61.4;40.8
29;2021-07-08;2454;8200;559461;377672;61.7;41.7
29;2021-07-09;2628;9062;562089;386734;62.0;42.7
29;2021-07-10;1917;6102;564006;392836;62.2;43.3
29;2021-07-11;449;1064;564455;393900;62.3;43.5
29;2021-07-12;1983;8376;566438;402276;62.5;44.4
29;2021-07-13;2754;8660;569192;410936;62.8;45.3
29;2021-07-14;2086;3372;571278;414308;63.0;45.7
29;2021-07-15;3858;9723;575136;424031;63.4;46.8
29;2021-07-16;4619;9186;579755;433217;64.0;47.8
29;2021-07-17;3223;6109;582978;439326;64.3;48.5
29;2021-07-18;668;1079;583646;440405;64.4;48.6
29;2021-07-19;3157;7541;586803;447946;64.7;49.4
29;2021-07-20;3556;9432;590359;457378;65.1;50.5
29;2021-07-21;3664;7706;594023;465084;65.5;51.3
29;2021-07-22;3428;8532;597451;473616;65.9;52.2
29;2021-07-23;4066;10700;601517;484316;66.4;53.4
29;2021-07-24;2536;5956;604053;490272;66.6;54.1
29;2021-07-25;655;2359;604708;492631;66.7;54.3
29;2021-07-26;3400;7278;608108;499909;67.1;55.1
29;2021-07-27;3721;7110;611829;507019;67.5;55.9
29;2021-07-28;4207;6031;616036;513050;68.0;56.6
29;2021-07-29;5705;6361;621741;519411;68.6;57.3
29;2021-07-30;5471;6536;627212;525947;69.2;58.0
29;2021-07-31;2938;4931;630150;530878;69.5;58.6
29;2021-08-01;658;921;630808;531799;69.6;58.7
29;2021-08-02;4308;5213;635116;537012;70.1;59.2
29;2021-08-03;5490;4406;640606;541418;70.7;59.7
29;2021-08-04;5743;3609;646349;545027;71.3;60.1
29;2021-08-05;6656;4110;653005;549137;72.0;60.6
29;2021-08-06;6215;4334;659220;553471;72.7;61.1
29;2021-08-07;4294;2953;663514;556424;73.2;61.4
29;2021-08-08;854;754;664368;557178;73.3;61.5
29;2021-08-09;3085;4739;667453;561917;73.6;62.0
29;2021-08-10;4495;3865;671948;565782;74.1;62.4
29;2021-08-11;3975;3189;675923;568971;74.6;62.8
29;2021-08-12;4650;4499;680573;573470;75.1;63.3
29;2021-08-13;4239;3718;684812;577188;75.5;63.7
29;2021-08-14;2968;2845;687780;580033;75.9;64.0
29;2021-08-15;338;405;688118;580438;75.9;64.0
29;2021-08-16;3288;4375;691406;584813;76.3;64.5
29;2021-08-17;4411;3419;695817;588232;76.8;64.9
29;2021-08-18;3683;3620;699500;591852;77.2;65.3
29;2021-08-19;3915;4719;703415;596571;77.6;65.8
29;2021-08-20;3512;4599;706927;601170;78.0;66.3
29;2021-08-21;2277;3164;709204;604334;78.2;66.7
29;2021-08-22;217;415;709421;604749;78.3;66.7
29;2021-08-23;2503;4627;711924;609376;78.5;67.2
29;2021-08-24;2469;4953;714393;614329;78.8;67.8
29;2021-08-25;2170;4230;716563;618559;79.0;68.2
29;2021-08-26;2359;5340;718922;623899;79.3;68.8
29;2021-08-27;2066;5914;720988;629813;79.5;69.5
29;2021-08-28;1474;4001;722462;633814;79.7;69.9
29;2021-08-29;453;1318;722915;635132;79.7;70.1
29;2021-08-30;1458;4232;724373;639364;79.9;70.5
29;2021-08-31;1628;4536;726001;643900;80.1;71.0
29;2021-09-01;1342;4005;727343;647905;80.2;71.5
29;2021-09-02;1176;4426;728519;652331;80.4;72.0
29;2021-09-03;1437;5291;729956;657622;80.5;72.5
29;2021-09-04;1419;4064;731375;661686;80.7;73.0
29;2021-09-05;227;741;731602;662427;80.7;73.1
29;2021-09-06;740;3761;732342;666188;80.8;73.5
29;2021-09-07;927;4019;733269;670207;80.9;73.9
29;2021-09-08;911;3904;734180;674111;81.0;74.4
29;2021-09-09;956;3922;735136;678033;81.1;74.8
29;2021-09-10;1196;5081;736332;683114;81.2;75.4
29;2021-09-11;732;3667;737064;686781;81.3;75.8
29;2021-09-12;116;443;737180;687224;81.3;75.8
29;2021-09-13;835;3942;738015;691166;81.4;76.2
29;2021-09-14;718;3915;738733;695081;81.5;76.7
29;2021-09-15;715;3225;739448;698306;81.6;77.0
29;2021-09-16;838;2790;740286;701096;81.7;77.3
29;2021-09-17;923;3243;741209;704339;81.8;77.7
29;2021-09-18;596;3449;741805;707788;81.8;78.1
29;2021-09-19;84;443;741889;708231;81.8;78.1
29;2021-09-20;490;2169;742379;710400;81.9;78.4
29;2021-09-21;474;1917;742853;712317;81.9;78.6
29;2021-09-22;365;2241;743218;714558;82.0;78.8
29;2021-09-23;463;1753;743681;716311;82.0;79.0
29;2021-09-24;483;2231;744164;718542;82.1;79.3
29;2021-09-25;340;2732;744504;721274;82.1;79.6
29;2021-09-26;56;239;744560;721513;82.1;79.6
29;2021-09-27;328;1638;744888;723151;82.2;79.8
29;2021-09-28;258;1567;745146;724718;82.2;79.9
29;2021-09-29;397;1677;745543;726395;82.2;80.1
29;2021-09-30;317;1327;745860;727722;82.3;80.3
29;2021-10-01;459;1536;746319;729258;82.3;80.4
29;2021-10-02;358;1673;746677;730931;82.4;80.6
29;2021-10-03;6;30;746683;730961;82.4;80.6
2A;2020-12-27;0;0;0;0;0.0;0.0
2A;2020-12-28;0;0;0;0;0.0;0.0
2A;2020-12-29;0;0;0;0;0.0;0.0
2A;2020-12-30;0;0;0;0;0.0;0.0
2A;2020-12-31;0;0;0;0;0.0;0.0
2A;2021-01-01;0;0;0;0;0.0;0.0
2A;2021-01-02;1;0;1;0;0.0;0.0
2A;2021-01-03;0;0;1;0;0.0;0.0
2A;2021-01-04;0;0;1;0;0.0;0.0
2A;2021-01-05;0;0;1;0;0.0;0.0
2A;2021-01-06;6;0;7;0;0.0;0.0
2A;2021-01-07;122;1;129;1;0.1;0.0
2A;2021-01-08;114;0;243;1;0.1;0.0
2A;2021-01-09;39;0;282;1;0.2;0.0
2A;2021-01-10;33;0;315;1;0.2;0.0
2A;2021-01-11;78;0;393;1;0.2;0.0
2A;2021-01-12;85;0;478;1;0.3;0.0
2A;2021-01-13;113;0;591;1;0.4;0.0
2A;2021-01-14;191;1;782;2;0.5;0.0
2A;2021-01-15;149;0;931;2;0.6;0.0
2A;2021-01-16;160;1;1091;3;0.7;0.0
2A;2021-01-17;86;1;1177;4;0.7;0.0
2A;2021-01-18;201;2;1378;6;0.8;0.0
2A;2021-01-19;488;1;1866;7;1.1;0.0
2A;2021-01-20;356;0;2222;7;1.4;0.0
2A;2021-01-21;453;1;2675;8;1.6;0.0
2A;2021-01-22;367;0;3042;8;1.9;0.0
2A;2021-01-23;183;0;3225;8;2.0;0.0
2A;2021-01-24;118;1;3343;9;2.1;0.0
2A;2021-01-25;215;0;3558;9;2.2;0.0
2A;2021-01-26;402;7;3960;16;2.4;0.0
2A;2021-01-27;325;5;4285;21;2.6;0.0
2A;2021-01-28;335;73;4620;94;2.8;0.1
2A;2021-01-29;342;59;4962;153;3.1;0.1
2A;2021-01-30;128;34;5090;187;3.1;0.1
2A;2021-01-31;92;11;5182;198;3.2;0.1
2A;2021-02-01;230;42;5412;240;3.3;0.1
2A;2021-02-02;288;107;5700;347;3.5;0.2
2A;2021-02-03;265;72;5965;419;3.7;0.3
2A;2021-02-04;256;113;6221;532;3.8;0.3
2A;2021-02-05;267;95;6488;627;4.0;0.4
2A;2021-02-06;121;54;6609;681;4.1;0.4
2A;2021-02-07;68;39;6677;720;4.1;0.4
2A;2021-02-08;92;169;6769;889;4.2;0.5
2A;2021-02-09;128;263;6897;1152;4.2;0.7
2A;2021-02-10;167;208;7064;1360;4.3;0.8
2A;2021-02-11;299;308;7363;1668;4.5;1.0
2A;2021-02-12;345;240;7708;1908;4.7;1.2
2A;2021-02-13;225;49;7933;1957;4.9;1.2
2A;2021-02-14;135;58;8068;2015;5.0;1.2
2A;2021-02-15;198;152;8266;2167;5.1;1.3
2A;2021-02-16;384;265;8650;2432;5.3;1.5
2A;2021-02-17;297;151;8947;2583;5.5;1.6
2A;2021-02-18;340;164;9287;2747;5.7;1.7
2A;2021-02-19;145;251;9432;2998;5.8;1.8
2A;2021-02-20;243;104;9675;3102;6.0;1.9
2A;2021-02-21;58;42;9733;3144;6.0;1.9
2A;2021-02-22;77;193;9810;3337;6.0;2.1
2A;2021-02-23;122;238;9932;3575;6.1;2.2
2A;2021-02-24;82;244;10014;3819;6.2;2.4
2A;2021-02-25;104;210;10118;4029;6.2;2.5
2A;2021-02-26;123;216;10241;4245;6.3;2.6
2A;2021-02-27;308;52;10549;4297;6.5;2.6
2A;2021-02-28;69;55;10618;4352;6.5;2.7
2A;2021-03-01;117;129;10735;4481;6.6;2.8
2A;2021-03-02;199;237;10934;4718;6.7;2.9
2A;2021-03-03;249;236;11183;4954;6.9;3.1
2A;2021-03-04;508;205;11691;5159;7.2;3.2
2A;2021-03-05;973;260;12664;5419;7.8;3.3
2A;2021-03-06;1167;73;13831;5492;8.5;3.4
2A;2021-03-07;1021;43;14852;5535;9.1;3.4
2A;2021-03-08;933;80;15785;5615;9.7;3.5
2A;2021-03-09;938;140;16723;5755;10.3;3.5
2A;2021-03-10;634;135;17357;5890;10.7;3.6
2A;2021-03-11;723;258;18080;6148;11.1;3.8
2A;2021-03-12;561;310;18641;6458;11.5;4.0
2A;2021-03-13;613;189;19254;6647;11.9;4.1
2A;2021-03-14;312;125;19566;6772;12.0;4.2
2A;2021-03-15;377;197;19943;6969;12.3;4.3
2A;2021-03-16;498;366;20441;7335;12.6;4.5
2A;2021-03-17;703;267;21144;7602;13.0;4.7
2A;2021-03-18;447;299;21591;7901;13.3;4.9
2A;2021-03-19;489;152;22080;8053;13.6;5.0
2A;2021-03-20;1079;258;23159;8311;14.3;5.1
2A;2021-03-21;695;53;23854;8364;14.7;5.1
2A;2021-03-22;347;65;24201;8429;14.9;5.2
2A;2021-03-23;518;56;24719;8485;15.2;5.2
2A;2021-03-24;864;92;25583;8577;15.8;5.3
2A;2021-03-25;930;140;26513;8717;16.3;5.4
2A;2021-03-26;1080;164;27593;8881;17.0;5.5
2A;2021-03-27;1189;199;28782;9080;17.7;5.6
2A;2021-03-28;241;95;29023;9175;17.9;5.6
2A;2021-03-29;283;138;29306;9313;18.0;5.7
2A;2021-03-30;383;233;29689;9546;18.3;5.9
2A;2021-03-31;445;224;30134;9770;18.6;6.0
2A;2021-04-01;638;451;30772;10221;18.9;6.3
2A;2021-04-02;903;780;31675;11001;19.5;6.8
2A;2021-04-03;646;981;32321;11982;19.9;7.4
2A;2021-04-04;578;783;32899;12765;20.3;7.9
2A;2021-04-05;525;691;33424;13456;20.6;8.3
2A;2021-04-06;548;559;33972;14015;20.9;8.6
2A;2021-04-07;795;428;34767;14443;21.4;8.9
2A;2021-04-08;1047;358;35814;14801;22.1;9.1
2A;2021-04-09;934;389;36748;15190;22.6;9.4
2A;2021-04-10;1058;382;37806;15572;23.3;9.6
2A;2021-04-11;362;256;38168;15828;23.5;9.7
2A;2021-04-12;669;339;38837;16167;23.9;10.0
2A;2021-04-13;329;378;39166;16545;24.1;10.2
2A;2021-04-14;1045;587;40211;17132;24.8;10.5
2A;2021-04-15;1044;524;41255;17656;25.4;10.9
2A;2021-04-16;872;392;42127;18048;25.9;11.1
2A;2021-04-17;1369;934;43496;18982;26.8;11.7
2A;2021-04-18;981;948;44477;19930;27.4;12.3
2A;2021-04-19;270;343;44747;20273;27.6;12.5
2A;2021-04-20;354;344;45101;20617;27.8;12.7
2A;2021-04-21;729;734;45830;21351;28.2;13.1
2A;2021-04-22;897;646;46727;21997;28.8;13.5
2A;2021-04-23;986;776;47713;22773;29.4;14.0
2A;2021-04-24;1750;984;49463;23757;30.5;14.6
2A;2021-04-25;976;306;50439;24063;31.1;14.8
2A;2021-04-26;308;226;50747;24289;31.2;15.0
2A;2021-04-27;343;347;51090;24636;31.5;15.2
2A;2021-04-28;1676;424;52766;25060;32.5;15.4
2A;2021-04-29;1053;361;53819;25421;33.1;15.7
2A;2021-04-30;1131;1062;54950;26483;33.8;16.3
2A;2021-05-01;970;575;55920;27058;34.4;16.7
2A;2021-05-02;674;708;56594;27766;34.8;17.1
2A;2021-05-03;583;575;57177;28341;35.2;17.4
2A;2021-05-04;752;535;57929;28876;35.7;17.8
2A;2021-05-05;1011;983;58940;29859;36.3;18.4
2A;2021-05-06;904;911;59844;30770;36.8;18.9
2A;2021-05-07;1156;834;61000;31604;37.6;19.5
2A;2021-05-08;422;501;61422;32105;37.8;19.8
2A;2021-05-09;783;636;62205;32741;38.3;20.2
2A;2021-05-10;454;741;62659;33482;38.6;20.6
2A;2021-05-11;652;417;63311;33899;39.0;20.9
2A;2021-05-12;925;488;64236;34387;39.5;21.2
2A;2021-05-13;920;138;65156;34525;40.1;21.3
2A;2021-05-14;797;678;65953;35203;40.6;21.7
2A;2021-05-15;778;649;66731;35852;41.1;22.1
2A;2021-05-16;740;500;67471;36352;41.5;22.4
2A;2021-05-17;584;557;68055;36909;41.9;22.7
2A;2021-05-18;614;475;68669;37384;42.3;23.0
2A;2021-05-19;787;481;69456;37865;42.8;23.3
2A;2021-05-20;692;539;70148;38404;43.2;23.6
2A;2021-05-21;536;483;70684;38887;43.5;23.9
2A;2021-05-22;440;310;71124;39197;43.8;24.1
2A;2021-05-23;533;282;71657;39479;44.1;24.3
2A;2021-05-24;125;33;71782;39512;44.2;24.3
2A;2021-05-25;421;503;72203;40015;44.5;24.6
2A;2021-05-26;425;1166;72628;41181;44.7;25.4
2A;2021-05-27;435;1111;73063;42292;45.0;26.0
2A;2021-05-28;298;915;73361;43207;45.2;26.6
2A;2021-05-29;334;900;73695;44107;45.4;27.2
2A;2021-05-30;181;507;73876;44614;45.5;27.5
2A;2021-05-31;191;413;74067;45027;45.6;27.7
2A;2021-06-01;342;727;74409;45754;45.8;28.2
2A;2021-06-02;285;940;74694;46694;46.0;28.7
2A;2021-06-03;306;850;75000;47544;46.2;29.3
2A;2021-06-04;271;1091;75271;48635;46.3;29.9
2A;2021-06-05;319;1443;75590;50078;46.5;30.8
2A;2021-06-06;173;907;75763;50985;46.6;31.4
2A;2021-06-07;171;658;75934;51643;46.8;31.8
2A;2021-06-08;324;706;76258;52349;47.0;32.2
2A;2021-06-09;304;1320;76562;53669;47.1;33.0
2A;2021-06-10;329;857;76891;54526;47.3;33.6
2A;2021-06-11;277;1019;77168;55545;47.5;34.2
2A;2021-06-12;232;657;77400;56202;47.7;34.6
2A;2021-06-13;189;797;77589;56999;47.8;35.1
2A;2021-06-14;251;922;77840;57921;47.9;35.7
2A;2021-06-15;217;507;78057;58428;48.1;36.0
2A;2021-06-16;213;776;78270;59204;48.2;36.5
2A;2021-06-17;235;591;78505;59795;48.3;36.8
2A;2021-06-18;246;912;78751;60707;48.5;37.4
2A;2021-06-19;208;689;78959;61396;48.6;37.8
2A;2021-06-20;150;692;79109;62088;48.7;38.2
2A;2021-06-21;184;795;79293;62883;48.8;38.7
2A;2021-06-22;236;841;79529;63724;49.0;39.2
2A;2021-06-23;217;568;79746;64292;49.1;39.6
2A;2021-06-24;149;369;79895;64661;49.2;39.8
2A;2021-06-25;167;470;80062;65131;49.3;40.1
2A;2021-06-26;203;872;80265;66003;49.4;40.6
2A;2021-06-27;175;794;80440;66797;49.5;41.1
2A;2021-06-28;194;704;80634;67501;49.6;41.6
2A;2021-06-29;216;689;80850;68190;49.8;42.0
2A;2021-06-30;242;490;81092;68680;49.9;42.3
2A;2021-07-01;211;483;81303;69163;50.1;42.6
2A;2021-07-02;294;368;81597;69531;50.2;42.8
2A;2021-07-03;211;617;81808;70148;50.4;43.2
2A;2021-07-04;179;664;81987;70812;50.5;43.6
2A;2021-07-05;163;235;82150;71047;50.6;43.7
2A;2021-07-06;252;389;82402;71436;50.7;44.0
2A;2021-07-07;433;611;82835;72047;51.0;44.4
2A;2021-07-08;592;705;83427;72752;51.4;44.8
2A;2021-07-09;384;420;83811;73172;51.6;45.1
2A;2021-07-10;281;346;84092;73518;51.8;45.3
2A;2021-07-11;92;151;84184;73669;51.8;45.4
2A;2021-07-12;317;346;84501;74015;52.0;45.6
2A;2021-07-13;1178;534;85679;74549;52.8;45.9
2A;2021-07-14;1623;342;87302;74891;53.8;46.1
2A;2021-07-15;1436;836;88738;75727;54.6;46.6
2A;2021-07-16;1168;463;89906;76190;55.4;46.9
2A;2021-07-17;1096;348;91002;76538;56.0;47.1
2A;2021-07-18;635;135;91637;76673;56.4;47.2
2A;2021-07-19;918;425;92555;77098;57.0;47.5
2A;2021-07-20;1283;469;93838;77567;57.8;47.8
2A;2021-07-21;1426;724;95264;78291;58.7;48.2
2A;2021-07-22;1400;764;96664;79055;59.5;48.7
2A;2021-07-23;1439;463;98103;79518;60.4;49.0
2A;2021-07-24;896;290;98999;79808;61.0;49.1
2A;2021-07-25;451;81;99450;79889;61.2;49.2
2A;2021-07-26;1198;507;100648;80396;62.0;49.5
2A;2021-07-27;1297;513;101945;80909;62.8;49.8
2A;2021-07-28;1199;593;103144;81502;63.5;50.2
2A;2021-07-29;1230;656;104374;82158;64.3;50.6
2A;2021-07-30;961;609;105335;82767;64.9;51.0
2A;2021-07-31;548;340;105883;83107;65.2;51.2
2A;2021-08-01;570;124;106453;83231;65.5;51.2
2A;2021-08-02;451;494;106904;83725;65.8;51.5
2A;2021-08-03;814;881;107718;84606;66.3;52.1
2A;2021-08-04;724;1161;108442;85767;66.8;52.8
2A;2021-08-05;956;1348;109398;87115;67.4;53.6
2A;2021-08-06;390;814;109788;87929;67.6;54.1
2A;2021-08-07;352;888;110140;88817;67.8;54.7
2A;2021-08-08;78;185;110218;89002;67.9;54.8
2A;2021-08-09;663;1142;110881;90144;68.3;55.5
2A;2021-08-10;642;1209;111523;91353;68.7;56.2
2A;2021-08-11;593;1064;112116;92417;69.0;56.9
2A;2021-08-12;742;1491;112858;93908;69.5;57.8
2A;2021-08-13;485;1066;113343;94974;69.8;58.5
2A;2021-08-14;414;766;113757;95740;70.0;58.9
2A;2021-08-15;27;26;113784;95766;70.1;59.0
2A;2021-08-16;482;1292;114266;97058;70.4;59.8
2A;2021-08-17;940;1556;115206;98614;70.9;60.7
2A;2021-08-18;525;1123;115731;99737;71.3;61.4
2A;2021-08-19;431;1010;116162;100747;71.5;62.0
2A;2021-08-20;328;574;116490;101321;71.7;62.4
2A;2021-08-21;240;535;116730;101856;71.9;62.7
2A;2021-08-22;197;617;116927;102473;72.0;63.1
2A;2021-08-23;325;744;117252;103217;72.2;63.5
2A;2021-08-24;326;858;117578;104075;72.4;64.1
2A;2021-08-25;401;881;117979;104956;72.6;64.6
2A;2021-08-26;343;768;118322;105724;72.8;65.1
2A;2021-08-27;244;714;118566;106438;73.0;65.5
2A;2021-08-28;256;352;118822;106790;73.2;65.7
2A;2021-08-29;97;115;118919;106905;73.2;65.8
2A;2021-08-30;244;652;119163;107557;73.4;66.2
2A;2021-08-31;172;520;119335;108077;73.5;66.5
2A;2021-09-01;343;837;119678;108914;73.7;67.1
2A;2021-09-02;315;734;119993;109648;73.9;67.5
2A;2021-09-03;242;633;120235;110281;74.0;67.9
2A;2021-09-04;147;453;120382;110734;74.1;68.2
2A;2021-09-05;29;32;120411;110766;74.1;68.2
2A;2021-09-06;111;425;120522;111191;74.2;68.5
2A;2021-09-07;191;793;120713;111984;74.3;68.9
2A;2021-09-08;221;794;120934;112778;74.5;69.4
2A;2021-09-09;201;592;121135;113370;74.6;69.8
2A;2021-09-10;155;465;121290;113835;74.7;70.1
2A;2021-09-11;135;345;121425;114180;74.8;70.3
2A;2021-09-12;41;143;121466;114323;74.8;70.4
2A;2021-09-13;101;227;121567;114550;74.8;70.5
2A;2021-09-14;221;430;121788;114980;75.0;70.8
2A;2021-09-15;191;541;121979;115521;75.1;71.1
2A;2021-09-16;214;363;122193;115884;75.2;71.3
2A;2021-09-17;133;176;122326;116060;75.3;71.5
2A;2021-09-18;104;302;122430;116362;75.4;71.6
2A;2021-09-19;10;49;122440;116411;75.4;71.7
2A;2021-09-20;37;130;122477;116541;75.4;71.8
2A;2021-09-21;89;246;122566;116787;75.5;71.9
2A;2021-09-22;99;448;122665;117235;75.5;72.2
2A;2021-09-23;89;324;122754;117559;75.6;72.4
2A;2021-09-24;59;258;122813;117817;75.6;72.5
2A;2021-09-25;63;143;122876;117960;75.7;72.6
2A;2021-09-26;10;29;122886;117989;75.7;72.6
2A;2021-09-27;43;104;122929;118093;75.7;72.7
2A;2021-09-28;102;172;123031;118265;75.7;72.8
2A;2021-09-29;107;297;123138;118562;75.8;73.0
2A;2021-09-30;73;209;123211;118771;75.9;73.1
2A;2021-10-01;81;118;123292;118889;75.9;73.2
2A;2021-10-02;78;136;123370;119025;76.0;73.3
2A;2021-10-03;18;33;123388;119058;76.0;73.3
2B;2020-12-27;0;0;0;0;0.0;0.0
2B;2020-12-28;0;0;0;0;0.0;0.0
2B;2020-12-29;0;0;0;0;0.0;0.0
2B;2020-12-30;0;0;0;0;0.0;0.0
2B;2020-12-31;0;0;0;0;0.0;0.0
2B;2021-01-01;0;0;0;0;0.0;0.0
2B;2021-01-02;0;0;0;0;0.0;0.0
2B;2021-01-03;0;0;0;0;0.0;0.0
2B;2021-01-04;2;0;2;0;0.0;0.0
2B;2021-01-05;0;0;2;0;0.0;0.0
2B;2021-01-06;48;1;50;1;0.0;0.0
2B;2021-01-07;210;0;260;1;0.1;0.0
2B;2021-01-08;197;2;457;3;0.3;0.0
2B;2021-01-09;40;0;497;3;0.3;0.0
2B;2021-01-10;1;0;498;3;0.3;0.0
2B;2021-01-11;74;0;572;3;0.3;0.0
2B;2021-01-12;128;1;700;4;0.4;0.0
2B;2021-01-13;93;0;793;4;0.4;0.0
2B;2021-01-14;72;0;865;4;0.5;0.0
2B;2021-01-15;259;0;1124;4;0.6;0.0
2B;2021-01-16;44;0;1168;4;0.6;0.0
2B;2021-01-17;8;0;1176;4;0.6;0.0
2B;2021-01-18;271;0;1447;4;0.8;0.0
2B;2021-01-19;505;0;1952;4;1.1;0.0
2B;2021-01-20;462;3;2414;7;1.3;0.0
2B;2021-01-21;358;0;2772;7;1.5;0.0
2B;2021-01-22;381;0;3153;7;1.7;0.0
2B;2021-01-23;61;0;3214;7;1.8;0.0
2B;2021-01-24;29;0;3243;7;1.8;0.0
2B;2021-01-25;210;2;3453;9;1.9;0.0
2B;2021-01-26;392;1;3845;10;2.1;0.0
2B;2021-01-27;341;30;4186;40;2.3;0.0
2B;2021-01-28;365;118;4551;158;2.5;0.1
2B;2021-01-29;296;135;4847;293;2.7;0.2
2B;2021-01-30;80;32;4927;325;2.7;0.2
2B;2021-01-31;60;0;4987;325;2.7;0.2
2B;2021-02-01;233;84;5220;409;2.9;0.2
2B;2021-02-02;358;72;5578;481;3.1;0.3
2B;2021-02-03;520;86;6098;567;3.3;0.3
2B;2021-02-04;458;110;6556;677;3.6;0.4
2B;2021-02-05;394;85;6950;762;3.8;0.4
2B;2021-02-06;87;11;7037;773;3.9;0.4
2B;2021-02-07;60;0;7097;773;3.9;0.4
2B;2021-02-08;231;121;7328;894;4.0;0.5
2B;2021-02-09;586;251;7914;1145;4.3;0.6
2B;2021-02-10;485;161;8399;1306;4.6;0.7
2B;2021-02-11;382;108;8781;1414;4.8;0.8
2B;2021-02-12;299;110;9080;1524;5.0;0.8
2B;2021-02-13;77;10;9157;1534;5.0;0.8
2B;2021-02-14;62;1;9219;1535;5.1;0.8
2B;2021-02-15;190;100;9409;1635;5.2;0.9
2B;2021-02-16;251;217;9660;1852;5.3;1.0
2B;2021-02-17;312;253;9972;2105;5.5;1.2
2B;2021-02-18;215;278;10187;2383;5.6;1.3
2B;2021-02-19;163;267;10350;2650;5.7;1.5
2B;2021-02-20;32;38;10382;2688;5.7;1.5
2B;2021-02-21;28;23;10410;2711;5.7;1.5
2B;2021-02-22;133;154;10543;2865;5.8;1.6
2B;2021-02-23;232;300;10775;3165;5.9;1.7
2B;2021-02-24;229;266;11004;3431;6.0;1.9
2B;2021-02-25;245;280;11249;3711;6.2;2.0
2B;2021-02-26;301;241;11550;3952;6.3;2.2
2B;2021-02-27;60;71;11610;4023;6.4;2.2
2B;2021-02-28;1;44;11611;4067;6.4;2.2
2B;2021-03-01;246;238;11857;4305;6.5;2.4
2B;2021-03-02;352;354;12209;4659;6.7;2.6
2B;2021-03-03;299;395;12508;5054;6.9;2.8
2B;2021-03-04;447;376;12955;5430;7.1;3.0
2B;2021-03-05;619;351;13574;5781;7.4;3.2
2B;2021-03-06;682;90;14256;5871;7.8;3.2
2B;2021-03-07;361;56;14617;5927;8.0;3.3
2B;2021-03-08;300;220;14917;6147;8.2;3.4
2B;2021-03-09;384;472;15301;6619;8.4;3.6
2B;2021-03-10;631;420;15932;7039;8.7;3.9
2B;2021-03-11;584;333;16516;7372;9.1;4.0
2B;2021-03-12;968;219;17484;7591;9.6;4.2
2B;2021-03-13;511;97;17995;7688;9.9;4.2
2B;2021-03-14;226;63;18221;7751;10.0;4.3
2B;2021-03-15;516;198;18737;7949;10.3;4.4
2B;2021-03-16;571;271;19308;8220;10.6;4.5
2B;2021-03-17;530;258;19838;8478;10.9;4.7
2B;2021-03-18;551;221;20389;8699;11.2;4.8
2B;2021-03-19;805;192;21194;8891;11.6;4.9
2B;2021-03-20;656;37;21850;8928;12.0;4.9
2B;2021-03-21;428;36;22278;8964;12.2;4.9
2B;2021-03-22;546;122;22824;9086;12.5;5.0
2B;2021-03-23;788;255;23612;9341;13.0;5.1
2B;2021-03-24;831;214;24443;9555;13.4;5.2
2B;2021-03-25;824;163;25267;9718;13.9;5.3
2B;2021-03-26;958;189;26225;9907;14.4;5.4
2B;2021-03-27;1092;36;27317;9943;15.0;5.5
2B;2021-03-28;830;121;28147;10064;15.4;5.5
2B;2021-03-29;745;177;28892;10241;15.9;5.6
2B;2021-03-30;971;323;29863;10564;16.4;5.8
2B;2021-03-31;981;266;30844;10830;16.9;5.9
2B;2021-04-01;1003;226;31847;11056;17.5;6.1
2B;2021-04-02;966;408;32813;11464;18.0;6.3
2B;2021-04-03;1246;153;34059;11617;18.7;6.4
2B;2021-04-04;197;60;34256;11677;18.8;6.4
2B;2021-04-05;109;113;34365;11790;18.9;6.5
2B;2021-04-06;1032;359;35397;12149;19.4;6.7
2B;2021-04-07;1231;421;36628;12570;20.1;6.9
2B;2021-04-08;1129;408;37757;12978;20.7;7.1
2B;2021-04-09;1166;567;38923;13545;21.4;7.4
2B;2021-04-10;1352;265;40275;13810;22.1;7.6
2B;2021-04-11;815;65;41090;13875;22.5;7.6
2B;2021-04-12;853;558;41943;14433;23.0;7.9
2B;2021-04-13;1063;630;43006;15063;23.6;8.3
2B;2021-04-14;1046;494;44052;15557;24.2;8.5
2B;2021-04-15;886;517;44938;16074;24.7;8.8
2B;2021-04-16;910;647;45848;16721;25.2;9.2
2B;2021-04-17;386;447;46234;17168;25.4;9.4
2B;2021-04-18;253;343;46487;17511;25.5;9.6
2B;2021-04-19;822;436;47309;17947;26.0;9.8
2B;2021-04-20;898;843;48207;18790;26.4;10.3
2B;2021-04-21;1056;608;49263;19398;27.0;10.6
2B;2021-04-22;938;732;50201;20130;27.5;11.0
2B;2021-04-23;662;628;50863;20758;27.9;11.4
2B;2021-04-24;288;772;51151;21530;28.1;11.8
2B;2021-04-25;285;477;51436;22007;28.2;12.1
2B;2021-04-26;708;918;52144;22925;28.6;12.6
2B;2021-04-27;965;873;53109;23798;29.1;13.1
2B;2021-04-28;918;862;54027;24660;29.6;13.5
2B;2021-04-29;925;867;54952;25527;30.2;14.0
2B;2021-04-30;1133;831;56085;26358;30.8;14.5
2B;2021-05-01;460;1116;56545;27474;31.0;15.1
2B;2021-05-02;335;244;56880;27718;31.2;15.2
2B;2021-05-03;1017;495;57897;28213;31.8;15.5
2B;2021-05-04;811;1152;58708;29365;32.2;16.1
2B;2021-05-05;800;1376;59508;30741;32.7;16.9
2B;2021-05-06;1286;905;60794;31646;33.4;17.4
2B;2021-05-07;1062;987;61856;32633;33.9;17.9
2B;2021-05-08;459;852;62315;33485;34.2;18.4
2B;2021-05-09;392;683;62707;34168;34.4;18.7
2B;2021-05-10;925;802;63632;34970;34.9;19.2
2B;2021-05-11;933;1163;64565;36133;35.4;19.8
2B;2021-05-12;859;893;65424;37026;35.9;20.3
2B;2021-05-13;1028;376;66452;37402;36.5;20.5
2B;2021-05-14;719;577;67171;37979;36.9;20.8
2B;2021-05-15;702;353;67873;38332;37.2;21.0
2B;2021-05-16;300;180;68173;38512;37.4;21.1
2B;2021-05-17;1003;405;69176;38917;38.0;21.4
2B;2021-05-18;990;382;70166;39299;38.5;21.6
2B;2021-05-19;771;416;70937;39715;38.9;21.8
2B;2021-05-20;668;359;71605;40074;39.3;22.0
2B;2021-05-21;706;502;72311;40576;39.7;22.3
2B;2021-05-22;576;392;72887;40968;40.0;22.5
2B;2021-05-23;170;46;73057;41014;40.1;22.5
2B;2021-05-24;40;115;73097;41129;40.1;22.6
2B;2021-05-25;548;352;73645;41481;40.4;22.8
2B;2021-05-26;545;787;74190;42268;40.7;23.2
2B;2021-05-27;407;1131;74597;43399;40.9;23.8
2B;2021-05-28;550;905;75147;44304;41.2;24.3
2B;2021-05-29;311;353;75458;44657;41.4;24.5
2B;2021-05-30;46;45;75504;44702;41.4;24.5
2B;2021-05-31;375;831;75879;45533;41.6;25.0
2B;2021-06-01;414;1037;76293;46570;41.9;25.6
2B;2021-06-02;363;988;76656;47558;42.1;26.1
2B;2021-06-03;498;806;77154;48364;42.3;26.5
2B;2021-06-04;343;1253;77497;49617;42.5;27.2
2B;2021-06-05;257;491;77754;50108;42.7;27.5
2B;2021-06-06;51;129;77805;50237;42.7;27.6
2B;2021-06-07;280;949;78085;51186;42.8;28.1
2B;2021-06-08;399;1167;78484;52353;43.1;28.7
2B;2021-06-09;519;1177;79003;53530;43.3;29.4
2B;2021-06-10;369;939;79372;54469;43.5;29.9
2B;2021-06-11;432;1272;79804;55741;43.8;30.6
2B;2021-06-12;152;544;79956;56285;43.9;30.9
2B;2021-06-13;27;59;79983;56344;43.9;30.9
2B;2021-06-14;195;1111;80178;57455;44.0;31.5
2B;2021-06-15;344;1217;80522;58672;44.2;32.2
2B;2021-06-16;383;935;80905;59607;44.4;32.7
2B;2021-06-17;402;1049;81307;60656;44.6;33.3
2B;2021-06-18;348;960;81655;61616;44.8;33.8
2B;2021-06-19;144;330;81799;61946;44.9;34.0
2B;2021-06-20;44;194;81843;62140;44.9;34.1
2B;2021-06-21;265;962;82108;63102;45.1;34.6
2B;2021-06-22;317;1115;82425;64217;45.2;35.2
2B;2021-06-23;209;871;82634;65088;45.3;35.7
2B;2021-06-24;337;758;82971;65846;45.5;36.1
2B;2021-06-25;210;1074;83181;66920;45.6;36.7
2B;2021-06-26;105;550;83286;67470;45.7;37.0
2B;2021-06-27;31;214;83317;67684;45.7;37.1
2B;2021-06-28;329;954;83646;68638;45.9;37.7
2B;2021-06-29;270;985;83916;69623;46.0;38.2
2B;2021-06-30;380;948;84296;70571;46.3;38.7
2B;2021-07-01;226;507;84522;71078;46.4;39.0
2B;2021-07-02;219;557;84741;71635;46.5;39.3
2B;2021-07-03;91;397;84832;72032;46.5;39.5
2B;2021-07-04;2;0;84834;72032;46.5;39.5
2B;2021-07-05;264;666;85098;72698;46.7;39.9
2B;2021-07-06;450;707;85548;73405;46.9;40.3
2B;2021-07-07;380;910;85928;74315;47.1;40.8
2B;2021-07-08;183;351;86111;74666;47.2;41.0
2B;2021-07-09;250;376;86361;75042;47.4;41.2
2B;2021-07-10;197;199;86558;75241;47.5;41.3
2B;2021-07-11;13;14;86571;75255;47.5;41.3
2B;2021-07-12;497;746;87068;76001;47.8;41.7
2B;2021-07-13;822;1020;87890;77021;48.2;42.3
2B;2021-07-14;344;100;88234;77121;48.4;42.3
2B;2021-07-15;1270;589;89504;77710;49.1;42.6
2B;2021-07-16;1120;564;90624;78274;49.7;42.9
2B;2021-07-17;710;318;91334;78592;50.1;43.1
2B;2021-07-18;179;49;91513;78641;50.2;43.1
2B;2021-07-19;857;708;92370;79349;50.7;43.5
2B;2021-07-20;1211;681;93581;80030;51.3;43.9
2B;2021-07-21;1396;725;94977;80755;52.1;44.3
2B;2021-07-22;1330;604;96307;81359;52.8;44.6
2B;2021-07-23;1328;502;97635;81861;53.6;44.9
2B;2021-07-24;534;315;98169;82176;53.9;45.1
2B;2021-07-25;203;71;98372;82247;54.0;45.1
2B;2021-07-26;913;634;99285;82881;54.5;45.5
2B;2021-07-27;1578;704;100863;83585;55.3;45.9
2B;2021-07-28;1177;633;102040;84218;56.0;46.2
2B;2021-07-29;1144;449;103184;84667;56.6;46.5
2B;2021-07-30;763;348;103947;85015;57.0;46.6
2B;2021-07-31;539;234;104486;85249;57.3;46.8
2B;2021-08-01;230;57;104716;85306;57.5;46.8
2B;2021-08-02;799;471;105515;85777;57.9;47.1
2B;2021-08-03;1137;786;106652;86563;58.5;47.5
2B;2021-08-04;810;454;107462;87017;59.0;47.7
2B;2021-08-05;1025;560;108487;87577;59.5;48.1
2B;2021-08-06;704;526;109191;88103;59.9;48.3
2B;2021-08-07;306;408;109497;88511;60.1;48.6
2B;2021-08-08;93;142;109590;88653;60.1;48.6
2B;2021-08-09;536;747;110126;89400;60.4;49.1
2B;2021-08-10;739;1131;110865;90531;60.8;49.7
2B;2021-08-11;752;901;111617;91432;61.2;50.2
2B;2021-08-12;692;1045;112309;92477;61.6;50.7
2B;2021-08-13;494;948;112803;93425;61.9;51.3
2B;2021-08-14;200;437;113003;93862;62.0;51.5
2B;2021-08-15;117;173;113120;94035;62.1;51.6
2B;2021-08-16;509;1063;113629;95098;62.3;52.2
2B;2021-08-17;587;1308;114216;96406;62.7;52.9
2B;2021-08-18;506;1193;114722;97599;62.9;53.5
2B;2021-08-19;433;900;115155;98499;63.2;54.0
2B;2021-08-20;368;813;115523;99312;63.4;54.5
2B;2021-08-21;158;474;115681;99786;63.5;54.7
2B;2021-08-22;79;208;115760;99994;63.5;54.9
2B;2021-08-23;376;945;116136;100939;63.7;55.4
2B;2021-08-24;497;1214;116633;102153;64.0;56.0
2B;2021-08-25;347;971;116980;103124;64.2;56.6
2B;2021-08-26;401;817;117381;103941;64.4;57.0
2B;2021-08-27;262;572;117643;104513;64.5;57.3
2B;2021-08-28;168;442;117811;104955;64.6;57.6
2B;2021-08-29;53;126;117864;105081;64.7;57.7
2B;2021-08-30;364;851;118228;105932;64.9;58.1
2B;2021-08-31;380;922;118608;106854;65.1;58.6
2B;2021-09-01;368;986;118976;107840;65.3;59.2
2B;2021-09-02;304;737;119280;108577;65.4;59.6
2B;2021-09-03;219;507;119499;109084;65.6;59.9
2B;2021-09-04;123;352;119622;109436;65.6;60.0
2B;2021-09-05;17;137;119639;109573;65.6;60.1
2B;2021-09-06;163;655;119802;110228;65.7;60.5
2B;2021-09-07;259;989;120061;111217;65.9;61.0
2B;2021-09-08;203;746;120264;111963;66.0;61.4
2B;2021-09-09;183;520;120447;112483;66.1;61.7
2B;2021-09-10;201;488;120648;112971;66.2;62.0
2B;2021-09-11;130;312;120778;113283;66.3;62.2
2B;2021-09-12;17;114;120795;113397;66.3;62.2
2B;2021-09-13;191;534;120986;113931;66.4;62.5
2B;2021-09-14;279;929;121265;114860;66.5;63.0
2B;2021-09-15;159;598;121424;115458;66.6;63.3
2B;2021-09-16;215;301;121639;115759;66.7;63.5
2B;2021-09-17;114;194;121753;115953;66.8;63.6
2B;2021-09-18;51;157;121804;116110;66.8;63.7
2B;2021-09-19;15;18;121819;116128;66.8;63.7
2B;2021-09-20;106;409;121925;116537;66.9;63.9
2B;2021-09-21;100;410;122025;116947;67.0;64.2
2B;2021-09-22;115;404;122140;117351;67.0;64.4
2B;2021-09-23;103;228;122243;117579;67.1;64.5
2B;2021-09-24;86;212;122329;117791;67.1;64.6
2B;2021-09-25;36;123;122365;117914;67.1;64.7
2B;2021-09-26;2;23;122367;117937;67.1;64.7
2B;2021-09-27;71;229;122438;118166;67.2;64.8
2B;2021-09-28;97;192;122535;118358;67.2;64.9
2B;2021-09-29;118;345;122653;118703;67.3;65.1
2B;2021-09-30;70;132;122723;118835;67.3;65.2
2B;2021-10-01;111;163;122834;118998;67.4;65.3
2B;2021-10-02;52;114;122886;119112;67.4;65.4
2B;2021-10-03;12;15;122898;119127;67.4;65.4
30;2020-12-27;1;0;1;0;0.0;0.0
30;2020-12-28;2;0;3;0;0.0;0.0
30;2020-12-29;0;0;3;0;0.0;0.0
30;2020-12-30;0;0;3;0;0.0;0.0
30;2020-12-31;0;0;3;0;0.0;0.0
30;2021-01-01;0;0;3;0;0.0;0.0
30;2021-01-02;0;0;3;0;0.0;0.0
30;2021-01-03;0;0;3;0;0.0;0.0
30;2021-01-04;0;0;3;0;0.0;0.0
30;2021-01-05;3;0;6;0;0.0;0.0
30;2021-01-06;128;0;134;0;0.0;0.0
30;2021-01-07;314;0;448;0;0.1;0.0
30;2021-01-08;532;0;980;0;0.1;0.0
30;2021-01-09;270;0;1250;0;0.2;0.0
30;2021-01-10;0;0;1250;0;0.2;0.0
30;2021-01-11;537;0;1787;0;0.2;0.0
30;2021-01-12;801;3;2588;3;0.3;0.0
30;2021-01-13;641;0;3229;3;0.4;0.0
30;2021-01-14;653;5;3882;8;0.5;0.0
30;2021-01-15;756;2;4638;10;0.6;0.0
30;2021-01-16;313;0;4951;10;0.7;0.0
30;2021-01-17;4;0;4955;10;0.7;0.0
30;2021-01-18;945;5;5900;15;0.8;0.0
30;2021-01-19;1735;5;7635;20;1.0;0.0
30;2021-01-20;1303;2;8938;22;1.2;0.0
30;2021-01-21;1229;2;10167;24;1.4;0.0
30;2021-01-22;1078;6;11245;30;1.5;0.0
30;2021-01-23;634;2;11879;32;1.6;0.0
30;2021-01-24;0;0;11879;32;1.6;0.0
30;2021-01-25;830;5;12709;37;1.7;0.0
30;2021-01-26;1059;15;13768;52;1.8;0.0
30;2021-01-27;983;104;14751;156;2.0;0.0
30;2021-01-28;714;246;15465;402;2.1;0.1
30;2021-01-29;671;418;16136;820;2.2;0.1
30;2021-01-30;473;261;16609;1081;2.2;0.1
30;2021-01-31;3;6;16612;1087;2.2;0.1
30;2021-02-01;816;405;17428;1492;2.3;0.2
30;2021-02-02;1876;634;19304;2126;2.6;0.3
30;2021-02-03;1185;455;20489;2581;2.7;0.3
30;2021-02-04;970;589;21459;3170;2.9;0.4
30;2021-02-05;599;699;22058;3869;2.9;0.5
30;2021-02-06;295;203;22353;4072;3.0;0.5
30;2021-02-07;3;8;22356;4080;3.0;0.5
30;2021-02-08;574;604;22930;4684;3.1;0.6
30;2021-02-09;985;908;23915;5592;3.2;0.7
30;2021-02-10;985;979;24900;6571;3.3;0.9
30;2021-02-11;929;936;25829;7507;3.5;1.0
30;2021-02-12;620;875;26449;8382;3.5;1.1
30;2021-02-13;435;296;26884;8678;3.6;1.2
30;2021-02-14;3;19;26887;8697;3.6;1.2
30;2021-02-15;450;473;27337;9170;3.7;1.2
30;2021-02-16;460;712;27797;9882;3.7;1.3
30;2021-02-17;683;518;28480;10400;3.8;1.4
30;2021-02-18;797;429;29277;10829;3.9;1.4
30;2021-02-19;577;563;29854;11392;4.0;1.5
30;2021-02-20;224;177;30078;11569;4.0;1.5
30;2021-02-21;5;3;30083;11572;4.0;1.5
30;2021-02-22;502;652;30585;12224;4.1;1.6
30;2021-02-23;973;1341;31558;13565;4.2;1.8
30;2021-02-24;930;1014;32488;14579;4.3;1.9
30;2021-02-25;1211;778;33699;15357;4.5;2.1
30;2021-02-26;1336;491;35035;15848;4.7;2.1
30;2021-02-27;564;442;35599;16290;4.8;2.2
30;2021-02-28;6;7;35605;16297;4.8;2.2
30;2021-03-01;1343;740;36948;17037;4.9;2.3
30;2021-03-02;1714;807;38662;17844;5.2;2.4
30;2021-03-03;2311;655;40973;18499;5.5;2.5
30;2021-03-04;2638;799;43611;19298;5.8;2.6
30;2021-03-05;2766;558;46377;19856;6.2;2.7
30;2021-03-06;2996;317;49373;20173;6.6;2.7
30;2021-03-07;1862;47;51235;20220;6.8;2.7
30;2021-03-08;1555;708;52790;20928;7.1;2.8
30;2021-03-09;2276;795;55066;21723;7.4;2.9
30;2021-03-10;2360;607;57426;22330;7.7;3.0
30;2021-03-11;3054;661;60480;22991;8.1;3.1
30;2021-03-12;3114;364;63594;23355;8.5;3.1
30;2021-03-13;2227;277;65821;23632;8.8;3.2
30;2021-03-14;83;3;65904;23635;8.8;3.2
30;2021-03-15;1579;547;67483;24182;9.0;3.2
30;2021-03-16;1297;1013;68780;25195;9.2;3.4
30;2021-03-17;1456;625;70236;25820;9.4;3.4
30;2021-03-18;1648;703;71884;26523;9.6;3.5
30;2021-03-19;2250;532;74134;27055;9.9;3.6
30;2021-03-20;1400;142;75534;27197;10.1;3.6
30;2021-03-21;58;8;75592;27205;10.1;3.6
30;2021-03-22;2394;712;77986;27917;10.4;3.7
30;2021-03-23;3512;798;81498;28715;10.9;3.8
30;2021-03-24;3639;810;85137;29525;11.4;3.9
30;2021-03-25;4406;840;89543;30365;12.0;4.1
30;2021-03-26;4361;644;93904;31009;12.5;4.1
30;2021-03-27;1971;374;95875;31383;12.8;4.2
30;2021-03-28;35;29;95910;31412;12.8;4.2
30;2021-03-29;2816;1641;98726;33053;13.2;4.4
30;2021-03-30;3777;1869;102503;34922;13.7;4.7
30;2021-03-31;3505;1636;106008;36558;14.2;4.9
30;2021-04-01;4016;1465;110024;38023;14.7;5.1
30;2021-04-02;3605;1221;113629;39244;15.2;5.2
30;2021-04-03;1061;1216;114690;40460;15.3;5.4
30;2021-04-04;30;188;114720;40648;15.3;5.4
30;2021-04-05;765;291;115485;40939;15.4;5.5
30;2021-04-06;3045;1576;118530;42515;15.8;5.7
30;2021-04-07;2718;1626;121248;44141;16.2;5.9
30;2021-04-08;3921;1486;125169;45627;16.7;6.1
30;2021-04-09;4888;1512;130057;47139;17.4;6.3
30;2021-04-10;2426;1175;132483;48314;17.7;6.5
30;2021-04-11;951;59;133434;48373;17.8;6.5
30;2021-04-12;3142;1490;136576;49863;18.2;6.7
30;2021-04-13;4019;1930;140595;51793;18.8;6.9
30;2021-04-14;3387;1542;143982;53335;19.2;7.1
30;2021-04-15;3827;1470;147809;54805;19.7;7.3
30;2021-04-16;3704;1544;151513;56349;20.2;7.5
30;2021-04-17;1493;952;153006;57301;20.4;7.7
30;2021-04-18;961;67;153967;57368;20.6;7.7
30;2021-04-19;2447;2297;156414;59665;20.9;8.0
30;2021-04-20;2817;2829;159231;62494;21.3;8.3
30;2021-04-21;2599;2568;161830;65062;21.6;8.7
30;2021-04-22;3525;2317;165355;67379;22.1;9.0
30;2021-04-23;3580;2299;168935;69678;22.6;9.3
30;2021-04-24;1347;1230;170282;70908;22.8;9.5
30;2021-04-25;748;91;171030;70999;22.9;9.5
30;2021-04-26;2015;2388;173045;73387;23.1;9.8
30;2021-04-27;2951;2593;175996;75980;23.5;10.2
30;2021-04-28;2838;2485;178834;78465;23.9;10.5
30;2021-04-29;3621;2319;182455;80784;24.4;10.8
30;2021-04-30;3409;2014;185864;82798;24.8;11.1
30;2021-05-01;1746;600;187610;83398;25.1;11.1
30;2021-05-02;665;245;188275;83643;25.2;11.2
30;2021-05-03;3750;2504;192025;86147;25.7;11.5
30;2021-05-04;3979;3538;196004;89685;26.2;12.0
30;2021-05-05;3942;3117;199946;92802;26.7;12.4
30;2021-05-06;4202;3366;204148;96168;27.3;12.8
30;2021-05-07;4078;3062;208226;99230;27.8;13.3
30;2021-05-08;1605;721;209831;99951;28.0;13.4
30;2021-05-09;372;613;210203;100564;28.1;13.4
30;2021-05-10;2921;3114;213124;103678;28.5;13.9
30;2021-05-11;5389;3646;218513;107324;29.2;14.3
30;2021-05-12;5303;3214;223816;110538;29.9;14.8
30;2021-05-13;3230;1028;227046;111566;30.3;14.9
30;2021-05-14;4890;2460;231936;114026;31.0;15.2
30;2021-05-15;3407;1206;235343;115232;31.4;15.4
30;2021-05-16;397;338;235740;115570;31.5;15.4
30;2021-05-17;3793;3030;239533;118600;32.0;15.8
30;2021-05-18;4826;3033;244359;121633;32.6;16.3
30;2021-05-19;4773;2546;249132;124179;33.3;16.6
30;2021-05-20;5014;2572;254146;126751;34.0;16.9
30;2021-05-21;4884;2472;259030;129223;34.6;17.3
30;2021-05-22;3155;1283;262185;130506;35.0;17.4
30;2021-05-23;289;344;262474;130850;35.1;17.5
30;2021-05-24;785;766;263259;131616;35.2;17.6
30;2021-05-25;2654;3157;265913;134773;35.5;18.0
30;2021-05-26;2887;2570;268800;137343;35.9;18.3
30;2021-05-27;3757;2708;272557;140051;36.4;18.7
30;2021-05-28;3325;3246;275882;143297;36.9;19.1
30;2021-05-29;1687;1793;277569;145090;37.1;19.4
30;2021-05-30;360;584;277929;145674;37.1;19.5
30;2021-05-31;2829;2293;280758;147967;37.5;19.8
30;2021-06-01;3657;2791;284415;150758;38.0;20.1
30;2021-06-02;3320;2449;287735;153207;38.4;20.5
30;2021-06-03;4129;3344;291864;156551;39.0;20.9
30;2021-06-04;3898;3392;295762;159943;39.5;21.4
30;2021-06-05;1904;1313;297666;161256;39.8;21.5
30;2021-06-06;684;264;298350;161520;39.9;21.6
30;2021-06-07;4721;2524;303071;164044;40.5;21.9
30;2021-06-08;4830;3324;307901;167368;41.1;22.4
30;2021-06-09;4151;2988;312052;170356;41.7;22.8
30;2021-06-10;4611;3353;316663;173709;42.3;23.2
30;2021-06-11;4583;3807;321246;177516;42.9;23.7
30;2021-06-12;2485;1709;323731;179225;43.3;23.9
30;2021-06-13;493;344;324224;179569;43.3;24.0
30;2021-06-14;2470;4711;326694;184280;43.6;24.6
30;2021-06-15;3198;5309;329892;189589;44.1;25.3
30;2021-06-16;3107;4642;332999;194231;44.5;26.0
30;2021-06-17;3922;4373;336921;198604;45.0;26.5
30;2021-06-18;3713;4694;340634;203298;45.5;27.2
30;2021-06-19;1441;2004;342075;205302;45.7;27.4
30;2021-06-20;357;491;342432;205793;45.8;27.5
30;2021-06-21;2379;4910;344811;210703;46.1;28.2
30;2021-06-22;2364;5741;347175;216444;46.4;28.9
30;2021-06-23;2528;5342;349703;221786;46.7;29.6
30;2021-06-24;2336;4706;352039;226492;47.0;30.3
30;2021-06-25;2611;5603;354650;232095;47.4;31.0
30;2021-06-26;909;2940;355559;235035;47.5;31.4
30;2021-06-27;222;527;355781;235562;47.5;31.5
30;2021-06-28;1670;6022;357451;241584;47.8;32.3
30;2021-06-29;1837;6022;359288;247606;48.0;33.1
30;2021-06-30;2001;5253;361289;252859;48.3;33.8
30;2021-07-01;3105;4715;364394;257574;48.7;34.4
30;2021-07-02;2833;4624;367227;262198;49.1;35.0
30;2021-07-03;1154;3047;368381;265245;49.2;35.4
30;2021-07-04;116;393;368497;265638;49.2;35.5
30;2021-07-05;2025;4028;370522;269666;49.5;36.0
30;2021-07-06;2663;4973;373185;274639;49.9;36.7
30;2021-07-07;2538;4221;375723;278860;50.2;37.3
30;2021-07-08;2011;3417;377734;282277;50.5;37.7
30;2021-07-09;2410;5312;380144;287589;50.8;38.4
30;2021-07-10;1504;2157;381648;289746;51.0;38.7
30;2021-07-11;47;415;381695;290161;51.0;38.8
30;2021-07-12;2527;5152;384222;295313;51.3;39.5
30;2021-07-13;3300;6029;387522;301342;51.8;40.3
30;2021-07-14;502;550;388024;301892;51.8;40.3
30;2021-07-15;4127;5474;392151;307366;52.4;41.1
30;2021-07-16;5036;5727;397187;313093;53.1;41.8
30;2021-07-17;1706;2466;398893;315559;53.3;42.2
30;2021-07-18;146;602;399039;316161;53.3;42.2
30;2021-07-19;3374;6314;402413;322475;53.8;43.1
30;2021-07-20;4640;6521;407053;328996;54.4;44.0
30;2021-07-21;4063;5413;411116;334409;54.9;44.7
30;2021-07-22;4900;5740;416016;340149;55.6;45.4
30;2021-07-23;4998;5866;421014;346015;56.3;46.2
30;2021-07-24;2240;3256;423254;349271;56.5;46.7
30;2021-07-25;137;309;423391;349580;56.6;46.7
30;2021-07-26;4414;4132;427805;353712;57.2;47.3
30;2021-07-27;4856;4648;432661;358360;57.8;47.9
30;2021-07-28;4877;4024;437538;362384;58.5;48.4
30;2021-07-29;5929;4140;443467;366524;59.2;49.0
30;2021-07-30;5341;4390;448808;370914;60.0;49.6
30;2021-07-31;2655;1965;451463;372879;60.3;49.8
30;2021-08-01;734;311;452197;373190;60.4;49.9
30;2021-08-02;3685;4011;455882;377201;60.9;50.4
30;2021-08-03;4887;3953;460769;381154;61.6;50.9
30;2021-08-04;5284;3051;466053;384205;62.3;51.3
30;2021-08-05;4616;3794;470669;387999;62.9;51.8
30;2021-08-06;4333;4064;475002;392063;63.5;52.4
30;2021-08-07;1841;1953;476843;394016;63.7;52.6
30;2021-08-08;619;280;477462;394296;63.8;52.7
30;2021-08-09;3342;3761;480804;398057;64.2;53.2
30;2021-08-10;3926;4400;484730;402457;64.8;53.8
30;2021-08-11;3402;3480;488132;405937;65.2;54.2
30;2021-08-12;3763;4220;491895;410157;65.7;54.8
30;2021-08-13;3306;3338;495201;413495;66.2;55.2
30;2021-08-14;1134;2048;496335;415543;66.3;55.5
30;2021-08-15;270;175;496605;415718;66.3;55.5
30;2021-08-16;2201;4864;498806;420582;66.6;56.2
30;2021-08-17;2745;4197;501551;424779;67.0;56.8
30;2021-08-18;2839;3835;504390;428614;67.4;57.3
30;2021-08-19;2858;4318;507248;432932;67.8;57.8
30;2021-08-20;2607;4466;509855;437398;68.1;58.4
30;2021-08-21;1018;2887;510873;440285;68.3;58.8
30;2021-08-22;227;516;511100;440801;68.3;58.9
30;2021-08-23;1687;4476;512787;445277;68.5;59.5
30;2021-08-24;1954;4525;514741;449802;68.8;60.1
30;2021-08-25;1689;4345;516430;454147;69.0;60.7
30;2021-08-26;1851;4256;518281;458403;69.2;61.2
30;2021-08-27;1773;4356;520054;462759;69.5;61.8
30;2021-08-28;681;2476;520735;465235;69.6;62.2
30;2021-08-29;182;614;520917;465849;69.6;62.2
30;2021-08-30;1406;4307;522323;470156;69.8;62.8
30;2021-08-31;1333;4190;523656;474346;70.0;63.4
30;2021-09-01;1237;3625;524893;477971;70.1;63.9
30;2021-09-02;1395;3591;526288;481562;70.3;64.3
30;2021-09-03;1503;4189;527791;485751;70.5;64.9
30;2021-09-04;685;1963;528476;487714;70.6;65.2
30;2021-09-05;136;527;528612;488241;70.6;65.2
30;2021-09-06;741;2742;529353;490983;70.7;65.6
30;2021-09-07;698;2647;530051;493630;70.8;66.0
30;2021-09-08;867;2863;530918;496493;70.9;66.3
30;2021-09-09;906;2492;531824;498985;71.1;66.7
30;2021-09-10;937;3002;532761;501987;71.2;67.1
30;2021-09-11;551;1667;533312;503654;71.3;67.3
30;2021-09-12;94;224;533406;503878;71.3;67.3
30;2021-09-13;682;2013;534088;505891;71.4;67.6
30;2021-09-14;646;2050;534734;507941;71.4;67.9
30;2021-09-15;727;1837;535461;509778;71.5;68.1
30;2021-09-16;745;1479;536206;511257;71.6;68.3
30;2021-09-17;801;2029;537007;513286;71.7;68.6
30;2021-09-18;400;1010;537407;514296;71.8;68.7
30;2021-09-19;69;158;537476;514454;71.8;68.7
30;2021-09-20;396;1200;537872;515654;71.9;68.9
30;2021-09-21;451;1157;538323;516811;71.9;69.0
30;2021-09-22;481;1379;538804;518190;72.0;69.2
30;2021-09-23;622;1199;539426;519389;72.1;69.4
30;2021-09-24;555;1628;539981;521017;72.1;69.6
30;2021-09-25;323;855;540304;521872;72.2;69.7
30;2021-09-26;55;168;540359;522040;72.2;69.7
30;2021-09-27;377;894;540736;522934;72.2;69.9
30;2021-09-28;574;892;541310;523826;72.3;70.0
30;2021-09-29;455;1065;541765;524891;72.4;70.1
30;2021-09-30;399;908;542164;525799;72.4;70.3
30;2021-10-01;489;999;542653;526798;72.5;70.4
30;2021-10-02;267;580;542920;527378;72.5;70.5
30;2021-10-03;19;45;542939;527423;72.5;70.5
31;2020-12-27;0;0;0;0;0.0;0.0
31;2020-12-28;2;0;2;0;0.0;0.0
31;2020-12-29;0;0;2;0;0.0;0.0
31;2020-12-30;0;0;2;0;0.0;0.0
31;2020-12-31;1;0;3;0;0.0;0.0
31;2021-01-01;4;0;7;0;0.0;0.0
31;2021-01-02;1;0;8;0;0.0;0.0
31;2021-01-03;2;0;10;0;0.0;0.0
31;2021-01-04;5;0;15;0;0.0;0.0
31;2021-01-05;50;0;65;0;0.0;0.0
31;2021-01-06;211;1;276;1;0.0;0.0
31;2021-01-07;284;1;560;2;0.0;0.0
31;2021-01-08;546;1;1106;3;0.1;0.0
31;2021-01-09;275;0;1381;3;0.1;0.0
31;2021-01-10;286;0;1667;3;0.1;0.0
31;2021-01-11;983;3;2650;6;0.2;0.0
31;2021-01-12;1192;1;3842;7;0.3;0.0
31;2021-01-13;1158;3;5000;10;0.4;0.0
31;2021-01-14;1179;18;6179;28;0.4;0.0
31;2021-01-15;1048;3;7227;31;0.5;0.0
31;2021-01-16;243;1;7470;32;0.5;0.0
31;2021-01-17;176;0;7646;32;0.5;0.0
31;2021-01-18;1616;5;9262;37;0.7;0.0
31;2021-01-19;2937;10;12199;47;0.9;0.0
31;2021-01-20;3683;12;15882;59;1.1;0.0
31;2021-01-21;2998;7;18880;66;1.3;0.0
31;2021-01-22;2275;4;21155;70;1.5;0.0
31;2021-01-23;728;2;21883;72;1.6;0.0
31;2021-01-24;212;1;22095;73;1.6;0.0
31;2021-01-25;1744;9;23839;82;1.7;0.0
31;2021-01-26;1839;36;25678;118;1.8;0.0
31;2021-01-27;1573;139;27251;257;1.9;0.0
31;2021-01-28;1385;282;28636;539;2.0;0.0
31;2021-01-29;1360;315;29996;854;2.1;0.1
31;2021-01-30;446;168;30442;1022;2.2;0.1
31;2021-01-31;61;191;30503;1213;2.2;0.1
31;2021-02-01;1183;664;31686;1877;2.3;0.1
31;2021-02-02;3056;760;34742;2637;2.5;0.2
31;2021-02-03;1922;736;36664;3373;2.6;0.2
31;2021-02-04;1813;790;38477;4163;2.7;0.3
31;2021-02-05;1342;542;39819;4705;2.8;0.3
31;2021-02-06;385;52;40204;4757;2.9;0.3
31;2021-02-07;37;37;40241;4794;2.9;0.3
31;2021-02-08;1116;608;41357;5402;3.0;0.4
31;2021-02-09;1679;1480;43036;6882;3.1;0.5
31;2021-02-10;1964;2269;45000;9151;3.2;0.7
31;2021-02-11;1814;1744;46814;10895;3.3;0.8
31;2021-02-12;1540;747;48354;11642;3.5;0.8
31;2021-02-13;504;211;48858;11853;3.5;0.8
31;2021-02-14;56;191;48914;12044;3.5;0.9
31;2021-02-15;444;1063;49358;13107;3.5;0.9
31;2021-02-16;463;1263;49821;14370;3.6;1.0
31;2021-02-17;472;1326;50293;15696;3.6;1.1
31;2021-02-18;476;1401;50769;17097;3.6;1.2
31;2021-02-19;393;1289;51162;18386;3.7;1.3
31;2021-02-20;69;415;51231;18801;3.7;1.3
31;2021-02-21;77;145;51308;18946;3.7;1.4
31;2021-02-22;434;1454;51742;20400;3.7;1.5
31;2021-02-23;864;2661;52606;23061;3.8;1.6
31;2021-02-24;652;1930;53258;24991;3.8;1.8
31;2021-02-25;1435;1616;54693;26607;3.9;1.9
31;2021-02-26;1711;988;56404;27595;4.0;2.0
31;2021-02-27;638;306;57042;27901;4.1;2.0
31;2021-02-28;78;54;57120;27955;4.1;2.0
31;2021-03-01;875;943;57995;28898;4.1;2.1
31;2021-03-02;1240;1437;59235;30335;4.2;2.2
31;2021-03-03;1355;1627;60590;31962;4.3;2.3
31;2021-03-04;2423;1317;63013;33279;4.5;2.4
31;2021-03-05;3054;1438;66067;34717;4.7;2.5
31;2021-03-06;2834;355;68901;35072;4.9;2.5
31;2021-03-07;5368;108;74269;35180;5.3;2.5
31;2021-03-08;1598;966;75867;36146;5.4;2.6
31;2021-03-09;2792;1041;78659;37187;5.6;2.7
31;2021-03-10;2574;993;81233;38180;5.8;2.7
31;2021-03-11;4382;1061;85615;39241;6.1;2.8
31;2021-03-12;5319;1102;90934;40343;6.5;2.9
31;2021-03-13;2839;473;93773;40816;6.7;2.9
31;2021-03-14;235;49;94008;40865;6.7;2.9
31;2021-03-15;2584;414;96592;41279;6.9;2.9
31;2021-03-16;1746;778;98338;42057;7.0;3.0
31;2021-03-17;1656;541;99994;42598;7.1;3.0
31;2021-03-18;1988;697;101982;43295;7.3;3.1
31;2021-03-19;3185;521;105167;43816;7.5;3.1
31;2021-03-20;1797;136;106964;43952;7.6;3.1
31;2021-03-21;211;24;107175;43976;7.7;3.1
31;2021-03-22;2579;355;109754;44331;7.8;3.2
31;2021-03-23;4057;317;113811;44648;8.1;3.2
31;2021-03-24;4356;288;118167;44936;8.4;3.2
31;2021-03-25;6041;514;124208;45450;8.9;3.2
31;2021-03-26;5466;507;129674;45957;9.3;3.3
31;2021-03-27;4350;209;134024;46166;9.6;3.3
31;2021-03-28;2291;48;136315;46214;9.7;3.3
31;2021-03-29;4206;430;140521;46644;10.0;3.3
31;2021-03-30;6595;553;147116;47197;10.5;3.4
31;2021-03-31;5649;382;152765;47579;10.9;3.4
31;2021-04-01;6968;552;159733;48131;11.4;3.4
31;2021-04-02;6102;574;165835;48705;11.8;3.5
31;2021-04-03;3927;151;169762;48856;12.1;3.5
31;2021-04-04;2060;113;171822;48969;12.3;3.5
31;2021-04-05;481;71;172303;49040;12.3;3.5
31;2021-04-06;4165;1145;176468;50185;12.6;3.6
31;2021-04-07;5988;982;182456;51167;13.0;3.7
31;2021-04-08;7568;1037;190024;52204;13.6;3.7
31;2021-04-09;8384;1257;198408;53461;14.2;3.8
31;2021-04-10;4716;543;203124;54004;14.5;3.9
31;2021-04-11;2069;136;205193;54140;14.6;3.9
31;2021-04-12;6001;1834;211194;55974;15.1;4.0
31;2021-04-13;8047;2014;219241;57988;15.6;4.1
31;2021-04-14;6655;1900;225896;59888;16.1;4.3
31;2021-04-15;7771;2239;233667;62127;16.7;4.4
31;2021-04-16;7177;2092;240844;64219;17.2;4.6
31;2021-04-17;4414;904;245258;65123;17.5;4.6
31;2021-04-18;2513;355;247771;65478;17.7;4.7
31;2021-04-19;5220;2020;252991;67498;18.1;4.8
31;2021-04-20;6073;2835;259064;70333;18.5;5.0
31;2021-04-21;5974;2786;265038;73119;18.9;5.2
31;2021-04-22;6379;3236;271417;76355;19.4;5.5
31;2021-04-23;6283;2551;277700;78906;19.8;5.6
31;2021-04-24;1616;3137;279316;82043;19.9;5.9
31;2021-04-25;688;2092;280004;84135;20.0;6.0
31;2021-04-26;3794;3212;283798;87347;20.3;6.2
31;2021-04-27;4517;3875;288315;91222;20.6;6.5
31;2021-04-28;4545;3550;292860;94772;20.9;6.8
31;2021-04-29;5181;4054;298041;98826;21.3;7.1
31;2021-04-30;5037;4123;303078;102949;21.6;7.3
31;2021-05-01;1487;3114;304565;106063;21.7;7.6
31;2021-05-02;1414;1979;305979;108042;21.8;7.7
31;2021-05-03;5658;2415;311637;110457;22.2;7.9
31;2021-05-04;4779;4739;316416;115196;22.6;8.2
31;2021-05-05;2994;5712;319410;120908;22.8;8.6
31;2021-05-06;3635;7376;323045;128284;23.1;9.2
31;2021-05-07;5256;7148;328301;135432;23.4;9.7
31;2021-05-08;3633;3102;331934;138534;23.7;9.9
31;2021-05-09;3760;2307;335694;140841;24.0;10.1
31;2021-05-10;5683;5471;341377;146312;24.4;10.4
31;2021-05-11;6605;6680;347982;152992;24.8;10.9
31;2021-05-12;6171;5926;354153;158918;25.3;11.3
31;2021-05-13;4642;2067;358795;160985;25.6;11.5
31;2021-05-14;6911;3974;365706;164959;26.1;11.8
31;2021-05-15;5145;1753;370851;166712;26.5;11.9
31;2021-05-16;3300;633;374151;167345;26.7;11.9
31;2021-05-17;5143;4148;379294;171493;27.1;12.2
31;2021-05-18;5589;4271;384883;175764;27.5;12.5
31;2021-05-19;5782;3762;390665;179526;27.9;12.8
31;2021-05-20;6473;4787;397138;184313;28.3;13.2
31;2021-05-21;5985;4594;403123;188907;28.8;13.5
31;2021-05-22;4081;1628;407204;190535;29.1;13.6
31;2021-05-23;3583;342;410787;190877;29.3;13.6
31;2021-05-24;3881;706;414668;191583;29.6;13.7
31;2021-05-25;6190;3607;420858;195190;30.0;13.9
31;2021-05-26;5607;4643;426465;199833;30.4;14.3
31;2021-05-27;4788;6183;431253;206016;30.8;14.7
31;2021-05-28;4116;6344;435369;212360;31.1;15.2
31;2021-05-29;1917;4024;437286;216384;31.2;15.4
31;2021-05-30;751;2361;438037;218745;31.3;15.6
31;2021-05-31;4397;5072;442434;223817;31.6;16.0
31;2021-06-01;5953;6558;448387;230375;32.0;16.4
31;2021-06-02;5802;6296;454189;236671;32.4;16.9
31;2021-06-03;7309;8133;461498;244804;32.9;17.5
31;2021-06-04;7541;7149;469039;251953;33.5;18.0
31;2021-06-05;9077;2772;478116;254725;34.1;18.2
31;2021-06-06;8106;1579;486222;256304;34.7;18.3
31;2021-06-07;7987;5472;494209;261776;35.3;18.7
31;2021-06-08;9106;6043;503315;267819;35.9;19.1
31;2021-06-09;8918;5551;512233;273370;36.6;19.5
31;2021-06-10;9781;6351;522014;279721;37.3;20.0
31;2021-06-11;10047;6626;532061;286347;38.0;20.4
31;2021-06-12;8788;3023;540849;289370;38.6;20.7
31;2021-06-13;8378;2018;549227;291388;39.2;20.8
31;2021-06-14;8427;6728;557654;298116;39.8;21.3
31;2021-06-15;9774;7445;567428;305561;40.5;21.8
31;2021-06-16;8735;5256;576163;310817;41.1;22.2
31;2021-06-17;8277;6603;584440;317420;41.7;22.7
31;2021-06-18;8551;7753;592991;325173;42.3;23.2
31;2021-06-19;7364;5440;600355;330613;42.9;23.6
31;2021-06-20;5572;3727;605927;334340;43.3;23.9
31;2021-06-21;5373;6916;611300;341256;43.6;24.4
31;2021-06-22;4987;8228;616287;349484;44.0;24.9
31;2021-06-23;5105;7283;621392;356767;44.4;25.5
31;2021-06-24;4633;8324;626025;365091;44.7;26.1
31;2021-06-25;5014;9309;631039;374400;45.0;26.7
31;2021-06-26;4282;6398;635321;380798;45.3;27.2
31;2021-06-27;3596;4106;638917;384904;45.6;27.5
31;2021-06-28;4097;6642;643014;391546;45.9;27.9
31;2021-06-29;3798;7559;646812;399105;46.2;28.5
31;2021-06-30;4280;7819;651092;406924;46.5;29.0
31;2021-07-01;4121;8461;655213;415385;46.8;29.7
31;2021-07-02;4108;9327;659321;424712;47.1;30.3
31;2021-07-03;4100;6111;663421;430823;47.4;30.8
31;2021-07-04;3205;4812;666626;435635;47.6;31.1
31;2021-07-05;4057;7094;670683;442729;47.9;31.6
31;2021-07-06;3889;8362;674572;451091;48.2;32.2
31;2021-07-07;3964;7960;678536;459051;48.4;32.8
31;2021-07-08;4054;8536;682590;467587;48.7;33.4
31;2021-07-09;4461;8798;687051;476385;49.0;34.0
31;2021-07-10;3918;5494;690969;481879;49.3;34.4
31;2021-07-11;3137;4137;694106;486016;49.5;34.7
31;2021-07-12;3824;8635;697930;494651;49.8;35.3
31;2021-07-13;6919;9445;704849;504096;50.3;36.0
31;2021-07-14;6167;3938;711016;508034;50.8;36.3
31;2021-07-15;8516;9451;719532;517485;51.4;36.9
31;2021-07-16;7775;9909;727307;527394;51.9;37.6
31;2021-07-17;8357;10555;735664;537949;52.5;38.4
31;2021-07-18;6620;9472;742284;547421;53.0;39.1
31;2021-07-19;4794;10775;747078;558196;53.3;39.8
31;2021-07-20;7159;11480;754237;569676;53.8;40.7
31;2021-07-21;7040;11530;761277;581206;54.3;41.5
31;2021-07-22;8165;11757;769442;592963;54.9;42.3
31;2021-07-23;7474;11811;776916;604774;55.5;43.2
31;2021-07-24;10312;10572;787228;615346;56.2;43.9
31;2021-07-25;7560;8802;794788;624148;56.7;44.6
31;2021-07-26;5513;9543;800301;633691;57.1;45.2
31;2021-07-27;7962;9197;808263;642888;57.7;45.9
31;2021-07-28;8676;8282;816939;651170;58.3;46.5
31;2021-07-29;8854;8047;825793;659217;58.9;47.1
31;2021-07-30;7672;7987;833465;667204;59.5;47.6
31;2021-07-31;6015;7393;839480;674597;59.9;48.2
31;2021-08-01;4431;4302;843911;678899;60.2;48.5
31;2021-08-02;5488;5418;849399;684317;60.6;48.8
31;2021-08-03;5895;5186;855294;689503;61.1;49.2
31;2021-08-04;5925;4805;861219;694308;61.5;49.6
31;2021-08-05;5585;7230;866804;701538;61.9;50.1
31;2021-08-06;5301;7343;872105;708881;62.3;50.6
31;2021-08-07;4596;6651;876701;715532;62.6;51.1
31;2021-08-08;3385;5578;880086;721110;62.8;51.5
31;2021-08-09;4396;7010;884482;728120;63.1;52.0
31;2021-08-10;4686;6285;889168;734405;63.5;52.4
31;2021-08-11;4526;5859;893694;740264;63.8;52.8
31;2021-08-12;4523;6758;898217;747022;64.1;53.3
31;2021-08-13;4169;6202;902386;753224;64.4;53.8
31;2021-08-14;3033;6461;905419;759685;64.6;54.2
31;2021-08-15;1308;4096;906727;763781;64.7;54.5
31;2021-08-16;3219;8118;909946;771899;65.0;55.1
31;2021-08-17;3434;7097;913380;778996;65.2;55.6
31;2021-08-18;3314;7006;916694;786002;65.4;56.1
31;2021-08-19;2987;6994;919681;792996;65.6;56.6
31;2021-08-20;3021;7396;922702;800392;65.9;57.1
31;2021-08-21;1980;6799;924682;807191;66.0;57.6
31;2021-08-22;1486;5637;926168;812828;66.1;58.0
31;2021-08-23;2384;7728;928552;820556;66.3;58.6
31;2021-08-24;2608;6174;931160;826730;66.5;59.0
31;2021-08-25;2390;5728;933550;832458;66.6;59.4
31;2021-08-26;2278;5799;935828;838257;66.8;59.8
31;2021-08-27;2362;6662;938190;844919;67.0;60.3
31;2021-08-28;1844;6789;940034;851708;67.1;60.8
31;2021-08-29;1281;5066;941315;856774;67.2;61.2
31;2021-08-30;2141;6631;943456;863405;67.3;61.6
31;2021-08-31;2255;5573;945711;868978;67.5;62.0
31;2021-09-01;1703;5059;947414;874037;67.6;62.4
31;2021-09-02;1765;4523;949179;878560;67.8;62.7
31;2021-09-03;1782;5203;950961;883763;67.9;63.1
31;2021-09-04;2005;5942;952966;889705;68.0;63.5
31;2021-09-05;1129;2400;954095;892105;68.1;63.7
31;2021-09-06;1363;3586;955458;895691;68.2;63.9
31;2021-09-07;1259;3352;956717;899043;68.3;64.2
31;2021-09-08;1421;3956;958138;902999;68.4;64.5
31;2021-09-09;1102;3118;959240;906117;68.5;64.7
31;2021-09-10;1668;3963;960908;910080;68.6;65.0
31;2021-09-11;1288;3991;962196;914071;68.7;65.2
31;2021-09-12;541;1815;962737;915886;68.7;65.4
31;2021-09-13;1009;2628;963746;918514;68.8;65.6
31;2021-09-14;1231;2798;964977;921312;68.9;65.8
31;2021-09-15;1081;2689;966058;924001;69.0;66.0
31;2021-09-16;895;1675;966953;925676;69.0;66.1
31;2021-09-17;1072;2505;968025;928181;69.1;66.3
31;2021-09-18;851;2798;968876;930979;69.2;66.5
31;2021-09-19;318;1238;969194;932217;69.2;66.5
31;2021-09-20;605;1598;969799;933815;69.2;66.7
31;2021-09-21;823;1563;970622;935378;69.3;66.8
31;2021-09-22;833;2057;971455;937435;69.3;66.9
31;2021-09-23;771;1545;972226;938980;69.4;67.0
31;2021-09-24;837;2013;973063;940993;69.5;67.2
31;2021-09-25;663;2533;973726;943526;69.5;67.3
31;2021-09-26;245;1127;973971;944653;69.5;67.4
31;2021-09-27;683;1503;974654;946156;69.6;67.5
31;2021-09-28;727;1348;975381;947504;69.6;67.6
31;2021-09-29;755;1662;976136;949166;69.7;67.8
31;2021-09-30;711;1242;976847;950408;69.7;67.8
31;2021-10-01;821;1846;977668;952254;69.8;68.0
31;2021-10-02;758;1758;978426;954012;69.8;68.1
31;2021-10-03;107;348;978533;954360;69.8;68.1
32;2020-12-27;0;0;0;0;0.0;0.0
32;2020-12-28;0;0;0;0;0.0;0.0
32;2020-12-29;0;0;0;0;0.0;0.0
32;2020-12-30;0;0;0;0;0.0;0.0
32;2020-12-31;0;0;0;0;0.0;0.0
32;2021-01-01;0;0;0;0;0.0;0.0
32;2021-01-02;0;0;0;0;0.0;0.0
32;2021-01-03;1;0;1;0;0.0;0.0
32;2021-01-04;3;0;4;0;0.0;0.0
32;2021-01-05;1;0;5;0;0.0;0.0
32;2021-01-06;3;0;8;0;0.0;0.0
32;2021-01-07;155;0;163;0;0.1;0.0
32;2021-01-08;70;0;233;0;0.1;0.0
32;2021-01-09;5;0;238;0;0.1;0.0
32;2021-01-10;0;0;238;0;0.1;0.0
32;2021-01-11;11;0;249;0;0.1;0.0
32;2021-01-12;96;0;345;0;0.2;0.0
32;2021-01-13;325;1;670;1;0.4;0.0
32;2021-01-14;389;3;1059;4;0.6;0.0
32;2021-01-15;448;2;1507;6;0.8;0.0
32;2021-01-16;17;2;1524;8;0.8;0.0
32;2021-01-17;1;0;1525;8;0.8;0.0
32;2021-01-18;345;1;1870;9;1.0;0.0
32;2021-01-19;420;0;2290;9;1.2;0.0
32;2021-01-20;358;0;2648;9;1.4;0.0
32;2021-01-21;582;0;3230;9;1.7;0.0
32;2021-01-22;372;0;3602;9;1.9;0.0
32;2021-01-23;189;0;3791;9;2.0;0.0
32;2021-01-24;5;0;3796;9;2.0;0.0
32;2021-01-25;468;1;4264;10;2.2;0.0
32;2021-01-26;609;0;4873;10;2.6;0.0
32;2021-01-27;703;4;5576;14;2.9;0.0
32;2021-01-28;688;12;6264;26;3.3;0.0
32;2021-01-29;461;49;6725;75;3.5;0.0
32;2021-01-30;260;0;6985;75;3.7;0.0
32;2021-01-31;4;5;6989;80;3.7;0.0
32;2021-02-01;289;57;7278;137;3.8;0.1
32;2021-02-02;640;135;7918;272;4.2;0.1
32;2021-02-03;338;196;8256;468;4.3;0.2
32;2021-02-04;426;271;8682;739;4.6;0.4
32;2021-02-05;348;354;9030;1093;4.8;0.6
32;2021-02-06;148;0;9178;1093;4.8;0.6
32;2021-02-07;0;36;9178;1129;4.8;0.6
32;2021-02-08;278;108;9456;1237;5.0;0.7
32;2021-02-09;310;225;9766;1462;5.1;0.8
32;2021-02-10;272;242;10038;1704;5.3;0.9
32;2021-02-11;383;301;10421;2005;5.5;1.1
32;2021-02-12;298;226;10719;2231;5.6;1.2
32;2021-02-13;249;1;10968;2232;5.8;1.2
32;2021-02-14;0;28;10968;2260;5.8;1.2
32;2021-02-15;25;183;10993;2443;5.8;1.3
32;2021-02-16;395;339;11388;2782;6.0;1.5
32;2021-02-17;191;437;11579;3219;6.1;1.7
32;2021-02-18;333;422;11912;3641;6.3;1.9
32;2021-02-19;184;264;12096;3905;6.4;2.1
32;2021-02-20;1;70;12097;3975;6.4;2.1
32;2021-02-21;0;0;12097;3975;6.4;2.1
32;2021-02-22;158;332;12255;4307;6.4;2.3
32;2021-02-23;431;517;12686;4824;6.7;2.5
32;2021-02-24;277;336;12963;5160;6.8;2.7
32;2021-02-25;481;479;13444;5639;7.1;3.0
32;2021-02-26;444;360;13888;5999;7.3;3.2
32;2021-02-27;157;214;14045;6213;7.4;3.3
32;2021-02-28;4;0;14049;6213;7.4;3.3
32;2021-03-01;51;277;14100;6490;7.4;3.4
32;2021-03-02;414;406;14514;6896;7.6;3.6
32;2021-03-03;276;268;14790;7164;7.8;3.8
32;2021-03-04;542;320;15332;7484;8.1;3.9
32;2021-03-05;438;228;15770;7712;8.3;4.1
32;2021-03-06;520;150;16290;7862;8.6;4.1
32;2021-03-07;25;5;16315;7867;8.6;4.1
32;2021-03-08;234;278;16549;8145;8.7;4.3
32;2021-03-09;643;312;17192;8457;9.0;4.5
32;2021-03-10;482;318;17674;8775;9.3;4.6
32;2021-03-11;854;283;18528;9058;9.7;4.8
32;2021-03-12;881;335;19409;9393;10.2;4.9
32;2021-03-13;492;232;19901;9625;10.5;5.1
32;2021-03-14;1;0;19902;9625;10.5;5.1
32;2021-03-15;264;25;20166;9650;10.6;5.1
32;2021-03-16;314;303;20480;9953;10.8;5.2
32;2021-03-17;150;153;20630;10106;10.9;5.3
32;2021-03-18;375;304;21005;10410;11.1;5.5
32;2021-03-19;405;179;21410;10589;11.3;5.6
32;2021-03-20;136;33;21546;10622;11.3;5.6
32;2021-03-21;0;0;21546;10622;11.3;5.6
32;2021-03-22;340;167;21886;10789;11.5;5.7
32;2021-03-23;560;397;22446;11186;11.8;5.9
32;2021-03-24;643;267;23089;11453;12.1;6.0
32;2021-03-25;899;413;23988;11866;12.6;6.2
32;2021-03-26;657;293;24645;12159;13.0;6.4
32;2021-03-27;165;3;24810;12162;13.1;6.4
32;2021-03-28;1;1;24811;12163;13.1;6.4
32;2021-03-29;371;48;25182;12211;13.3;6.4
32;2021-03-30;766;287;25948;12498;13.7;6.6
32;2021-03-31;654;170;26602;12668;14.0;6.7
32;2021-04-01;1238;318;27840;12986;14.6;6.8
32;2021-04-02;575;167;28415;13153;15.0;6.9
32;2021-04-03;114;0;28529;13153;15.0;6.9
32;2021-04-04;0;0;28529;13153;15.0;6.9
32;2021-04-05;0;0;28529;13153;15.0;6.9
32;2021-04-06;2650;310;31179;13463;16.4;7.1
32;2021-04-07;1178;202;32357;13665;17.0;7.2
32;2021-04-08;1736;405;34093;14070;17.9;7.4
32;2021-04-09;883;218;34976;14288;18.4;7.5
32;2021-04-10;809;29;35785;14317;18.8;7.5
32;2021-04-11;14;0;35799;14317;18.8;7.5
32;2021-04-12;477;23;36276;14340;19.1;7.5
32;2021-04-13;2469;389;38745;14729;20.4;7.8
32;2021-04-14;1226;263;39971;14992;21.0;7.9
32;2021-04-15;1704;392;41675;15384;21.9;8.1
32;2021-04-16;638;282;42313;15666;22.3;8.2
32;2021-04-17;783;39;43096;15705;22.7;8.3
32;2021-04-18;13;1;43109;15706;22.7;8.3
32;2021-04-19;502;45;43611;15751;22.9;8.3
32;2021-04-20;2472;393;46083;16144;24.2;8.5
32;2021-04-21;1009;302;47092;16446;24.8;8.7
32;2021-04-22;1662;319;48754;16765;25.7;8.8
32;2021-04-23;549;158;49303;16923;25.9;8.9
32;2021-04-24;1392;57;50695;16980;26.7;8.9
32;2021-04-25;0;11;50695;16991;26.7;8.9
32;2021-04-26;387;359;51082;17350;26.9;9.1
32;2021-04-27;2551;556;53633;17906;28.2;9.4
32;2021-04-28;972;354;54605;18260;28.7;9.6
32;2021-04-29;1008;883;55613;19143;29.3;10.1
32;2021-04-30;453;363;56066;19506;29.5;10.3
32;2021-05-01;2607;97;58673;19603;30.9;10.3
32;2021-05-02;0;0;58673;19603;30.9;10.3
32;2021-05-03;170;321;58843;19924;31.0;10.5
32;2021-05-04;785;2490;59628;22414;31.4;11.8
32;2021-05-05;2360;1098;61988;23512;32.6;12.4
32;2021-05-06;516;1655;62504;25167;32.9;13.2
32;2021-05-07;2286;538;64790;25705;34.1;13.5
32;2021-05-08;70;516;64860;26221;34.1;13.8
32;2021-05-09;21;179;64881;26400;34.1;13.9
32;2021-05-10;1994;549;66875;26949;35.2;14.2
32;2021-05-11;651;2276;67526;29225;35.5;15.4
32;2021-05-12;2313;1137;69839;30362;36.7;16.0
32;2021-05-13;280;1417;70119;31779;36.9;16.7
32;2021-05-14;2223;328;72342;32107;38.1;16.9
32;2021-05-15;134;712;72476;32819;38.1;17.3
32;2021-05-16;2;0;72478;32819;38.1;17.3
32;2021-05-17;353;169;72831;32988;38.3;17.4
32;2021-05-18;1642;298;74473;33286;39.2;17.5
32;2021-05-19;2474;272;76947;33558;40.5;17.7
32;2021-05-20;2885;470;79832;34028;42.0;17.9
32;2021-05-21;2532;499;82364;34527;43.3;18.2
32;2021-05-22;334;110;82698;34637;43.5;18.2
32;2021-05-23;2;13;82700;34650;43.5;18.2
32;2021-05-24;3;0;82703;34650;43.5;18.2
32;2021-05-25;1982;373;84685;35023;44.6;18.4
32;2021-05-26;2547;556;87232;35579;45.9;18.7
32;2021-05-27;2876;626;90108;36205;47.4;19.1
32;2021-05-28;2308;766;92416;36971;48.6;19.5
32;2021-05-29;372;313;92788;37284;48.8;19.6
32;2021-05-30;4;6;92792;37290;48.8;19.6
32;2021-05-31;1413;626;94205;37916;49.6;20.0
32;2021-06-01;566;2887;94771;40803;49.9;21.5
32;2021-06-02;1580;1351;96351;42154;50.7;22.2
32;2021-06-03;395;2085;96746;44239;50.9;23.3
32;2021-06-04;1836;831;98582;45070;51.9;23.7
32;2021-06-05;206;1660;98788;46730;52.0;24.6
32;2021-06-06;8;14;98796;46744;52.0;24.6
32;2021-06-07;102;418;98898;47162;52.0;24.8
32;2021-06-08;663;2536;99561;49698;52.4;26.2
32;2021-06-09;1191;1056;100752;50754;53.0;26.7
32;2021-06-10;684;1225;101436;51979;53.4;27.4
32;2021-06-11;926;663;102362;52642;53.9;27.7
32;2021-06-12;150;2679;102512;55321;53.9;29.1
32;2021-06-13;1;1;102513;55322;53.9;29.1
32;2021-06-14;528;210;103041;55532;54.2;29.2
32;2021-06-15;1733;1025;104774;56557;55.1;29.8
32;2021-06-16;850;2777;105624;59334;55.6;31.2
32;2021-06-17;859;829;106483;60163;56.0;31.7
32;2021-06-18;315;2723;106798;62886;56.2;33.1
32;2021-06-19;914;437;107712;63323;56.7;33.3
32;2021-06-20;5;13;107717;63336;56.7;33.3
32;2021-06-21;67;1994;107784;65330;56.7;34.4
32;2021-06-22;1042;970;108826;66300;57.3;34.9
32;2021-06-23;516;2183;109342;68483;57.5;36.0
32;2021-06-24;528;517;109870;69000;57.8;36.3
32;2021-06-25;501;2360;110371;71360;58.1;37.5
32;2021-06-26;108;171;110479;71531;58.1;37.6
32;2021-06-27;2;5;110481;71536;58.1;37.6
32;2021-06-28;630;603;111111;72139;58.5;38.0
32;2021-06-29;800;1982;111911;74121;58.9;39.0
32;2021-06-30;757;2726;112668;76847;59.3;40.4
32;2021-07-01;538;2637;113206;79484;59.6;41.8
32;2021-07-02;641;2335;113847;81819;59.9;43.1
32;2021-07-03;481;506;114328;82325;60.2;43.3
32;2021-07-04;1;12;114329;82337;60.2;43.3
32;2021-07-05;76;390;114405;82727;60.2;43.5
32;2021-07-06;878;2083;115283;84810;60.7;44.6
32;2021-07-07;781;2756;116064;87566;61.1;46.1
32;2021-07-08;479;2268;116543;89834;61.3;47.3
32;2021-07-09;615;2226;117158;92060;61.6;48.4
32;2021-07-10;536;520;117694;92580;61.9;48.7
32;2021-07-11;0;5;117694;92585;61.9;48.7
32;2021-07-12;526;1244;118220;93829;62.2;49.4
32;2021-07-13;1695;1817;119915;95646;63.1;50.3
32;2021-07-14;492;35;120407;95681;63.4;50.3
32;2021-07-15;2096;892;122503;96573;64.5;50.8
32;2021-07-16;1170;1915;123673;98488;65.1;51.8
32;2021-07-17;78;129;123751;98617;65.1;51.9
32;2021-07-18;2;5;123753;98622;65.1;51.9
32;2021-07-19;1997;147;125750;98769;66.2;52.0
32;2021-07-20;2036;1272;127786;100041;67.2;52.6
32;2021-07-21;1614;1691;129400;101732;68.1;53.5
32;2021-07-22;1946;513;131346;102245;69.1;53.8
32;2021-07-23;1408;1731;132754;103976;69.9;54.7
32;2021-07-24;139;117;132893;104093;69.9;54.8
32;2021-07-25;34;10;132927;104103;69.9;54.8
32;2021-07-26;1071;1070;133998;105173;70.5;55.3
32;2021-07-27;1730;2099;135728;107272;71.4;56.4
32;2021-07-28;694;975;136422;108247;71.8;57.0
32;2021-07-29;1694;1607;138116;109854;72.7;57.8
32;2021-07-30;363;348;138479;110202;72.9;58.0
32;2021-07-31;186;350;138665;110552;73.0;58.2
32;2021-08-01;18;4;138683;110556;73.0;58.2
32;2021-08-02;82;76;138765;110632;73.0;58.2
32;2021-08-03;1174;1792;139939;112424;73.6;59.2
32;2021-08-04;633;652;140572;113076;74.0;59.5
32;2021-08-05;1106;1944;141678;115020;74.6;60.5
32;2021-08-06;563;495;142241;115515;74.8;60.8
32;2021-08-07;148;92;142389;115607;74.9;60.8
32;2021-08-08;1;0;142390;115607;74.9;60.8
32;2021-08-09;263;1826;142653;117433;75.1;61.8
32;2021-08-10;715;2077;143368;119510;75.4;62.9
32;2021-08-11;579;446;143947;119956;75.7;63.1
32;2021-08-12;933;2102;144880;122058;76.2;64.2
32;2021-08-13;178;249;145058;122307;76.3;64.4
32;2021-08-14;113;117;145171;122424;76.4;64.4
32;2021-08-15;13;21;145184;122445;76.4;64.4
32;2021-08-16;41;40;145225;122485;76.4;64.5
32;2021-08-17;573;2300;145798;124785;76.7;65.7
32;2021-08-18;310;559;146108;125344;76.9;66.0
32;2021-08-19;954;1411;147062;126755;77.4;66.7
32;2021-08-20;158;166;147220;126921;77.5;66.8
32;2021-08-21;150;192;147370;127113;77.5;66.9
32;2021-08-22;8;3;147378;127116;77.6;66.9
32;2021-08-23;42;101;147420;127217;77.6;66.9
32;2021-08-24;584;1449;148004;128666;77.9;67.7
32;2021-08-25;94;191;148098;128857;77.9;67.8
32;2021-08-26;320;2260;148418;131117;78.1;69.0
32;2021-08-27;274;553;148692;131670;78.2;69.3
32;2021-08-28;70;109;148762;131779;78.3;69.3
32;2021-08-29;1;8;148763;131787;78.3;69.3
32;2021-08-30;19;50;148782;131837;78.3;69.4
32;2021-08-31;194;1536;148976;133373;78.4;70.2
32;2021-09-01;649;829;149625;134202;78.7;70.6
32;2021-09-02;318;1734;149943;135936;78.9;71.5
32;2021-09-03;187;314;150130;136250;79.0;71.7
32;2021-09-04;49;106;150179;136356;79.0;71.8
32;2021-09-05;12;15;150191;136371;79.0;71.8
32;2021-09-06;38;103;150229;136474;79.1;71.8
32;2021-09-07;438;950;150667;137424;79.3;72.3
32;2021-09-08;255;551;150922;137975;79.4;72.6
32;2021-09-09;226;1063;151148;139038;79.5;73.2
32;2021-09-10;203;241;151351;139279;79.6;73.3
32;2021-09-11;88;160;151439;139439;79.7;73.4
32;2021-09-12;7;11;151446;139450;79.7;73.4
32;2021-09-13;4;12;151450;139462;79.7;73.4
32;2021-09-14;319;846;151769;140308;79.9;73.8
32;2021-09-15;200;145;151969;140453;80.0;73.9
32;2021-09-16;181;215;152150;140668;80.1;74.0
32;2021-09-17;199;345;152349;141013;80.2;74.2
32;2021-09-18;40;62;152389;141075;80.2;74.2
32;2021-09-19;0;2;152389;141077;80.2;74.2
32;2021-09-20;4;18;152393;141095;80.2;74.2
32;2021-09-21;241;458;152634;141553;80.3;74.5
32;2021-09-22;233;547;152867;142100;80.4;74.8
32;2021-09-23;132;219;152999;142319;80.5;74.9
32;2021-09-24;101;288;153100;142607;80.6;75.0
32;2021-09-25;28;51;153128;142658;80.6;75.1
32;2021-09-26;3;5;153131;142663;80.6;75.1
32;2021-09-27;9;29;153140;142692;80.6;75.1
32;2021-09-28;112;515;153252;143207;80.6;75.4
32;2021-09-29;88;334;153340;143541;80.7;75.5
32;2021-09-30;170;201;153510;143742;80.8;75.6
32;2021-10-01;101;242;153611;143984;80.8;75.8
32;2021-10-02;26;102;153637;144086;80.8;75.8
32;2021-10-03;0;8;153637;144094;80.8;75.8
33;2020-12-27;4;0;4;0;0.0;0.0
33;2020-12-28;4;0;8;0;0.0;0.0
33;2020-12-29;0;0;8;0;0.0;0.0
33;2020-12-30;0;0;8;0;0.0;0.0
33;2020-12-31;1;0;9;0;0.0;0.0
33;2021-01-01;0;0;9;0;0.0;0.0
33;2021-01-02;2;0;11;0;0.0;0.0
33;2021-01-03;2;0;13;0;0.0;0.0
33;2021-01-04;2;0;15;0;0.0;0.0
33;2021-01-05;2;0;17;0;0.0;0.0
33;2021-01-06;135;0;152;0;0.0;0.0
33;2021-01-07;1309;1;1461;1;0.1;0.0
33;2021-01-08;1200;2;2661;3;0.2;0.0
33;2021-01-09;298;0;2959;3;0.2;0.0
33;2021-01-10;229;0;3188;3;0.2;0.0
33;2021-01-11;628;0;3816;3;0.2;0.0
33;2021-01-12;1415;2;5231;5;0.3;0.0
33;2021-01-13;1313;9;6544;14;0.4;0.0
33;2021-01-14;1293;12;7837;26;0.5;0.0
33;2021-01-15;1610;11;9447;37;0.6;0.0
33;2021-01-16;568;6;10015;43;0.6;0.0
33;2021-01-17;406;2;10421;45;0.6;0.0
33;2021-01-18;1224;9;11645;54;0.7;0.0
33;2021-01-19;2936;8;14581;62;0.9;0.0
33;2021-01-20;3421;12;18002;74;1.1;0.0
33;2021-01-21;2864;3;20866;77;1.3;0.0
33;2021-01-22;2328;7;23194;84;1.4;0.0
33;2021-01-23;854;2;24048;86;1.5;0.0
33;2021-01-24;532;2;24580;88;1.5;0.0
33;2021-01-25;2173;55;26753;143;1.6;0.0
33;2021-01-26;2263;145;29016;288;1.8;0.0
33;2021-01-27;2263;188;31279;476;1.9;0.0
33;2021-01-28;2160;409;33439;885;2.0;0.1
33;2021-01-29;1825;633;35264;1518;2.2;0.1
33;2021-01-30;705;155;35969;1673;2.2;0.1
33;2021-01-31;390;133;36359;1806;2.2;0.1
33;2021-02-01;1457;603;37816;2409;2.3;0.1
33;2021-02-02;2646;1033;40462;3442;2.5;0.2
33;2021-02-03;2942;829;43404;4271;2.7;0.3
33;2021-02-04;4031;1276;47435;5547;2.9;0.3
33;2021-02-05;2193;1094;49628;6641;3.0;0.4
33;2021-02-06;648;172;50276;6813;3.1;0.4
33;2021-02-07;218;182;50494;6995;3.1;0.4
33;2021-02-08;1265;681;51759;7676;3.2;0.5
33;2021-02-09;1327;1431;53086;9107;3.2;0.6
33;2021-02-10;1267;1526;54353;10633;3.3;0.7
33;2021-02-11;1306;1296;55659;11929;3.4;0.7
33;2021-02-12;1121;1076;56780;13005;3.5;0.8
33;2021-02-13;204;241;56984;13246;3.5;0.8
33;2021-02-14;47;192;57031;13438;3.5;0.8
33;2021-02-15;685;1338;57716;14776;3.5;0.9
33;2021-02-16;816;1673;58532;16449;3.6;1.0
33;2021-02-17;668;1672;59200;18121;3.6;1.1
33;2021-02-18;899;1778;60099;19899;3.7;1.2
33;2021-02-19;918;1666;61017;21565;3.7;1.3
33;2021-02-20;78;458;61095;22023;3.7;1.3
33;2021-02-21;37;349;61132;22372;3.7;1.4
33;2021-02-22;709;1476;61841;23848;3.8;1.5
33;2021-02-23;1235;2147;63076;25995;3.9;1.6
33;2021-02-24;1404;2048;64480;28043;3.9;1.7
33;2021-02-25;2839;3207;67319;31250;4.1;1.9
33;2021-02-26;4059;1986;71378;33236;4.4;2.0
33;2021-02-27;1360;558;72738;33794;4.5;2.1
33;2021-02-28;127;424;72865;34218;4.5;2.1
33;2021-03-01;1536;1562;74401;35780;4.6;2.2
33;2021-03-02;2325;1494;76726;37274;4.7;2.3
33;2021-03-03;2312;1474;79038;38748;4.8;2.4
33;2021-03-04;3938;1461;82976;40209;5.1;2.5
33;2021-03-05;5762;1516;88738;41725;5.4;2.6
33;2021-03-06;3416;502;92154;42227;5.6;2.6
33;2021-03-07;741;139;92895;42366;5.7;2.6
33;2021-03-08;2712;992;95607;43358;5.9;2.7
33;2021-03-09;4404;1157;100011;44515;6.1;2.7
33;2021-03-10;5121;1126;105132;45641;6.4;2.8
33;2021-03-11;7545;1143;112677;46784;6.9;2.9
33;2021-03-12;10118;1098;122795;47882;7.5;2.9
33;2021-03-13;5155;206;127950;48088;7.8;2.9
33;2021-03-14;714;28;128664;48116;7.9;2.9
33;2021-03-15;4445;660;133109;48776;8.1;3.0
33;2021-03-16;3582;814;136691;49590;8.4;3.0
33;2021-03-17;3644;921;140335;50511;8.6;3.1
33;2021-03-18;4037;1388;144372;51899;8.8;3.2
33;2021-03-19;6270;1013;150642;52912;9.2;3.2
33;2021-03-20;3368;105;154010;53017;9.4;3.2
33;2021-03-21;462;29;154472;53046;9.5;3.2
33;2021-03-22;4901;442;159373;53488;9.8;3.3
33;2021-03-23;6324;601;165697;54089;10.1;3.3
33;2021-03-24;7076;526;172773;54615;10.6;3.3
33;2021-03-25;8843;646;181616;55261;11.1;3.4
33;2021-03-26;10038;845;191654;56106;11.7;3.4
33;2021-03-27;3620;83;195274;56189;12.0;3.4
33;2021-03-28;577;33;195851;56222;12.0;3.4
33;2021-03-29;6767;697;202618;56919;12.4;3.5
33;2021-03-30;8102;1033;210720;57952;12.9;3.5
33;2021-03-31;7577;1044;218297;58996;13.4;3.6
33;2021-04-01;8822;1191;227119;60187;13.9;3.7
33;2021-04-02;8412;1547;235531;61734;14.4;3.8
33;2021-04-03;2832;520;238363;62254;14.6;3.8
33;2021-04-04;218;160;238581;62414;14.6;3.8
33;2021-04-05;693;123;239274;62537;14.6;3.8
33;2021-04-06;6048;2679;245322;65216;15.0;4.0
33;2021-04-07;7422;2519;252744;67735;15.5;4.1
33;2021-04-08;10328;2771;263072;70506;16.1;4.3
33;2021-04-09;12688;3085;275760;73591;16.9;4.5
33;2021-04-10;5357;1391;281117;74982;17.2;4.6
33;2021-04-11;1002;351;282119;75333;17.3;4.6
33;2021-04-12;7425;3274;289544;78607;17.7;4.8
33;2021-04-13;9321;3476;298865;82083;18.3;5.0
33;2021-04-14;9038;3641;307903;85724;18.8;5.2
33;2021-04-15;10110;3875;318013;89599;19.5;5.5
33;2021-04-16;9718;4224;327731;93823;20.1;5.7
33;2021-04-17;4651;1657;332382;95480;20.3;5.8
33;2021-04-18;929;411;333311;95891;20.4;5.9
33;2021-04-19;5616;3833;338927;99724;20.7;6.1
33;2021-04-20;7294;4259;346221;103983;21.2;6.4
33;2021-04-21;6594;4341;352815;108324;21.6;6.6
33;2021-04-22;7349;4480;360164;112804;22.0;6.9
33;2021-04-23;7705;4819;367869;117623;22.5;7.2
33;2021-04-24;4500;1797;372369;119420;22.8;7.3
33;2021-04-25;1652;418;374021;119838;22.9;7.3
33;2021-04-26;5270;5076;379291;124914;23.2;7.6
33;2021-04-27;6579;5583;385870;130497;23.6;8.0
33;2021-04-28;6783;5555;392653;136052;24.0;8.3
33;2021-04-29;8425;6213;401078;142265;24.6;8.7
33;2021-04-30;8740;6091;409818;148356;25.1;9.1
33;2021-05-01;2902;513;412720;148869;25.3;9.1
33;2021-05-02;1835;346;414555;149215;25.4;9.1
33;2021-05-03;7018;5204;421573;154419;25.8;9.5
33;2021-05-04;6826;6651;428399;161070;26.2;9.9
33;2021-05-05;7140;7562;435539;168632;26.7;10.3
33;2021-05-06;8705;8219;444244;176851;27.2;10.8
33;2021-05-07;8610;8867;452854;185718;27.7;11.4
33;2021-05-08;3543;1586;456397;187304;27.9;11.5
33;2021-05-09;1118;969;457515;188273;28.0;11.5
33;2021-05-10;6874;7288;464389;195561;28.4;12.0
33;2021-05-11;8634;7852;473023;203413;29.0;12.5
33;2021-05-12;9175;6698;482198;210111;29.5;12.9
33;2021-05-13;5210;2109;487408;212220;29.8;13.0
33;2021-05-14;8129;5350;495537;217570;30.3;13.3
33;2021-05-15;5179;2865;500716;220435;30.7;13.5
33;2021-05-16;1842;804;502558;221239;30.8;13.5
33;2021-05-17;8861;5108;511419;226347;31.3;13.9
33;2021-05-18;10625;4872;522044;231219;32.0;14.2
33;2021-05-19;10900;4775;532944;235994;32.6;14.4
33;2021-05-20;10907;5581;543851;241575;33.3;14.8
33;2021-05-21;10915;6235;554766;247810;34.0;15.2
33;2021-05-22;5121;2749;559887;250559;34.3;15.3
33;2021-05-23;1751;385;561638;250944;34.4;15.4
33;2021-05-24;5412;1001;567050;251945;34.7;15.4
33;2021-05-25;9391;5762;576441;257707;35.3;15.8
33;2021-05-26;9676;6032;586117;263739;35.9;16.1
33;2021-05-27;10901;7705;597018;271444;36.5;16.6
33;2021-05-28;10063;9480;607081;280924;37.2;17.2
33;2021-05-29;5042;4115;612123;285039;37.5;17.5
33;2021-05-30;1703;667;613826;285706;37.6;17.5
33;2021-05-31;8551;6404;622377;292110;38.1;17.9
33;2021-06-01;11804;8694;634181;300804;38.8;18.4
33;2021-06-02;11710;8195;645891;308999;39.5;18.9
33;2021-06-03;12715;9185;658606;318184;40.3;19.5
33;2021-06-04;12933;10931;671539;329115;41.1;20.1
33;2021-06-05;5272;5053;676811;334168;41.4;20.5
33;2021-06-06;2525;1193;679336;335361;41.6;20.5
33;2021-06-07;9759;8495;689095;343856;42.2;21.1
33;2021-06-08;11938;9441;701033;353297;42.9;21.6
33;2021-06-09;11775;8515;712808;361812;43.6;22.2
33;2021-06-10;12950;8382;725758;370194;44.4;22.7
33;2021-06-11;12516;11150;738274;381344;45.2;23.3
33;2021-06-12;6185;4477;744459;385821;45.6;23.6
33;2021-06-13;2612;1283;747071;387104;45.7;23.7
33;2021-06-14;8580;10150;755651;397254;46.3;24.3
33;2021-06-15;12053;10253;767704;407507;47.0;24.9
33;2021-06-16;12057;8864;779761;416371;47.7;25.5
33;2021-06-17;13116;9605;792877;425976;48.5;26.1
33;2021-06-18;11797;11430;804674;437406;49.3;26.8
33;2021-06-19;5610;4819;810284;442225;49.6;27.1
33;2021-06-20;2946;1475;813230;443700;49.8;27.2
33;2021-06-21;7875;10164;821105;453864;50.3;27.8
33;2021-06-22;9064;11074;830169;464938;50.8;28.5
33;2021-06-23;8671;10840;838840;475778;51.4;29.1
33;2021-06-24;9743;9979;848583;485757;52.0;29.7
33;2021-06-25;8047;13709;856630;499466;52.4;30.6
33;2021-06-26;4344;5916;860974;505382;52.7;30.9
33;2021-06-27;2467;1959;863441;507341;52.9;31.1
33;2021-06-28;4871;12754;868312;520095;53.2;31.8
33;2021-06-29;6443;13652;874755;533747;53.6;32.7
33;2021-06-30;6681;13387;881436;547134;54.0;33.5
33;2021-07-01;8046;11806;889482;558940;54.5;34.2
33;2021-07-02;6844;15106;896326;574046;54.9;35.1
33;2021-07-03;3227;6783;899553;580829;55.1;35.6
33;2021-07-04;2065;2379;901618;583208;55.2;35.7
33;2021-07-05;4398;12903;906016;596111;55.5;36.5
33;2021-07-06;6147;14588;912163;610699;55.8;37.4
33;2021-07-07;6895;13041;919058;623740;56.3;38.2
33;2021-07-08;7971;12753;927029;636493;56.8;39.0
33;2021-07-09;6471;15110;933500;651603;57.1;39.9
33;2021-07-10;3114;7159;936614;658762;57.3;40.3
33;2021-07-11;1844;2303;938458;661065;57.5;40.5
33;2021-07-12;3950;14701;942408;675766;57.7;41.4
33;2021-07-13;7153;16098;949561;691864;58.1;42.4
33;2021-07-14;3689;5315;953250;697179;58.4;42.7
33;2021-07-15;7627;15977;960877;713156;58.8;43.7
33;2021-07-16;8588;15137;969465;728293;59.4;44.6
33;2021-07-17;3155;6429;972620;734722;59.5;45.0
33;2021-07-18;1702;3205;974322;737927;59.6;45.2
33;2021-07-19;5872;15088;980194;753015;60.0;46.1
33;2021-07-20;7430;16118;987624;769133;60.5;47.1
33;2021-07-21;8370;14531;995994;783664;61.0;48.0
33;2021-07-22;9365;15097;1005359;798761;61.5;48.9
33;2021-07-23;9666;16346;1015025;815107;62.1;49.9
33;2021-07-24;3836;7550;1018861;822657;62.4;50.4
33;2021-07-25;2093;2667;1020954;825324;62.5;50.5
33;2021-07-26;6966;13414;1027920;838738;62.9;51.3
33;2021-07-27;10091;13392;1038011;852130;63.5;52.2
33;2021-07-28;10929;11965;1048940;864095;64.2;52.9
33;2021-07-29;11673;11903;1060613;875998;64.9;53.6
33;2021-07-30;11399;12206;1072012;888204;65.6;54.4
33;2021-07-31;4761;5647;1076773;893851;65.9;54.7
33;2021-08-01;2484;1951;1079257;895802;66.1;54.8
33;2021-08-02;8417;9889;1087674;905691;66.6;55.4
33;2021-08-03;11560;9021;1099234;914712;67.3;56.0
33;2021-08-04;12284;7365;1111518;922077;68.0;56.5
33;2021-08-05;11933;8043;1123451;930120;68.8;56.9
33;2021-08-06;11230;9056;1134681;939176;69.5;57.5
33;2021-08-07;5929;4517;1140610;943693;69.8;57.8
33;2021-08-08;3201;1820;1143811;945513;70.0;57.9
33;2021-08-09;8662;8721;1152473;954234;70.6;58.4
33;2021-08-10;9373;8448;1161846;962682;71.1;58.9
33;2021-08-11;8113;7584;1169959;970266;71.6;59.4
33;2021-08-12;7980;8019;1177939;978285;72.1;59.9
33;2021-08-13;7846;7679;1185785;985964;72.6;60.4
33;2021-08-14;3526;4332;1189311;990296;72.8;60.6
33;2021-08-15;1211;1881;1190522;992177;72.9;60.7
33;2021-08-16;6428;8628;1196950;1000805;73.3;61.3
33;2021-08-17;6638;9069;1203588;1009874;73.7;61.8
33;2021-08-18;5629;8771;1209217;1018645;74.0;62.4
33;2021-08-19;5506;9119;1214723;1027764;74.4;62.9
33;2021-08-20;4961;9835;1219684;1037599;74.7;63.5
33;2021-08-21;2208;5036;1221892;1042635;74.8;63.8
33;2021-08-22;565;2366;1222457;1045001;74.8;64.0
33;2021-08-23;3921;10288;1226378;1055289;75.1;64.6
33;2021-08-24;4140;11094;1230518;1066383;75.3;65.3
33;2021-08-25;3721;10488;1234239;1076871;75.6;65.9
33;2021-08-26;3658;11056;1237897;1087927;75.8;66.6
33;2021-08-27;3825;12585;1241722;1100512;76.0;67.4
33;2021-08-28;1578;6639;1243300;1107151;76.1;67.8
33;2021-08-29;454;2426;1243754;1109577;76.1;67.9
33;2021-08-30;2357;10537;1246111;1120114;76.3;68.6
33;2021-08-31;3248;11072;1249359;1131186;76.5;69.3
33;2021-09-01;2838;8818;1252197;1140004;76.7;69.8
33;2021-09-02;2687;8396;1254884;1148400;76.8;70.3
33;2021-09-03;3105;10139;1257989;1158539;77.0;70.9
33;2021-09-04;1643;6083;1259632;1164622;77.1;71.3
33;2021-09-05;413;1517;1260045;1166139;77.1;71.4
33;2021-09-06;1597;7182;1261642;1173321;77.2;71.8
33;2021-09-07;2066;6578;1263708;1179899;77.4;72.2
33;2021-09-08;1756;6596;1265464;1186495;77.5;72.6
33;2021-09-09;1887;6743;1267351;1193238;77.6;73.1
33;2021-09-10;2091;7285;1269442;1200523;77.7;73.5
33;2021-09-11;996;4494;1270438;1205017;77.8;73.8
33;2021-09-12;130;610;1270568;1205627;77.8;73.8
33;2021-09-13;1461;4785;1272029;1210412;77.9;74.1
33;2021-09-14;1557;5144;1273586;1215556;78.0;74.4
33;2021-09-15;1536;4441;1275122;1219997;78.1;74.7
33;2021-09-16;1474;3347;1276596;1223344;78.2;74.9
33;2021-09-17;1789;4515;1278385;1227859;78.3;75.2
33;2021-09-18;605;3050;1278990;1230909;78.3;75.4
33;2021-09-19;115;398;1279105;1231307;78.3;75.4
33;2021-09-20;1046;2158;1280151;1233465;78.4;75.5
33;2021-09-21;955;2449;1281106;1235914;78.4;75.7
33;2021-09-22;959;3443;1282065;1239357;78.5;75.9
33;2021-09-23;900;2305;1282965;1241662;78.5;76.0
33;2021-09-24;1289;3720;1284254;1245382;78.6;76.2
33;2021-09-25;515;2355;1284769;1247737;78.7;76.4
33;2021-09-26;64;333;1284833;1248070;78.7;76.4
33;2021-09-27;666;2013;1285499;1250083;78.7;76.5
33;2021-09-28;824;2147;1286323;1252230;78.7;76.7
33;2021-09-29;884;2211;1287207;1254441;78.8;76.8
33;2021-09-30;683;1682;1287890;1256123;78.8;76.9
33;2021-10-01;1054;2681;1288944;1258804;78.9;77.1
33;2021-10-02;557;1350;1289501;1260154;78.9;77.1
33;2021-10-03;6;44;1289507;1260198;78.9;77.1
34;2020-12-27;1;0;1;0;0.0;0.0
34;2020-12-28;3;0;4;0;0.0;0.0
34;2020-12-29;0;0;4;0;0.0;0.0
34;2020-12-30;0;0;4;0;0.0;0.0
34;2020-12-31;0;0;4;0;0.0;0.0
34;2021-01-01;1;0;5;0;0.0;0.0
34;2021-01-02;2;0;7;0;0.0;0.0
34;2021-01-03;0;0;7;0;0.0;0.0
34;2021-01-04;23;0;30;0;0.0;0.0
34;2021-01-05;107;2;137;2;0.0;0.0
34;2021-01-06;199;1;336;3;0.0;0.0
34;2021-01-07;364;0;700;3;0.1;0.0
34;2021-01-08;606;0;1306;3;0.1;0.0
34;2021-01-09;244;0;1550;3;0.1;0.0
34;2021-01-10;94;1;1644;4;0.1;0.0
34;2021-01-11;567;2;2211;6;0.2;0.0
34;2021-01-12;1009;1;3220;7;0.3;0.0
34;2021-01-13;1098;6;4318;13;0.4;0.0
34;2021-01-14;1954;12;6272;25;0.5;0.0
34;2021-01-15;1471;4;7743;29;0.7;0.0
34;2021-01-16;332;7;8075;36;0.7;0.0
34;2021-01-17;235;1;8310;37;0.7;0.0
34;2021-01-18;1124;3;9434;40;0.8;0.0
34;2021-01-19;1610;8;11044;48;0.9;0.0
34;2021-01-20;2090;8;13134;56;1.1;0.0
34;2021-01-21;4234;11;17368;67;1.5;0.0
34;2021-01-22;2556;8;19924;75;1.7;0.0
34;2021-01-23;600;2;20524;77;1.7;0.0
34;2021-01-24;3;0;20527;77;1.7;0.0
34;2021-01-25;1242;5;21769;82;1.9;0.0
34;2021-01-26;1461;17;23230;99;2.0;0.0
34;2021-01-27;1471;23;24701;122;2.1;0.0
34;2021-01-28;1394;120;26095;242;2.2;0.0
34;2021-01-29;1260;124;27355;366;2.3;0.0
34;2021-01-30;479;12;27834;378;2.4;0.0
34;2021-01-31;4;0;27838;378;2.4;0.0
34;2021-02-01;1028;220;28866;598;2.5;0.1
34;2021-02-02;1462;400;30328;998;2.6;0.1
34;2021-02-03;2654;484;32982;1482;2.8;0.1
34;2021-02-04;2318;835;35300;2317;3.0;0.2
34;2021-02-05;1891;1070;37191;3387;3.2;0.3
34;2021-02-06;497;209;37688;3596;3.2;0.3
34;2021-02-07;34;95;37722;3691;3.2;0.3
34;2021-02-08;860;955;38582;4646;3.3;0.4
34;2021-02-09;1034;1185;39616;5831;3.4;0.5
34;2021-02-10;1296;1338;40912;7169;3.5;0.6
34;2021-02-11;1794;2423;42706;9592;3.6;0.8
34;2021-02-12;1922;1459;44628;11051;3.8;0.9
34;2021-02-13;357;435;44985;11486;3.8;1.0
34;2021-02-14;22;271;45007;11757;3.8;1.0
34;2021-02-15;673;846;45680;12603;3.9;1.1
34;2021-02-16;666;1130;46346;13733;3.9;1.2
34;2021-02-17;714;1164;47060;14897;4.0;1.3
34;2021-02-18;837;1115;47897;16012;4.1;1.4
34;2021-02-19;816;902;48713;16914;4.1;1.4
34;2021-02-20;300;336;49013;17250;4.2;1.5
34;2021-02-21;64;18;49077;17268;4.2;1.5
34;2021-02-22;630;978;49707;18246;4.2;1.6
34;2021-02-23;565;1107;50272;19353;4.3;1.6
34;2021-02-24;943;1926;51215;21279;4.4;1.8
34;2021-02-25;1607;1885;52822;23164;4.5;2.0
34;2021-02-26;1850;1332;54672;24496;4.6;2.1
34;2021-02-27;702;316;55374;24812;4.7;2.1
34;2021-02-28;86;61;55460;24873;4.7;2.1
34;2021-03-01;932;938;56392;25811;4.8;2.2
34;2021-03-02;1592;1047;57984;26858;4.9;2.3
34;2021-03-03;1835;1129;59819;27987;5.1;2.4
34;2021-03-04;2867;1386;62686;29373;5.3;2.5
34;2021-03-05;3686;1359;66372;30732;5.6;2.6
34;2021-03-06;2639;175;69011;30907;5.9;2.6
34;2021-03-07;1242;56;70253;30963;6.0;2.6
34;2021-03-08;2781;839;73034;31802;6.2;2.7
34;2021-03-09;4019;1248;77053;33050;6.6;2.8
34;2021-03-10;3991;1182;81044;34232;6.9;2.9
34;2021-03-11;5437;1190;86481;35422;7.4;3.0
34;2021-03-12;6492;853;92973;36275;7.9;3.1
34;2021-03-13;3138;164;96111;36439;8.2;3.1
34;2021-03-14;1003;54;97114;36493;8.3;3.1
34;2021-03-15;3307;551;100421;37044;8.5;3.1
34;2021-03-16;2912;638;103333;37682;8.8;3.2
34;2021-03-17;3305;735;106638;38417;9.1;3.3
34;2021-03-18;3450;906;110088;39323;9.4;3.3
34;2021-03-19;4692;787;114780;40110;9.8;3.4
34;2021-03-20;3148;65;117928;40175;10.0;3.4
34;2021-03-21;1997;60;119925;40235;10.2;3.4
34;2021-03-22;3683;460;123608;40695;10.5;3.5
34;2021-03-23;4961;534;128569;41229;10.9;3.5
34;2021-03-24;5221;627;133790;41856;11.4;3.6
34;2021-03-25;7197;715;140987;42571;12.0;3.6
34;2021-03-26;7169;572;148156;43143;12.6;3.7
34;2021-03-27;2373;85;150529;43228;12.8;3.7
34;2021-03-28;699;21;151228;43249;12.9;3.7
34;2021-03-29;4186;751;155414;44000;13.2;3.7
34;2021-03-30;5221;961;160635;44961;13.7;3.8
34;2021-03-31;5068;1204;165703;46165;14.1;3.9
34;2021-04-01;7031;1037;172734;47202;14.7;4.0
34;2021-04-02;5822;1191;178556;48393;15.2;4.1
34;2021-04-03;1137;85;179693;48478;15.3;4.1
34;2021-04-04;166;5;179859;48483;15.3;4.1
34;2021-04-05;433;26;180292;48509;15.3;4.1
34;2021-04-06;3136;2440;183428;50949;15.6;4.3
34;2021-04-07;3387;2631;186815;53580;15.9;4.6
34;2021-04-08;5251;2801;192066;56381;16.3;4.8
34;2021-04-09;8072;2493;200138;58874;17.0;5.0
34;2021-04-10;3164;1373;203302;60247;17.3;5.1
34;2021-04-11;1715;805;205017;61052;17.4;5.2
34;2021-04-12;4500;2518;209517;63570;17.8;5.4
34;2021-04-13;5240;3051;214757;66621;18.3;5.7
34;2021-04-14;5621;3238;220378;69859;18.7;5.9
34;2021-04-15;6996;3166;227374;73025;19.3;6.2
34;2021-04-16;6580;3158;233954;76183;19.9;6.5
34;2021-04-17;2378;2068;236332;78251;20.1;6.7
34;2021-04-18;988;1717;237320;79968;20.2;6.8
34;2021-04-19;3421;3119;240741;83087;20.5;7.1
34;2021-04-20;3767;3657;244508;86744;20.8;7.4
34;2021-04-21;4241;3717;248749;90461;21.1;7.7
34;2021-04-22;4490;4595;253239;95056;21.5;8.1
34;2021-04-23;5378;3514;258617;98570;22.0;8.4
34;2021-04-24;3165;1579;261782;100149;22.3;8.5
34;2021-04-25;1919;644;263701;100793;22.4;8.6
34;2021-04-26;4223;3469;267924;104262;22.8;8.9
34;2021-04-27;5128;4005;273052;108267;23.2;9.2
34;2021-04-28;5771;3539;278823;111806;23.7;9.5
34;2021-04-29;6421;3925;285244;115731;24.3;9.8
34;2021-04-30;7870;3257;293114;118988;24.9;10.1
34;2021-05-01;2405;499;295519;119487;25.1;10.2
34;2021-05-02;3260;322;298779;119809;25.4;10.2
34;2021-05-03;6576;2904;305355;122713;26.0;10.4
34;2021-05-04;7109;3792;312464;126505;26.6;10.8
34;2021-05-05;6498;4528;318962;131033;27.1;11.1
34;2021-05-06;6944;5191;325906;136224;27.7;11.6
34;2021-05-07;6927;5657;332833;141881;28.3;12.1
34;2021-05-08;3609;1172;336442;143053;28.6;12.2
34;2021-05-09;2178;1288;338620;144341;28.8;12.3
34;2021-05-10;5853;4797;344473;149138;29.3;12.7
34;2021-05-11;7411;5307;351884;154445;29.9;13.1
34;2021-05-12;7755;4454;359639;158899;30.6;13.5
34;2021-05-13;6128;785;365767;159684;31.1;13.6
34;2021-05-14;7491;3734;373258;163418;31.7;13.9
34;2021-05-15;4863;1686;378121;165104;32.1;14.0
34;2021-05-16;4949;460;383070;165564;32.6;14.1
34;2021-05-17;8693;1983;391763;167547;33.3;14.2
34;2021-05-18;9142;1973;400905;169520;34.1;14.4
34;2021-05-19;8625;1811;409530;171331;34.8;14.6
34;2021-05-20;8866;2517;418396;173848;35.6;14.8
34;2021-05-21;8784;3204;427180;177052;36.3;15.1
34;2021-05-22;5787;1153;432967;178205;36.8;15.2
34;2021-05-23;3883;549;436850;178754;37.1;15.2
34;2021-05-24;1896;852;438746;179606;37.3;15.3
34;2021-05-25;7143;3811;445889;183417;37.9;15.6
34;2021-05-26;8319;3033;454208;186450;38.6;15.9
34;2021-05-27;8316;4307;462524;190757;39.3;16.2
34;2021-05-28;8063;5439;470587;196196;40.0;16.7
34;2021-05-29;4006;3101;474593;199297;40.4;16.9
34;2021-05-30;1985;1389;476578;200686;40.5;17.1
34;2021-05-31;5878;5247;482456;205933;41.0;17.5
34;2021-06-01;6948;6091;489404;212024;41.6;18.0
34;2021-06-02;6136;5810;495540;217834;42.1;18.5
34;2021-06-03;7705;6478;503245;224312;42.8;19.1
34;2021-06-04;7651;7582;510896;231894;43.4;19.7
34;2021-06-05;4140;3678;515036;235572;43.8;20.0
34;2021-06-06;3266;1865;518302;237437;44.1;20.2
34;2021-06-07;4414;6759;522716;244196;44.4;20.8
34;2021-06-08;5854;6826;528570;251022;44.9;21.3
34;2021-06-09;5826;6840;534396;257862;45.4;21.9
34;2021-06-10;6322;6865;540718;264727;46.0;22.5
34;2021-06-11;5400;9275;546118;274002;46.4;23.3
34;2021-06-12;3166;4726;549284;278728;46.7;23.7
34;2021-06-13;1081;1905;550365;280633;46.8;23.9
34;2021-06-14;3443;7810;553808;288443;47.1;24.5
34;2021-06-15;3951;8789;557759;297232;47.4;25.3
34;2021-06-16;4619;7856;562378;305088;47.8;25.9
34;2021-06-17;4228;7950;566606;313038;48.2;26.6
34;2021-06-18;4350;9327;570956;322365;48.5;27.4
34;2021-06-19;2729;4403;573685;326768;48.8;27.8
34;2021-06-20;888;2873;574573;329641;48.9;28.0
34;2021-06-21;2180;8553;576753;338194;49.0;28.8
34;2021-06-22;2974;9405;579727;347599;49.3;29.6
34;2021-06-23;3528;8963;583255;356562;49.6;30.3
34;2021-06-24;3559;8671;586814;365233;49.9;31.1
34;2021-06-25;3374;10439;590188;375672;50.2;31.9
34;2021-06-26;1641;6190;591829;381862;50.3;32.5
34;2021-06-27;308;4268;592137;386130;50.3;32.8
34;2021-06-28;2265;9426;594402;395556;50.5;33.6
34;2021-06-29;2682;10295;597084;405851;50.8;34.5
34;2021-06-30;3356;9543;600440;415394;51.1;35.3
34;2021-07-01;3529;9445;603969;424839;51.4;36.1
34;2021-07-02;3433;9739;607402;434578;51.6;36.9
34;2021-07-03;1682;6158;609084;440736;51.8;37.5
34;2021-07-04;312;2763;609396;443499;51.8;37.7
34;2021-07-05;3234;7998;612630;451497;52.1;38.4
34;2021-07-06;3532;9175;616162;460672;52.4;39.2
34;2021-07-07;3273;8652;619435;469324;52.7;39.9
34;2021-07-08;4303;8869;623738;478193;53.0;40.7
34;2021-07-09;4009;9348;627747;487541;53.4;41.5
34;2021-07-10;2140;5717;629887;493258;53.6;41.9
34;2021-07-11;923;2576;630810;495834;53.6;42.2
34;2021-07-12;2929;8966;633739;504800;53.9;42.9
34;2021-07-13;4657;10041;638396;514841;54.3;43.8
34;2021-07-14;784;356;639180;515197;54.3;43.8
34;2021-07-15;5911;10396;645091;525593;54.8;44.7
34;2021-07-16;5860;10727;650951;536320;55.3;45.6
34;2021-07-17;4499;4415;655450;540735;55.7;46.0
34;2021-07-18;235;195;655685;540930;55.7;46.0
34;2021-07-19;5117;8329;660802;549259;56.2;46.7
34;2021-07-20;6896;8386;667698;557645;56.8;47.4
34;2021-07-21;7650;7826;675348;565471;57.4;48.1
34;2021-07-22;7441;8176;682789;573647;58.1;48.8
34;2021-07-23;7842;8159;690631;581806;58.7;49.5
34;2021-07-24;6150;3057;696781;584863;59.2;49.7
34;2021-07-25;3210;548;699991;585411;59.5;49.8
34;2021-07-26;6238;6429;706229;591840;60.0;50.3
34;2021-07-27;8755;6056;714984;597896;60.8;50.8
34;2021-07-28;9711;5923;724695;603819;61.6;51.3
34;2021-07-29;11326;6053;736021;609872;62.6;51.9
34;2021-07-30;9848;6539;745869;616411;63.4;52.4
34;2021-07-31;6445;2197;752314;618608;64.0;52.6
34;2021-08-01;3316;619;755630;619227;64.2;52.6
34;2021-08-02;7359;5066;762989;624293;64.9;53.1
34;2021-08-03;8143;5400;771132;629693;65.6;53.5
34;2021-08-04;8446;4568;779578;634261;66.3;53.9
34;2021-08-05;7135;5028;786713;639289;66.9;54.4
34;2021-08-06;6124;5229;792837;644518;67.4;54.8
34;2021-08-07;3109;2437;795946;646955;67.7;55.0
34;2021-08-08;202;204;796148;647159;67.7;55.0
34;2021-08-09;4781;6180;800929;653339;68.1;55.5
34;2021-08-10;5396;6484;806325;659823;68.6;56.1
34;2021-08-11;4831;6544;811156;666367;69.0;56.7
34;2021-08-12;4576;6200;815732;672567;69.4;57.2
34;2021-08-13;4109;5738;819841;678305;69.7;57.7
34;2021-08-14;1797;2880;821638;681185;69.9;57.9
34;2021-08-15;209;194;821847;681379;69.9;57.9
34;2021-08-16;2904;7548;824751;688927;70.1;58.6
34;2021-08-17;3592;8281;828343;697208;70.4;59.3
34;2021-08-18;3206;7563;831549;704771;70.7;59.9
34;2021-08-19;3268;7784;834817;712555;71.0;60.6
34;2021-08-20;2725;7721;837542;720276;71.2;61.2
34;2021-08-21;1399;3563;838941;723839;71.3;61.5
34;2021-08-22;163;308;839104;724147;71.3;61.6
34;2021-08-23;2330;8655;841434;732802;71.5;62.3
34;2021-08-24;2727;8962;844161;741764;71.8;63.1
34;2021-08-25;2345;8540;846506;750304;72.0;63.8
34;2021-08-26;2607;7888;849113;758192;72.2;64.5
34;2021-08-27;2196;7571;851309;765763;72.4;65.1
34;2021-08-28;1117;3561;852426;769324;72.5;65.4
34;2021-08-29;368;1357;852794;770681;72.5;65.5
34;2021-08-30;2054;6883;854848;777564;72.7;66.1
34;2021-08-31;2119;6840;856967;784404;72.9;66.7
34;2021-09-01;2052;6427;859019;790831;73.0;67.2
34;2021-09-02;1666;4828;860685;795659;73.2;67.6
34;2021-09-03;1766;5561;862451;801220;73.3;68.1
34;2021-09-04;1361;3377;863812;804597;73.4;68.4
34;2021-09-05;141;240;863953;804837;73.5;68.4
34;2021-09-06;1150;4057;865103;808894;73.6;68.8
34;2021-09-07;1349;4125;866452;813019;73.7;69.1
34;2021-09-08;1629;4777;868081;817796;73.8;69.5
34;2021-09-09;1182;3858;869263;821654;73.9;69.9
34;2021-09-10;1520;4093;870783;825747;74.0;70.2
34;2021-09-11;1280;2072;872063;827819;74.1;70.4
34;2021-09-12;90;88;872153;827907;74.2;70.4
34;2021-09-13;993;3305;873146;831212;74.2;70.7
34;2021-09-14;1223;3267;874369;834479;74.3;71.0
34;2021-09-15;1477;2951;875846;837430;74.5;71.2
34;2021-09-16;879;1875;876725;839305;74.5;71.4
34;2021-09-17;1108;2418;877833;841723;74.6;71.6
34;2021-09-18;781;1761;878614;843484;74.7;71.7
34;2021-09-19;36;59;878650;843543;74.7;71.7
34;2021-09-20;608;1907;879258;845450;74.8;71.9
34;2021-09-21;608;1777;879866;847227;74.8;72.0
34;2021-09-22;829;2527;880695;849754;74.9;72.2
34;2021-09-23;669;1657;881364;851411;74.9;72.4
34;2021-09-24;842;2220;882206;853631;75.0;72.6
34;2021-09-25;492;1555;882698;855186;75.1;72.7
34;2021-09-26;51;142;882749;855328;75.1;72.7
34;2021-09-27;620;1475;883369;856803;75.1;72.8
34;2021-09-28;629;1126;883998;857929;75.2;72.9
34;2021-09-29;848;1806;884846;859735;75.2;73.1
34;2021-09-30;601;1342;885447;861077;75.3;73.2
34;2021-10-01;711;1496;886158;862573;75.3;73.3
34;2021-10-02;646;1383;886804;863956;75.4;73.5
34;2021-10-03;57;160;886861;864116;75.4;73.5
35;2020-12-27;0;0;0;0;0.0;0.0
35;2020-12-28;0;0;0;0;0.0;0.0
35;2020-12-29;2;0;2;0;0.0;0.0
35;2020-12-30;0;0;2;0;0.0;0.0
35;2020-12-31;3;0;5;0;0.0;0.0
35;2021-01-01;3;0;8;0;0.0;0.0
35;2021-01-02;1;0;9;0;0.0;0.0
35;2021-01-03;0;0;9;0;0.0;0.0
35;2021-01-04;10;0;19;0;0.0;0.0
35;2021-01-05;110;0;129;0;0.0;0.0
35;2021-01-06;175;0;304;0;0.0;0.0
35;2021-01-07;440;1;744;1;0.1;0.0
35;2021-01-08;513;1;1257;2;0.1;0.0
35;2021-01-09;31;0;1288;2;0.1;0.0
35;2021-01-10;2;0;1290;2;0.1;0.0
35;2021-01-11;538;0;1828;2;0.2;0.0
35;2021-01-12;886;2;2714;4;0.3;0.0
35;2021-01-13;969;1;3683;5;0.3;0.0
35;2021-01-14;1261;17;4944;22;0.5;0.0
35;2021-01-15;731;2;5675;24;0.5;0.0
35;2021-01-16;189;3;5864;27;0.5;0.0
35;2021-01-17;44;0;5908;27;0.5;0.0
35;2021-01-18;1222;0;7130;27;0.7;0.0
35;2021-01-19;5406;12;12536;39;1.2;0.0
35;2021-01-20;3238;9;15774;48;1.5;0.0
35;2021-01-21;3643;5;19417;53;1.8;0.0
35;2021-01-22;2087;9;21504;62;2.0;0.0
35;2021-01-23;421;1;21925;63;2.0;0.0
35;2021-01-24;51;0;21976;63;2.0;0.0
35;2021-01-25;917;15;22893;78;2.1;0.0
35;2021-01-26;1130;126;24023;204;2.2;0.0
35;2021-01-27;1030;115;25053;319;2.3;0.0
35;2021-01-28;914;272;25967;591;2.4;0.1
35;2021-01-29;724;255;26691;846;2.5;0.1
35;2021-01-30;140;15;26831;861;2.5;0.1
35;2021-01-31;0;0;26831;861;2.5;0.1
35;2021-02-01;672;282;27503;1143;2.5;0.1
35;2021-02-02;726;410;28229;1553;2.6;0.1
35;2021-02-03;662;467;28891;2020;2.7;0.2
35;2021-02-04;590;582;29481;2602;2.7;0.2
35;2021-02-05;624;509;30105;3111;2.8;0.3
35;2021-02-06;175;4;30280;3115;2.8;0.3
35;2021-02-07;1;0;30281;3115;2.8;0.3
35;2021-02-08;446;538;30727;3653;2.8;0.3
35;2021-02-09;1715;3232;32442;6885;3.0;0.6
35;2021-02-10;1370;2517;33812;9402;3.1;0.9
35;2021-02-11;1945;3007;35757;12409;3.3;1.1
35;2021-02-12;1663;1551;37420;13960;3.5;1.3
35;2021-02-13;58;230;37478;14190;3.5;1.3
35;2021-02-14;8;46;37486;14236;3.5;1.3
35;2021-02-15;770;822;38256;15058;3.5;1.4
35;2021-02-16;919;779;39175;15837;3.6;1.5
35;2021-02-17;895;870;40070;16707;3.7;1.5
35;2021-02-18;1020;803;41090;17510;3.8;1.6
35;2021-02-19;1013;752;42103;18262;3.9;1.7
35;2021-02-20;143;38;42246;18300;3.9;1.7
35;2021-02-21;5;0;42251;18300;3.9;1.7
35;2021-02-22;776;649;43027;18949;4.0;1.8
35;2021-02-23;1287;694;44314;19643;4.1;1.8
35;2021-02-24;1404;676;45718;20319;4.2;1.9
35;2021-02-25;2249;658;47967;20977;4.4;1.9
35;2021-02-26;2599;594;50566;21571;4.7;2.0
35;2021-02-27;869;78;51435;21649;4.8;2.0
35;2021-02-28;10;0;51445;21649;4.8;2.0
35;2021-03-01;959;567;52404;22216;4.8;2.1
35;2021-03-02;1634;1805;54038;24021;5.0;2.2
35;2021-03-03;1914;861;55952;24882;5.2;2.3
35;2021-03-04;2917;1292;58869;26174;5.4;2.4
35;2021-03-05;3717;1254;62586;27428;5.8;2.5
35;2021-03-06;1337;79;63923;27507;5.9;2.5
35;2021-03-07;1;36;63924;27543;5.9;2.5
35;2021-03-08;1475;539;65399;28082;6.0;2.6
35;2021-03-09;3238;545;68637;28627;6.3;2.6
35;2021-03-10;2902;516;71539;29143;6.6;2.7
35;2021-03-11;4199;652;75738;29795;7.0;2.8
35;2021-03-12;6049;520;81787;30315;7.6;2.8
35;2021-03-13;2427;124;84214;30439;7.8;2.8
35;2021-03-14;18;25;84232;30464;7.8;2.8
35;2021-03-15;1966;658;86198;31122;8.0;2.9
35;2021-03-16;2505;714;88703;31836;8.2;2.9
35;2021-03-17;2397;588;91100;32424;8.4;3.0
35;2021-03-18;2334;580;93434;33004;8.6;3.1
35;2021-03-19;3546;496;96980;33500;9.0;3.1
35;2021-03-20;1543;108;98523;33608;9.1;3.1
35;2021-03-21;38;1;98561;33609;9.1;3.1
35;2021-03-22;1749;835;100310;34444;9.3;3.2
35;2021-03-23;3626;1167;103936;35611;9.6;3.3
35;2021-03-24;3730;982;107666;36593;9.9;3.4
35;2021-03-25;5328;980;112994;37573;10.4;3.5
35;2021-03-26;5852;801;118846;38374;11.0;3.5
35;2021-03-27;1416;208;120262;38582;11.1;3.6
35;2021-03-28;4;0;120266;38582;11.1;3.6
35;2021-03-29;2778;902;123044;39484;11.4;3.6
35;2021-03-30;4292;1311;127336;40795;11.8;3.8
35;2021-03-31;3471;1331;130807;42126;12.1;3.9
35;2021-04-01;4249;1236;135056;43362;12.5;4.0
35;2021-04-02;4861;1205;139917;44567;12.9;4.1
35;2021-04-03;763;214;140680;44781;13.0;4.1
35;2021-04-04;6;0;140686;44781;13.0;4.1
35;2021-04-05;24;1;140710;44782;13.0;4.1
35;2021-04-06;3282;2022;143992;46804;13.3;4.3
35;2021-04-07;3965;1839;147957;48643;13.7;4.5
35;2021-04-08;5803;1590;153760;50233;14.2;4.6
35;2021-04-09;7429;1413;161189;51646;14.9;4.8
35;2021-04-10;1860;250;163049;51896;15.1;4.8
35;2021-04-11;35;23;163084;51919;15.1;4.8
35;2021-04-12;5137;1593;168221;53512;15.5;4.9
35;2021-04-13;7624;2782;175845;56294;16.3;5.2
35;2021-04-14;6314;2299;182159;58593;16.8;5.4
35;2021-04-15;7565;2178;189724;60771;17.5;5.6
35;2021-04-16;8081;1761;197805;62532;18.3;5.8
35;2021-04-17;1571;222;199376;62754;18.4;5.8
35;2021-04-18;10;4;199386;62758;18.4;5.8
35;2021-04-19;4819;1667;204205;64425;18.9;6.0
35;2021-04-20;5165;2636;209370;67061;19.3;6.2
35;2021-04-21;5134;2208;214504;69269;19.8;6.4
35;2021-04-22;6428;2326;220932;71595;20.4;6.6
35;2021-04-23;6821;2365;227753;73960;21.0;6.8
35;2021-04-24;1131;261;228884;74221;21.2;6.9
35;2021-04-25;8;16;228892;74237;21.2;6.9
35;2021-04-26;5099;2153;233991;76390;21.6;7.1
35;2021-04-27;6089;3190;240080;79580;22.2;7.4
35;2021-04-28;6173;2548;246253;82128;22.8;7.6
35;2021-04-29;7117;2732;253370;84860;23.4;7.8
35;2021-04-30;7564;2521;260934;87381;24.1;8.1
35;2021-05-01;617;239;261551;87620;24.2;8.1
35;2021-05-02;15;21;261566;87641;24.2;8.1
35;2021-05-03;5307;2328;266873;89969;24.7;8.3
35;2021-05-04;5068;5316;271941;95285;25.1;8.8
35;2021-05-05;4883;4436;276824;99721;25.6;9.2
35;2021-05-06;6175;5257;282999;104978;26.2;9.7
35;2021-05-07;5620;5218;288619;110196;26.7;10.2
35;2021-05-08;1719;135;290338;110331;26.8;10.2
35;2021-05-09;698;75;291036;110406;26.9;10.2
35;2021-05-10;3719;4951;294755;115357;27.2;10.7
35;2021-05-11;4774;5795;299529;121152;27.7;11.2
35;2021-05-12;5292;5491;304821;126643;28.2;11.7
35;2021-05-13;2699;1424;307520;128067;28.4;11.8
35;2021-05-14;5460;4327;312980;132394;28.9;12.2
35;2021-05-15;2929;718;315909;133112;29.2;12.3
35;2021-05-16;997;61;316906;133173;29.3;12.3
35;2021-05-17;4474;3874;321380;137047;29.7;12.7
35;2021-05-18;5838;4315;327218;141362;30.2;13.1
35;2021-05-19;5866;3632;333084;144994;30.8;13.4
35;2021-05-20;6448;3996;339532;148990;31.4;13.8
35;2021-05-21;6139;4755;345671;153745;31.9;14.2
35;2021-05-22;2118;727;347789;154472;32.1;14.3
35;2021-05-23;688;46;348477;154518;32.2;14.3
35;2021-05-24;3206;1298;351683;155816;32.5;14.4
35;2021-05-25;5542;4271;357225;160087;33.0;14.8
35;2021-05-26;5720;4151;362945;164238;33.5;15.2
35;2021-05-27;6527;4750;369472;168988;34.1;15.6
35;2021-05-28;6330;5544;375802;174532;34.7;16.1
35;2021-05-29;2873;1137;378675;175669;35.0;16.2
35;2021-05-30;878;39;379553;175708;35.1;16.2
35;2021-05-31;6309;4381;385862;180089;35.7;16.6
35;2021-06-01;7365;5103;393227;185192;36.3;17.1
35;2021-06-02;7220;3789;400447;188981;37.0;17.5
35;2021-06-03;8155;4981;408602;193962;37.8;17.9
35;2021-06-04;7274;7442;415876;201404;38.4;18.6
35;2021-06-05;4138;1584;420014;202988;38.8;18.8
35;2021-06-06;3053;146;423067;203134;39.1;18.8
35;2021-06-07;5780;5771;428847;208905;39.6;19.3
35;2021-06-08;7604;5948;436451;214853;40.3;19.9
35;2021-06-09;8461;4807;444912;219660;41.1;20.3
35;2021-06-10;9346;4735;454258;224395;42.0;20.7
35;2021-06-11;8632;7461;462890;231856;42.8;21.4
35;2021-06-12;4684;1208;467574;233064;43.2;21.5
35;2021-06-13;3386;227;470960;233291;43.5;21.6
35;2021-06-14;6231;6517;477191;239808;44.1;22.2
35;2021-06-15;7505;6963;484696;246771;44.8;22.8
35;2021-06-16;8323;5623;493019;252394;45.6;23.3
35;2021-06-17;8896;5905;501915;258299;46.4;23.9
35;2021-06-18;8716;8088;510631;266387;47.2;24.6
35;2021-06-19;1505;2510;512136;268897;47.3;24.9
35;2021-06-20;2953;883;515089;269780;47.6;24.9
35;2021-06-21;5930;6373;521019;276153;48.2;25.5
35;2021-06-22;6841;7499;527860;283652;48.8;26.2
35;2021-06-23;7253;6143;535113;289795;49.5;26.8
35;2021-06-24;8367;5922;543480;295717;50.2;27.3
35;2021-06-25;6628;8478;550108;304195;50.8;28.1
35;2021-06-26;1107;3076;551215;307271;50.9;28.4
35;2021-06-27;2635;1031;553850;308302;51.2;28.5
35;2021-06-28;4298;7759;558148;316061;51.6;29.2
35;2021-06-29;5088;7970;563236;324031;52.1;29.9
35;2021-06-30;5602;7891;568838;331922;52.6;30.7
35;2021-07-01;6586;7540;575424;339462;53.2;31.4
35;2021-07-02;5330;9858;580754;349320;53.7;32.3
35;2021-07-03;1083;2838;581837;352158;53.8;32.5
35;2021-07-04;2149;1554;583986;353712;54.0;32.7
35;2021-07-05;3735;8209;587721;361921;54.3;33.4
35;2021-07-06;4787;9470;592508;371391;54.8;34.3
35;2021-07-07;5057;8316;597565;379707;55.2;35.1
35;2021-07-08;5387;8486;602952;388193;55.7;35.9
35;2021-07-09;3907;11545;606859;399738;56.1;36.9
35;2021-07-10;892;3147;607751;402885;56.2;37.2
35;2021-07-11;1300;2355;609051;405240;56.3;37.5
35;2021-07-12;3121;9145;612172;414385;56.6;38.3
35;2021-07-13;3980;10747;616152;425132;56.9;39.3
35;2021-07-14;2153;4450;618305;429582;57.1;39.7
35;2021-07-15;4293;10177;622598;439759;57.5;40.6
35;2021-07-16;4802;10998;627400;450757;58.0;41.7
35;2021-07-17;1988;4064;629388;454821;58.2;42.0
35;2021-07-18;844;2571;630232;457392;58.2;42.3
35;2021-07-19;3251;8970;633483;466362;58.5;43.1
35;2021-07-20;4244;10590;637727;476952;58.9;44.1
35;2021-07-21;4370;9385;642097;486337;59.3;44.9
35;2021-07-22;4852;9653;646949;495990;59.8;45.8
35;2021-07-23;4563;11009;651512;506999;60.2;46.9
35;2021-07-24;1587;4262;653099;511261;60.4;47.2
35;2021-07-25;815;2846;653914;514107;60.4;47.5
35;2021-07-26;3891;8734;657805;522841;60.8;48.3
35;2021-07-27;5281;9652;663086;532493;61.3;49.2
35;2021-07-28;5318;8670;668404;541163;61.8;50.0
35;2021-07-29;6114;8332;674518;549495;62.3;50.8
35;2021-07-30;5904;9084;680422;558579;62.9;51.6
35;2021-07-31;2322;3654;682744;562233;63.1;52.0
35;2021-08-01;1526;2415;684270;564648;63.2;52.2
35;2021-08-02;4757;6949;689027;571597;63.7;52.8
35;2021-08-03;6712;7581;695739;579178;64.3;53.5
35;2021-08-04;6712;6592;702451;585770;64.9;54.1
35;2021-08-05;6685;6981;709136;592751;65.5;54.8
35;2021-08-06;6067;7318;715203;600069;66.1;55.5
35;2021-08-07;2109;3150;717312;603219;66.3;55.7
35;2021-08-08;1523;2257;718835;605476;66.4;56.0
35;2021-08-09;4617;5534;723452;611010;66.9;56.5
35;2021-08-10;6565;6380;730017;617390;67.5;57.1
35;2021-08-11;6474;5863;736491;623253;68.1;57.6
35;2021-08-12;7014;5582;743505;628835;68.7;58.1
35;2021-08-13;6687;5065;750192;633900;69.3;58.6
35;2021-08-14;3049;1985;753241;635885;69.6;58.8
35;2021-08-15;2472;1261;755713;637146;69.8;58.9
35;2021-08-16;4872;5294;760585;642440;70.3;59.4
35;2021-08-17;6406;6081;766991;648521;70.9;59.9
35;2021-08-18;6487;5630;773478;654151;71.5;60.5
35;2021-08-19;6302;5763;779780;659914;72.1;61.0
35;2021-08-20;5134;6349;784914;666263;72.5;61.6
35;2021-08-21;2384;2633;787298;668896;72.8;61.8
35;2021-08-22;1765;1796;789063;670692;72.9;62.0
35;2021-08-23;3103;6012;792166;676704;73.2;62.5
35;2021-08-24;3500;7221;795666;683925;73.5;63.2
35;2021-08-25;3313;6616;798979;690541;73.8;63.8
35;2021-08-26;2640;6891;801619;697432;74.1;64.5
35;2021-08-27;2783;7259;804402;704691;74.3;65.1
35;2021-08-28;1178;2953;805580;707644;74.4;65.4
35;2021-08-29;517;1759;806097;709403;74.5;65.6
35;2021-08-30;1977;5496;808074;714899;74.7;66.1
35;2021-08-31;2386;6522;810460;721421;74.9;66.7
35;2021-09-01;1923;6095;812383;727516;75.1;67.2
35;2021-09-02;1839;6172;814222;733688;75.2;67.8
35;2021-09-03;2032;7046;816254;740734;75.4;68.5
35;2021-09-04;1129;4096;817383;744830;75.5;68.8
35;2021-09-05;516;2076;817899;746906;75.6;69.0
35;2021-09-06;1131;5010;819030;751916;75.7;69.5
35;2021-09-07;1323;5417;820353;757333;75.8;70.0
35;2021-09-08;1333;6263;821686;763596;75.9;70.6
35;2021-09-09;1258;5311;822944;768907;76.1;71.1
35;2021-09-10;1578;6593;824522;775500;76.2;71.7
35;2021-09-11;624;3898;825146;779398;76.3;72.0
35;2021-09-12;285;2373;825431;781771;76.3;72.2
35;2021-09-13;1310;4312;826741;786083;76.4;72.6
35;2021-09-14;1364;4451;828105;790534;76.5;73.1
35;2021-09-15;1224;4593;829329;795127;76.6;73.5
35;2021-09-16;1117;2844;830446;797971;76.7;73.7
35;2021-09-17;1268;3895;831714;801866;76.9;74.1
35;2021-09-18;513;2876;832227;804742;76.9;74.4
35;2021-09-19;167;1020;832394;805762;76.9;74.5
35;2021-09-20;1151;2647;833545;808409;77.0;74.7
35;2021-09-21;663;1926;834208;810335;77.1;74.9
35;2021-09-22;857;3621;835065;813956;77.2;75.2
35;2021-09-23;565;1532;835630;815488;77.2;75.4
35;2021-09-24;972;3038;836602;818526;77.3;75.6
35;2021-09-25;421;1958;837023;820484;77.4;75.8
35;2021-09-26;16;164;837039;820648;77.4;75.8
35;2021-09-27;518;1625;837557;822273;77.4;76.0
35;2021-09-28;460;1186;838017;823459;77.4;76.1
35;2021-09-29;609;1980;838626;825439;77.5;76.3
35;2021-09-30;349;833;838975;826272;77.5;76.4
35;2021-10-01;789;2151;839764;828423;77.6;76.6
35;2021-10-02;358;1134;840122;829557;77.6;76.7
35;2021-10-03;1;12;840123;829569;77.6;76.7
36;2020-12-27;0;0;0;0;0.0;0.0
36;2020-12-28;0;0;0;0;0.0;0.0
36;2020-12-29;0;0;0;0;0.0;0.0
36;2020-12-30;0;0;0;0;0.0;0.0
36;2020-12-31;0;0;0;0;0.0;0.0
36;2021-01-01;0;0;0;0;0.0;0.0
36;2021-01-02;0;0;0;0;0.0;0.0
36;2021-01-03;0;0;0;0;0.0;0.0
36;2021-01-04;2;0;2;0;0.0;0.0
36;2021-01-05;0;0;2;0;0.0;0.0
36;2021-01-06;24;0;26;0;0.0;0.0
36;2021-01-07;51;0;77;0;0.0;0.0
36;2021-01-08;111;0;188;0;0.1;0.0
36;2021-01-09;84;0;272;0;0.1;0.0
36;2021-01-10;142;0;414;0;0.2;0.0
36;2021-01-11;240;1;654;1;0.3;0.0
36;2021-01-12;282;0;936;1;0.4;0.0
36;2021-01-13;198;1;1134;2;0.5;0.0
36;2021-01-14;506;3;1640;5;0.8;0.0
36;2021-01-15;179;1;1819;6;0.8;0.0
36;2021-01-16;24;1;1843;7;0.8;0.0
36;2021-01-17;19;1;1862;8;0.9;0.0
36;2021-01-18;612;3;2474;11;1.1;0.0
36;2021-01-19;1173;1;3647;12;1.7;0.0
36;2021-01-20;1102;2;4749;14;2.2;0.0
36;2021-01-21;721;1;5470;15;2.5;0.0
36;2021-01-22;858;2;6328;17;2.9;0.0
36;2021-01-23;294;0;6622;17;3.0;0.0
36;2021-01-24;185;0;6807;17;3.1;0.0
36;2021-01-25;640;4;7447;21;3.4;0.0
36;2021-01-26;609;1;8056;22;3.7;0.0
36;2021-01-27;853;19;8909;41;4.1;0.0
36;2021-01-28;478;34;9387;75;4.3;0.0
36;2021-01-29;573;88;9960;163;4.6;0.1
36;2021-01-30;288;61;10248;224;4.7;0.1
36;2021-01-31;115;116;10363;340;4.8;0.2
36;2021-02-01;379;88;10742;428;4.9;0.2
36;2021-02-02;410;167;11152;595;5.1;0.3
36;2021-02-03;473;240;11625;835;5.4;0.4
36;2021-02-04;275;246;11900;1081;5.5;0.5
36;2021-02-05;301;151;12201;1232;5.6;0.6
36;2021-02-06;1;0;12202;1232;5.6;0.6
36;2021-02-07;1;0;12203;1232;5.6;0.6
36;2021-02-08;280;198;12483;1430;5.7;0.7
36;2021-02-09;328;536;12811;1966;5.9;0.9
36;2021-02-10;489;601;13300;2567;6.1;1.2
36;2021-02-11;384;566;13684;3133;6.3;1.4
36;2021-02-12;303;356;13987;3489;6.4;1.6
36;2021-02-13;126;54;14113;3543;6.5;1.6
36;2021-02-14;22;22;14135;3565;6.5;1.6
36;2021-02-15;42;443;14177;4008;6.5;1.8
36;2021-02-16;107;309;14284;4317;6.6;2.0
36;2021-02-17;117;480;14401;4797;6.6;2.2
36;2021-02-18;161;520;14562;5317;6.7;2.4
36;2021-02-19;181;408;14743;5725;6.8;2.6
36;2021-02-20;86;194;14829;5919;6.8;2.7
36;2021-02-21;87;127;14916;6046;6.9;2.8
36;2021-02-22;162;393;15078;6439;6.9;3.0
36;2021-02-23;62;498;15140;6937;7.0;3.2
36;2021-02-24;110;558;15250;7495;7.0;3.5
36;2021-02-25;251;226;15501;7721;7.1;3.6
36;2021-02-26;339;397;15840;8118;7.3;3.7
36;2021-02-27;73;216;15913;8334;7.3;3.8
36;2021-02-28;13;79;15926;8413;7.3;3.9
36;2021-03-01;218;301;16144;8714;7.4;4.0
36;2021-03-02;352;323;16496;9037;7.6;4.2
36;2021-03-03;394;482;16890;9519;7.8;4.4
36;2021-03-04;662;326;17552;9845;8.1;4.5
36;2021-03-05;800;271;18352;10116;8.5;4.7
36;2021-03-06;410;17;18762;10133;8.6;4.7
36;2021-03-07;339;8;19101;10141;8.8;4.7
36;2021-03-08;251;290;19352;10431;8.9;4.8
36;2021-03-09;449;241;19801;10672;9.1;4.9
36;2021-03-10;724;389;20525;11061;9.5;5.1
36;2021-03-11;840;237;21365;11298;9.8;5.2
36;2021-03-12;1446;295;22811;11593;10.5;5.3
36;2021-03-13;576;124;23387;11717;10.8;5.4
36;2021-03-14;113;1;23500;11718;10.8;5.4
36;2021-03-15;648;154;24148;11872;11.1;5.5
36;2021-03-16;445;67;24593;11939;11.3;5.5
36;2021-03-17;766;90;25359;12029;11.7;5.5
36;2021-03-18;414;72;25773;12101;11.9;5.6
36;2021-03-19;737;40;26510;12141;12.2;5.6
36;2021-03-20;450;26;26960;12167;12.4;5.6
36;2021-03-21;0;0;26960;12167;12.4;5.6
36;2021-03-22;497;59;27457;12226;12.6;5.6
36;2021-03-23;777;59;28234;12285;13.0;5.7
36;2021-03-24;1089;76;29323;12361;13.5;5.7
36;2021-03-25;1337;89;30660;12450;14.1;5.7
36;2021-03-26;1419;140;32079;12590;14.8;5.8
36;2021-03-27;475;43;32554;12633;15.0;5.8
36;2021-03-28;68;56;32622;12689;15.0;5.8
36;2021-03-29;462;183;33084;12872;15.2;5.9
36;2021-03-30;583;263;33667;13135;15.5;6.0
36;2021-03-31;1262;172;34929;13307;16.1;6.1
36;2021-04-01;1086;431;36015;13738;16.6;6.3
36;2021-04-02;966;143;36981;13881;17.0;6.4
36;2021-04-03;282;176;37263;14057;17.2;6.5
36;2021-04-04;42;2;37305;14059;17.2;6.5
36;2021-04-05;15;46;37320;14105;17.2;6.5
36;2021-04-06;820;361;38140;14466;17.6;6.7
36;2021-04-07;1072;539;39212;15005;18.1;6.9
36;2021-04-08;1347;479;40559;15484;18.7;7.1
36;2021-04-09;1936;402;42495;15886;19.6;7.3
36;2021-04-10;592;243;43087;16129;19.8;7.4
36;2021-04-11;256;90;43343;16219;20.0;7.5
36;2021-04-12;848;560;44191;16779;20.4;7.7
36;2021-04-13;1140;516;45331;17295;20.9;8.0
36;2021-04-14;1582;865;46913;18160;21.6;8.4
36;2021-04-15;1654;473;48567;18633;22.4;8.6
36;2021-04-16;1485;468;50052;19101;23.1;8.8
36;2021-04-17;893;250;50945;19351;23.5;8.9
36;2021-04-18;383;7;51328;19358;23.6;8.9
36;2021-04-19;874;443;52202;19801;24.0;9.1
36;2021-04-20;1145;520;53347;20321;24.6;9.4
36;2021-04-21;1240;879;54587;21200;25.1;9.8
36;2021-04-22;1593;869;56180;22069;25.9;10.2
36;2021-04-23;1329;614;57509;22683;26.5;10.4
36;2021-04-24;677;380;58186;23063;26.8;10.6
36;2021-04-25;413;94;58599;23157;27.0;10.7
36;2021-04-26;1134;446;59733;23603;27.5;10.9
36;2021-04-27;1277;551;61010;24154;28.1;11.1
36;2021-04-28;1488;1061;62498;25215;28.8;11.6
36;2021-04-29;2016;703;64514;25918;29.7;11.9
36;2021-04-30;1553;457;66067;26375;30.4;12.1
36;2021-05-01;724;62;66791;26437;30.8;12.2
36;2021-05-02;498;64;67289;26501;31.0;12.2
36;2021-05-03;1293;314;68582;26815;31.6;12.3
36;2021-05-04;780;803;69362;27618;31.9;12.7
36;2021-05-05;1282;1303;70644;28921;32.5;13.3
36;2021-05-06;2137;795;72781;29716;33.5;13.7
36;2021-05-07;1469;766;74250;30482;34.2;14.0
36;2021-05-08;306;105;74556;30587;34.3;14.1
36;2021-05-09;174;343;74730;30930;34.4;14.2
36;2021-05-10;1216;814;75946;31744;35.0;14.6
36;2021-05-11;1725;1244;77671;32988;35.8;15.2
36;2021-05-12;1827;1484;79498;34472;36.6;15.9
36;2021-05-13;548;304;80046;34776;36.9;16.0
36;2021-05-14;701;1035;80747;35811;37.2;16.5
36;2021-05-15;635;591;81382;36402;37.5;16.8
36;2021-05-16;337;377;81719;36779;37.6;16.9
36;2021-05-17;615;943;82334;37722;37.9;17.4
36;2021-05-18;874;935;83208;38657;38.3;17.8
36;2021-05-19;1333;845;84541;39502;38.9;18.2
36;2021-05-20;1611;1200;86152;40702;39.7;18.7
36;2021-05-21;1106;1064;87258;41766;40.2;19.2
36;2021-05-22;678;342;87936;42108;40.5;19.4
36;2021-05-23;428;297;88364;42405;40.7;19.5
36;2021-05-24;506;469;88870;42874;40.9;19.7
36;2021-05-25;1045;685;89915;43559;41.4;20.1
36;2021-05-26;1472;1158;91387;44717;42.1;20.6
36;2021-05-27;1397;975;92784;45692;42.7;21.0
36;2021-05-28;921;1480;93705;47172;43.2;21.7
36;2021-05-29;700;507;94405;47679;43.5;22.0
36;2021-05-30;111;572;94516;48251;43.5;22.2
36;2021-05-31;1137;763;95653;49014;44.1;22.6
36;2021-06-01;1413;829;97066;49843;44.7;23.0
36;2021-06-02;2062;614;99128;50457;45.7;23.2
36;2021-06-03;1902;1199;101030;51656;46.5;23.8
36;2021-06-04;1772;1038;102802;52694;47.3;24.3
36;2021-06-05;693;657;103495;53351;47.7;24.6
36;2021-06-06;336;272;103831;53623;47.8;24.7
36;2021-06-07;983;806;104814;54429;48.3;25.1
36;2021-06-08;957;981;105771;55410;48.7;25.5
36;2021-06-09;1675;1061;107446;56471;49.5;26.0
36;2021-06-10;1530;1381;108976;57852;50.2;26.6
36;2021-06-11;1288;1489;110264;59341;50.8;27.3
36;2021-06-12;920;779;111184;60120;51.2;27.7
36;2021-06-13;343;269;111527;60389;51.4;27.8
36;2021-06-14;605;1268;112132;61657;51.6;28.4
36;2021-06-15;733;1215;112865;62872;52.0;29.0
36;2021-06-16;903;1519;113768;64391;52.4;29.7
36;2021-06-17;750;1899;114518;66290;52.7;30.5
36;2021-06-18;706;1878;115224;68168;53.1;31.4
36;2021-06-19;295;395;115519;68563;53.2;31.6
36;2021-06-20;235;327;115754;68890;53.3;31.7
36;2021-06-21;692;1449;116446;70339;53.6;32.4
36;2021-06-22;841;1552;117287;71891;54.0;33.1
36;2021-06-23;774;1786;118061;73677;54.4;33.9
36;2021-06-24;855;1522;118916;75199;54.8;34.6
36;2021-06-25;942;1218;119858;76417;55.2;35.2
36;2021-06-26;324;602;120182;77019;55.3;35.5
36;2021-06-27;105;267;120287;77286;55.4;35.6
36;2021-06-28;696;922;120983;78208;55.7;36.0
36;2021-06-29;688;1459;121671;79667;56.0;36.7
36;2021-06-30;836;2149;122507;81816;56.4;37.7
36;2021-07-01;353;1081;122860;82897;56.6;38.2
36;2021-07-02;749;1843;123609;84740;56.9;39.0
36;2021-07-03;465;885;124074;85625;57.1;39.4
36;2021-07-04;185;325;124259;85950;57.2;39.6
36;2021-07-05;493;1335;124752;87285;57.5;40.2
36;2021-07-06;491;1220;125243;88505;57.7;40.8
36;2021-07-07;586;1791;125829;90296;57.9;41.6
36;2021-07-08;550;1706;126379;92002;58.2;42.4
36;2021-07-09;786;1651;127165;93653;58.6;43.1
36;2021-07-10;470;1119;127635;94772;58.8;43.6
36;2021-07-11;257;154;127892;94926;58.9;43.7
36;2021-07-12;332;1628;128224;96554;59.1;44.5
36;2021-07-13;311;1936;128535;98490;59.2;45.4
36;2021-07-14;376;763;128911;99253;59.4;45.7
36;2021-07-15;917;2161;129828;101414;59.8;46.7
36;2021-07-16;628;1869;130456;103283;60.1;47.6
36;2021-07-17;400;859;130856;104142;60.3;48.0
36;2021-07-18;199;408;131055;104550;60.4;48.1
36;2021-07-19;552;1456;131607;106006;60.6;48.8
36;2021-07-20;776;1406;132383;107412;61.0;49.5
36;2021-07-21;713;1984;133096;109396;61.3;50.4
36;2021-07-22;1138;1686;134234;111082;61.8;51.2
36;2021-07-23;968;1739;135202;112821;62.3;52.0
36;2021-07-24;605;800;135807;113621;62.5;52.3
36;2021-07-25;148;404;135955;114025;62.6;52.5
36;2021-07-26;948;1085;136903;115110;63.0;53.0
36;2021-07-27;816;1354;137719;116464;63.4;53.6
36;2021-07-28;1385;1401;139104;117865;64.1;54.3
36;2021-07-29;1708;1310;140812;119175;64.8;54.9
36;2021-07-30;1445;1322;142257;120497;65.5;55.5
36;2021-07-31;933;537;143190;121034;65.9;55.7
36;2021-08-01;210;239;143400;121273;66.0;55.9
36;2021-08-02;1116;891;144516;122164;66.6;56.3
36;2021-08-03;1271;997;145787;123161;67.1;56.7
36;2021-08-04;1695;940;147482;124101;67.9;57.2
36;2021-08-05;1824;910;149306;125011;68.8;57.6
36;2021-08-06;1418;877;150724;125888;69.4;58.0
36;2021-08-07;541;526;151265;126414;69.7;58.2
36;2021-08-08;292;153;151557;126567;69.8;58.3
36;2021-08-09;818;846;152375;127413;70.2;58.7
36;2021-08-10;1067;1012;153442;128425;70.7;59.1
36;2021-08-11;1356;857;154798;129282;71.3;59.5
36;2021-08-12;1161;854;155959;130136;71.8;59.9
36;2021-08-13;1192;778;157151;130914;72.4;60.3
36;2021-08-14;426;836;157577;131750;72.6;60.7
36;2021-08-15;365;113;157942;131863;72.7;60.7
36;2021-08-16;606;954;158548;132817;73.0;61.2
36;2021-08-17;766;1001;159314;133818;73.4;61.6
36;2021-08-18;1039;1164;160353;134982;73.8;62.2
36;2021-08-19;840;1178;161193;136160;74.2;62.7
36;2021-08-20;487;1479;161680;137639;74.5;63.4
36;2021-08-21;309;468;161989;138107;74.6;63.6
36;2021-08-22;27;65;162016;138172;74.6;63.6
36;2021-08-23;551;1179;162567;139351;74.9;64.2
36;2021-08-24;589;1204;163156;140555;75.1;64.7
36;2021-08-25;465;1093;163621;141648;75.4;65.2
36;2021-08-26;666;1480;164287;143128;75.7;65.9
36;2021-08-27;529;1409;164816;144537;75.9;66.6
36;2021-08-28;368;580;165184;145117;76.1;66.8
36;2021-08-29;222;241;165406;145358;76.2;66.9
36;2021-08-30;246;748;165652;146106;76.3;67.3
36;2021-08-31;387;935;166039;147041;76.5;67.7
36;2021-09-01;388;1219;166427;148260;76.6;68.3
36;2021-09-02;323;1055;166750;149315;76.8;68.8
36;2021-09-03;297;1496;167047;150811;76.9;69.5
36;2021-09-04;248;864;167295;151675;77.0;69.9
36;2021-09-05;119;384;167414;152059;77.1;70.0
36;2021-09-06;150;1041;167564;153100;77.2;70.5
36;2021-09-07;191;855;167755;153955;77.3;70.9
36;2021-09-08;236;1303;167991;155258;77.4;71.5
36;2021-09-09;293;1010;168284;156268;77.5;72.0
36;2021-09-10;270;1141;168554;157409;77.6;72.5
36;2021-09-11;164;761;168718;158170;77.7;72.8
36;2021-09-12;82;235;168800;158405;77.7;73.0
36;2021-09-13;168;734;168968;159139;77.8;73.3
36;2021-09-14;169;791;169137;159930;77.9;73.7
36;2021-09-15;301;568;169438;160498;78.0;73.9
36;2021-09-16;248;669;169686;161167;78.1;74.2
36;2021-09-17;256;567;169942;161734;78.3;74.5
36;2021-09-18;122;427;170064;162161;78.3;74.7
36;2021-09-19;43;214;170107;162375;78.3;74.8
36;2021-09-20;131;325;170238;162700;78.4;74.9
36;2021-09-21;132;300;170370;163000;78.5;75.1
36;2021-09-22;118;674;170488;163674;78.5;75.4
36;2021-09-23;134;437;170622;164111;78.6;75.6
36;2021-09-24;128;497;170750;164608;78.6;75.8
36;2021-09-25;119;502;170869;165110;78.7;76.0
36;2021-09-26;15;318;170884;165428;78.7;76.2
36;2021-09-27;66;224;170950;165652;78.7;76.3
36;2021-09-28;69;233;171019;165885;78.8;76.4
36;2021-09-29;107;387;171126;166272;78.8;76.6
36;2021-09-30;108;250;171234;166522;78.9;76.7
36;2021-10-01;163;307;171397;166829;78.9;76.8
36;2021-10-02;43;180;171440;167009;79.0;76.9
36;2021-10-03;4;23;171444;167032;79.0;76.9
37;2020-12-27;1;0;1;0;0.0;0.0
37;2020-12-28;17;0;18;0;0.0;0.0
37;2020-12-29;10;0;28;0;0.0;0.0
37;2020-12-30;0;0;28;0;0.0;0.0
37;2020-12-31;0;0;28;0;0.0;0.0
37;2021-01-01;0;0;28;0;0.0;0.0
37;2021-01-02;0;0;28;0;0.0;0.0
37;2021-01-03;2;0;30;0;0.0;0.0
37;2021-01-04;23;0;53;0;0.0;0.0
37;2021-01-05;47;0;100;0;0.0;0.0
37;2021-01-06;79;0;179;0;0.0;0.0
37;2021-01-07;116;0;295;0;0.0;0.0
37;2021-01-08;442;1;737;1;0.1;0.0
37;2021-01-09;80;1;817;2;0.1;0.0
37;2021-01-10;83;0;900;2;0.1;0.0
37;2021-01-11;280;0;1180;2;0.2;0.0
37;2021-01-12;658;4;1838;6;0.3;0.0
37;2021-01-13;560;1;2398;7;0.4;0.0
37;2021-01-14;524;3;2922;10;0.5;0.0
37;2021-01-15;628;1;3550;11;0.6;0.0
37;2021-01-16;304;2;3854;13;0.6;0.0
37;2021-01-17;262;1;4116;14;0.7;0.0
37;2021-01-18;733;9;4849;23;0.8;0.0
37;2021-01-19;1244;11;6093;34;1.0;0.0
37;2021-01-20;1038;5;7131;39;1.2;0.0
37;2021-01-21;857;1;7988;40;1.3;0.0
37;2021-01-22;767;2;8755;42;1.4;0.0
37;2021-01-23;173;0;8928;42;1.5;0.0
37;2021-01-24;1;0;8929;42;1.5;0.0
37;2021-01-25;541;15;9470;57;1.6;0.0
37;2021-01-26;1814;63;11284;120;1.9;0.0
37;2021-01-27;1523;67;12807;187;2.1;0.0
37;2021-01-28;1534;87;14341;274;2.4;0.0
37;2021-01-29;634;304;14975;578;2.5;0.1
37;2021-01-30;204;53;15179;631;2.5;0.1
37;2021-01-31;15;52;15194;683;2.5;0.1
37;2021-02-01;333;182;15527;865;2.6;0.1
37;2021-02-02;523;494;16050;1359;2.7;0.2
37;2021-02-03;659;330;16709;1689;2.8;0.3
37;2021-02-04;548;385;17257;2074;2.9;0.3
37;2021-02-05;468;406;17725;2480;2.9;0.4
37;2021-02-06;189;2;17914;2482;3.0;0.4
37;2021-02-07;20;1;17934;2483;3.0;0.4
37;2021-02-08;333;279;18267;2762;3.0;0.5
37;2021-02-09;627;620;18894;3382;3.1;0.6
37;2021-02-10;664;462;19558;3844;3.2;0.6
37;2021-02-11;613;522;20171;4366;3.3;0.7
37;2021-02-12;489;514;20660;4880;3.4;0.8
37;2021-02-13;156;169;20816;5049;3.4;0.8
37;2021-02-14;2;70;20818;5119;3.4;0.8
37;2021-02-15;427;389;21245;5508;3.5;0.9
37;2021-02-16;841;1318;22086;6826;3.6;1.1
37;2021-02-17;634;1218;22720;8044;3.8;1.3
37;2021-02-18;913;1288;23633;9332;3.9;1.5
37;2021-02-19;797;729;24430;10061;4.0;1.7
37;2021-02-20;245;155;24675;10216;4.1;1.7
37;2021-02-21;5;1;24680;10217;4.1;1.7
37;2021-02-22;335;465;25015;10682;4.1;1.8
37;2021-02-23;606;491;25621;11173;4.2;1.8
37;2021-02-24;573;482;26194;11655;4.3;1.9
37;2021-02-25;875;481;27069;12136;4.5;2.0
37;2021-02-26;1118;472;28187;12608;4.7;2.1
37;2021-02-27;585;131;28772;12739;4.8;2.1
37;2021-02-28;23;0;28795;12739;4.8;2.1
37;2021-03-01;603;307;29398;13046;4.9;2.2
37;2021-03-02;1090;457;30488;13503;5.0;2.2
37;2021-03-03;972;439;31460;13942;5.2;2.3
37;2021-03-04;1608;413;33068;14355;5.5;2.4
37;2021-03-05;2131;475;35199;14830;5.8;2.4
37;2021-03-06;1165;174;36364;15004;6.0;2.5
37;2021-03-07;472;66;36836;15070;6.1;2.5
37;2021-03-08;670;361;37506;15431;6.2;2.5
37;2021-03-09;1654;621;39160;16052;6.5;2.7
37;2021-03-10;1607;681;40767;16733;6.7;2.8
37;2021-03-11;2050;641;42817;17374;7.1;2.9
37;2021-03-12;3210;458;46027;17832;7.6;2.9
37;2021-03-13;1948;180;47975;18012;7.9;3.0
37;2021-03-14;206;4;48181;18016;8.0;3.0
37;2021-03-15;1069;243;49250;18259;8.1;3.0
37;2021-03-16;1049;522;50299;18781;8.3;3.1
37;2021-03-17;936;277;51235;19058;8.5;3.1
37;2021-03-18;1036;517;52271;19575;8.6;3.2
37;2021-03-19;2219;340;54490;19915;9.0;3.3
37;2021-03-20;1334;141;55824;20056;9.2;3.3
37;2021-03-21;205;3;56029;20059;9.3;3.3
37;2021-03-22;1288;238;57317;20297;9.5;3.4
37;2021-03-23;2257;563;59574;20860;9.8;3.4
37;2021-03-24;2245;463;61819;21323;10.2;3.5
37;2021-03-25;2984;440;64803;21763;10.7;3.6
37;2021-03-26;3524;402;68327;22165;11.3;3.7
37;2021-03-27;1175;125;69502;22290;11.5;3.7
37;2021-03-28;139;1;69641;22291;11.5;3.7
37;2021-03-29;1606;344;71247;22635;11.8;3.7
37;2021-03-30;2524;618;73771;23253;12.2;3.8
37;2021-03-31;2050;482;75821;23735;12.5;3.9
37;2021-04-01;2601;966;78422;24701;13.0;4.1
37;2021-04-02;2809;666;81231;25367;13.4;4.2
37;2021-04-03;818;222;82049;25589;13.6;4.2
37;2021-04-04;104;1;82153;25590;13.6;4.2
37;2021-04-05;4;0;82157;25590;13.6;4.2
37;2021-04-06;2242;782;84399;26372;13.9;4.4
37;2021-04-07;3172;876;87571;27248;14.5;4.5
37;2021-04-08;4043;964;91614;28212;15.1;4.7
37;2021-04-09;4544;947;96158;29159;15.9;4.8
37;2021-04-10;1328;429;97486;29588;16.1;4.9
37;2021-04-11;104;1;97590;29589;16.1;4.9
37;2021-04-12;2642;675;100232;30264;16.6;5.0
37;2021-04-13;4114;1163;104346;31427;17.2;5.2
37;2021-04-14;3043;895;107389;32322;17.7;5.3
37;2021-04-15;3757;1018;111146;33340;18.4;5.5
37;2021-04-16;4358;1229;115504;34569;19.1;5.7
37;2021-04-17;1147;223;116651;34792;19.3;5.7
37;2021-04-18;97;3;116748;34795;19.3;5.7
37;2021-04-19;2481;847;119229;35642;19.7;5.9
37;2021-04-20;3233;1339;122462;36981;20.2;6.1
37;2021-04-21;2928;1155;125390;38136;20.7;6.3
37;2021-04-22;3455;1400;128845;39536;21.3;6.5
37;2021-04-23;3693;1813;132538;41349;21.9;6.8
37;2021-04-24;1007;385;133545;41734;22.1;6.9
37;2021-04-25;46;2;133591;41736;22.1;6.9
37;2021-04-26;2971;1336;136562;43072;22.6;7.1
37;2021-04-27;4186;1799;140748;44871;23.2;7.4
37;2021-04-28;3464;1951;144212;46822;23.8;7.7
37;2021-04-29;4586;2002;148798;48824;24.6;8.1
37;2021-04-30;5055;1951;153853;50775;25.4;8.4
37;2021-05-01;638;209;154491;50984;25.5;8.4
37;2021-05-02;104;15;154595;50999;25.5;8.4
37;2021-05-03;2672;1957;157267;52956;26.0;8.7
37;2021-05-04;3730;2702;160997;55658;26.6;9.2
37;2021-05-05;3498;2071;164495;57729;27.2;9.5
37;2021-05-06;4992;1945;169487;59674;28.0;9.9
37;2021-05-07;4685;2868;174172;62542;28.8;10.3
37;2021-05-08;538;312;174710;62854;28.9;10.4
37;2021-05-09;63;41;174773;62895;28.9;10.4
37;2021-05-10;2160;3480;176933;66375;29.2;11.0
37;2021-05-11;3868;3869;180801;70244;29.9;11.6
37;2021-05-12;4041;2537;184842;72781;30.5;12.0
37;2021-05-13;1139;515;185981;73296;30.7;12.1
37;2021-05-14;4046;2675;190027;75971;31.4;12.5
37;2021-05-15;2322;743;192349;76714;31.8;12.7
37;2021-05-16;22;70;192371;76784;31.8;12.7
37;2021-05-17;2765;2038;195136;78822;32.2;13.0
37;2021-05-18;3875;2359;199011;81181;32.9;13.4
37;2021-05-19;3495;1808;202506;82989;33.5;13.7
37;2021-05-20;4751;1768;207257;84757;34.2;14.0
37;2021-05-21;4525;2569;211782;87326;35.0;14.4
37;2021-05-22;1078;751;212860;88077;35.2;14.5
37;2021-05-23;73;89;212933;88166;35.2;14.6
37;2021-05-24;513;107;213446;88273;35.3;14.6
37;2021-05-25;5123;2176;218569;90449;36.1;14.9
37;2021-05-26;4929;2099;223498;92548;36.9;15.3
37;2021-05-27;5984;2355;229482;94903;37.9;15.7
37;2021-05-28;6019;3248;235501;98151;38.9;16.2
37;2021-05-29;1520;1164;237021;99315;39.2;16.4
37;2021-05-30;55;160;237076;99475;39.2;16.4
37;2021-05-31;3646;2519;240722;101994;39.8;16.8
37;2021-06-01;5841;3610;246563;105604;40.7;17.4
37;2021-06-02;5078;2450;251641;108054;41.6;17.8
37;2021-06-03;6086;2876;257727;110930;42.6;18.3
37;2021-06-04;5510;4202;263237;115132;43.5;19.0
37;2021-06-05;1853;1300;265090;116432;43.8;19.2
37;2021-06-06;49;197;265139;116629;43.8;19.3
37;2021-06-07;3021;4164;268160;120793;44.3;20.0
37;2021-06-08;4201;4644;272361;125437;45.0;20.7
37;2021-06-09;3882;3565;276243;129002;45.6;21.3
37;2021-06-10;5271;3615;281514;132617;46.5;21.9
37;2021-06-11;4972;4821;286486;137438;47.3;22.7
37;2021-06-12;3552;1347;290038;138785;47.9;22.9
37;2021-06-13;15;164;290053;138949;47.9;23.0
37;2021-06-14;2666;4032;292719;142981;48.4;23.6
37;2021-06-15;3898;4778;296617;147759;49.0;24.4
37;2021-06-16;3261;3599;299878;151358;49.5;25.0
37;2021-06-17;4013;4492;303891;155850;50.2;25.7
37;2021-06-18;4704;5068;308595;160918;51.0;26.6
37;2021-06-19;2518;1098;311113;162016;51.4;26.8
37;2021-06-20;10;183;311123;162199;51.4;26.8
37;2021-06-21;2417;3827;313540;166026;51.8;27.4
37;2021-06-22;2968;5003;316508;171029;52.3;28.3
37;2021-06-23;2625;3642;319133;174671;52.7;28.9
37;2021-06-24;2872;3540;322005;178211;53.2;29.4
37;2021-06-25;3308;4876;325313;183087;53.7;30.2
37;2021-06-26;1238;3084;326551;186171;53.9;30.8
37;2021-06-27;23;142;326574;186313;53.9;30.8
37;2021-06-28;1703;4508;328277;190821;54.2;31.5
37;2021-06-29;1904;6223;330181;197044;54.5;32.5
37;2021-06-30;1870;4441;332051;201485;54.9;33.3
37;2021-07-01;2124;4793;334175;206278;55.2;34.1
37;2021-07-02;2681;5589;336856;211867;55.6;35.0
37;2021-07-03;945;2138;337801;214005;55.8;35.4
37;2021-07-04;5;105;337806;214110;55.8;35.4
37;2021-07-05;1708;5133;339514;219243;56.1;36.2
37;2021-07-06;2003;6757;341517;226000;56.4;37.3
37;2021-07-07;1944;5465;343461;231465;56.7;38.2
37;2021-07-08;2465;6662;345926;238127;57.1;39.3
37;2021-07-09;1986;7640;347912;245767;57.5;40.6
37;2021-07-10;1016;2618;348928;248385;57.6;41.0
37;2021-07-11;26;96;348954;248481;57.6;41.0
37;2021-07-12;1131;5982;350085;254463;57.8;42.0
37;2021-07-13;1614;7815;351699;262278;58.1;43.3
37;2021-07-14;525;408;352224;262686;58.2;43.4
37;2021-07-15;2625;7498;354849;270184;58.6;44.6
37;2021-07-16;2757;7796;357606;277980;59.1;45.9
37;2021-07-17;1202;2444;358808;280424;59.3;46.3
37;2021-07-18;50;53;358858;280477;59.3;46.3
37;2021-07-19;1652;6127;360510;286604;59.6;47.3
37;2021-07-20;2906;7060;363416;293664;60.0;48.5
37;2021-07-21;2981;5783;366397;299447;60.5;49.5
37;2021-07-22;4057;6531;370454;305978;61.2;50.5
37;2021-07-23;3808;7100;374262;313078;61.8;51.7
37;2021-07-24;1775;3306;376037;316384;62.1;52.3
37;2021-07-25;66;77;376103;316461;62.1;52.3
37;2021-07-26;3236;4318;379339;320779;62.7;53.0
37;2021-07-27;4429;4960;383768;325739;63.4;53.8
37;2021-07-28;4138;3660;387906;329399;64.1;54.4
37;2021-07-29;5086;4195;392992;333594;64.9;55.1
37;2021-07-30;5247;4937;398239;338531;65.8;55.9
37;2021-07-31;1920;1845;400159;340376;66.1;56.2
37;2021-08-01;31;52;400190;340428;66.1;56.2
37;2021-08-02;3292;3291;403482;343719;66.6;56.8
37;2021-08-03;5262;3144;408744;346863;67.5;57.3
37;2021-08-04;4559;1925;413303;348788;68.3;57.6
37;2021-08-05;4788;2600;418091;351388;69.1;58.0
37;2021-08-06;4852;3305;422943;354693;69.9;58.6
37;2021-08-07;1626;1125;424569;355818;70.1;58.8
37;2021-08-08;34;177;424603;355995;70.1;58.8
37;2021-08-09;2435;2259;427038;358254;70.5;59.2
37;2021-08-10;3026;2638;430064;360892;71.0;59.6
37;2021-08-11;2099;2108;432163;363000;71.4;60.0
37;2021-08-12;2613;2690;434776;365690;71.8;60.4
37;2021-08-13;2484;2776;437260;368466;72.2;60.9
37;2021-08-14;755;814;438015;369280;72.4;61.0
37;2021-08-15;12;57;438027;369337;72.4;61.0
37;2021-08-16;1464;3160;439491;372497;72.6;61.5
37;2021-08-17;1795;3973;441286;376470;72.9;62.2
37;2021-08-18;1398;3141;442684;379611;73.1;62.7
37;2021-08-19;1598;3842;444282;383453;73.4;63.3
37;2021-08-20;1597;4552;445879;388005;73.7;64.1
37;2021-08-21;610;1201;446489;389206;73.8;64.3
37;2021-08-22;3;31;446492;389237;73.8;64.3
37;2021-08-23;1291;3985;447783;393222;74.0;65.0
37;2021-08-24;1541;4851;449324;398073;74.2;65.8
37;2021-08-25;1053;4223;450377;402296;74.4;66.5
37;2021-08-26;1278;4513;451655;406809;74.6;67.2
37;2021-08-27;1454;5663;453109;412472;74.8;68.1
37;2021-08-28;408;1462;453517;413934;74.9;68.4
37;2021-08-29;1;18;453518;413952;74.9;68.4
37;2021-08-30;1076;3945;454594;417897;75.1;69.0
37;2021-08-31;1280;3831;455874;421728;75.3;69.7
37;2021-09-01;976;2687;456850;424415;75.5;70.1
37;2021-09-02;896;2810;457746;427225;75.6;70.6
37;2021-09-03;1045;3961;458791;431186;75.8;71.2
37;2021-09-04;667;1464;459458;432650;75.9;71.5
37;2021-09-05;1;30;459459;432680;75.9;71.5
37;2021-09-06;377;1314;459836;433994;76.0;71.7
37;2021-09-07;535;1508;460371;435502;76.0;71.9
37;2021-09-08;819;2083;461190;437585;76.2;72.3
37;2021-09-09;556;1536;461746;439121;76.3;72.5
37;2021-09-10;814;1911;462560;441032;76.4;72.9
37;2021-09-11;397;1008;462957;442040;76.5;73.0
37;2021-09-12;14;24;462971;442064;76.5;73.0
37;2021-09-13;450;1402;463421;443466;76.6;73.3
37;2021-09-14;508;1520;463929;444986;76.6;73.5
37;2021-09-15;622;1478;464551;446464;76.7;73.7
37;2021-09-16;352;768;464903;447232;76.8;73.9
37;2021-09-17;633;1468;465536;448700;76.9;74.1
37;2021-09-18;306;841;465842;449541;77.0;74.3
37;2021-09-19;16;42;465858;449583;77.0;74.3
37;2021-09-20;270;681;466128;450264;77.0;74.4
37;2021-09-21;438;1322;466566;451586;77.1;74.6
37;2021-09-22;426;1288;466992;452874;77.1;74.8
37;2021-09-23;427;1046;467419;453920;77.2;75.0
37;2021-09-24;500;1404;467919;455324;77.3;75.2
37;2021-09-25;231;769;468150;456093;77.3;75.3
37;2021-09-26;1;22;468151;456115;77.3;75.3
37;2021-09-27;289;692;468440;456807;77.4;75.5
37;2021-09-28;395;660;468835;457467;77.4;75.6
37;2021-09-29;366;939;469201;458406;77.5;75.7
37;2021-09-30;370;493;469571;458899;77.6;75.8
37;2021-10-01;413;799;469984;459698;77.6;75.9
37;2021-10-02;221;559;470205;460257;77.7;76.0
37;2021-10-03;19;22;470224;460279;77.7;76.0
38;2020-12-27;1;0;1;0;0.0;0.0
38;2020-12-28;1;0;2;0;0.0;0.0
38;2020-12-29;0;0;2;0;0.0;0.0
38;2020-12-30;2;0;4;0;0.0;0.0
38;2020-12-31;5;0;9;0;0.0;0.0
38;2021-01-01;4;0;13;0;0.0;0.0
38;2021-01-02;1;0;14;0;0.0;0.0
38;2021-01-03;3;0;17;0;0.0;0.0
38;2021-01-04;163;0;180;0;0.0;0.0
38;2021-01-05;258;1;438;1;0.0;0.0
38;2021-01-06;364;0;802;1;0.1;0.0
38;2021-01-07;636;1;1438;2;0.1;0.0
38;2021-01-08;695;0;2133;2;0.2;0.0
38;2021-01-09;30;0;2163;2;0.2;0.0
38;2021-01-10;2;0;2165;2;0.2;0.0
38;2021-01-11;801;1;2966;3;0.2;0.0
38;2021-01-12;1471;4;4437;7;0.4;0.0
38;2021-01-13;1084;5;5521;12;0.4;0.0
38;2021-01-14;1682;12;7203;24;0.6;0.0
38;2021-01-15;1675;7;8878;31;0.7;0.0
38;2021-01-16;307;1;9185;32;0.7;0.0
38;2021-01-17;3;0;9188;32;0.7;0.0
38;2021-01-18;1178;3;10366;35;0.8;0.0
38;2021-01-19;2241;5;12607;40;1.0;0.0
38;2021-01-20;1888;4;14495;44;1.1;0.0
38;2021-01-21;1644;7;16139;51;1.3;0.0
38;2021-01-22;1401;8;17540;59;1.4;0.0
38;2021-01-23;379;3;17919;62;1.4;0.0
38;2021-01-24;1;0;17920;62;1.4;0.0
38;2021-01-25;795;86;18715;148;1.5;0.0
38;2021-01-26;855;143;19570;291;1.5;0.0
38;2021-01-27;1093;230;20663;521;1.6;0.0
38;2021-01-28;1175;431;21838;952;1.7;0.1
38;2021-01-29;952;341;22790;1293;1.8;0.1
38;2021-01-30;304;0;23094;1293;1.8;0.1
38;2021-01-31;0;0;23094;1293;1.8;0.1
38;2021-02-01;703;550;23797;1843;1.9;0.1
38;2021-02-02;964;886;24761;2729;2.0;0.2
38;2021-02-03;1230;606;25991;3335;2.1;0.3
38;2021-02-04;1278;869;27269;4204;2.2;0.3
38;2021-02-05;1400;813;28669;5017;2.3;0.4
38;2021-02-06;188;80;28857;5097;2.3;0.4
38;2021-02-07;3;47;28860;5144;2.3;0.4
38;2021-02-08;862;643;29722;5787;2.3;0.5
38;2021-02-09;1537;1160;31259;6947;2.5;0.5
38;2021-02-10;1581;1152;32840;8099;2.6;0.6
38;2021-02-11;1871;1018;34711;9117;2.7;0.7
38;2021-02-12;1509;976;36220;10093;2.9;0.8
38;2021-02-13;467;164;36687;10257;2.9;0.8
38;2021-02-14;1;3;36688;10260;2.9;0.8
38;2021-02-15;976;749;37664;11009;3.0;0.9
38;2021-02-16;1379;801;39043;11810;3.1;0.9
38;2021-02-17;1376;872;40419;12682;3.2;1.0
38;2021-02-18;1791;899;42210;13581;3.3;1.1
38;2021-02-19;1255;680;43465;14261;3.4;1.1
38;2021-02-20;470;238;43935;14499;3.5;1.1
38;2021-02-21;1;0;43936;14499;3.5;1.1
38;2021-02-22;1074;708;45010;15207;3.6;1.2
38;2021-02-23;1542;799;46552;16006;3.7;1.3
38;2021-02-24;1741;972;48293;16978;3.8;1.3
38;2021-02-25;2500;889;50793;17867;4.0;1.4
38;2021-02-26;3311;838;54104;18705;4.3;1.5
38;2021-02-27;1511;352;55615;19057;4.4;1.5
38;2021-02-28;33;2;55648;19059;4.4;1.5
38;2021-03-01;2512;680;58160;19739;4.6;1.6
38;2021-03-02;4049;977;62209;20716;4.9;1.6
38;2021-03-03;3368;1128;65577;21844;5.2;1.7
38;2021-03-04;4489;1292;70066;23136;5.5;1.8
38;2021-03-05;5233;1080;75299;24216;6.0;1.9
38;2021-03-06;3042;261;78341;24477;6.2;1.9
38;2021-03-07;115;2;78456;24479;6.2;1.9
38;2021-03-08;2440;791;80896;25270;6.4;2.0
38;2021-03-09;4029;1204;84925;26474;6.7;2.1
38;2021-03-10;3508;996;88433;27470;7.0;2.2
38;2021-03-11;5142;1447;93575;28917;7.4;2.3
38;2021-03-12;7095;1128;100670;30045;8.0;2.4
38;2021-03-13;3771;224;104441;30269;8.3;2.4
38;2021-03-14;544;15;104985;30284;8.3;2.4
38;2021-03-15;2702;980;107687;31264;8.5;2.5
38;2021-03-16;2081;1272;109768;32536;8.7;2.6
38;2021-03-17;2024;1178;111792;33714;8.8;2.7
38;2021-03-18;2640;1339;114432;35053;9.0;2.8
38;2021-03-19;4009;1036;118441;36089;9.4;2.9
38;2021-03-20;1826;243;120267;36332;9.5;2.9
38;2021-03-21;132;8;120399;36340;9.5;2.9
38;2021-03-22;2867;983;123266;37323;9.7;3.0
38;2021-03-23;4780;1471;128046;38794;10.1;3.1
38;2021-03-24;3707;1539;131753;40333;10.4;3.2
38;2021-03-25;5791;1534;137544;41867;10.9;3.3
38;2021-03-26;6599;1736;144143;43603;11.4;3.4
38;2021-03-27;2513;756;146656;44359;11.6;3.5
38;2021-03-28;926;48;147582;44407;11.7;3.5
38;2021-03-29;2679;1835;150261;46242;11.9;3.7
38;2021-03-30;4564;2530;154825;48772;12.2;3.9
38;2021-03-31;3665;2218;158490;50990;12.5;4.0
38;2021-04-01;5136;2522;163626;53512;12.9;4.2
38;2021-04-02;3873;2516;167499;56028;13.2;4.4
38;2021-04-03;1418;938;168917;56966;13.4;4.5
38;2021-04-04;430;46;169347;57012;13.4;4.5
38;2021-04-05;2177;347;171524;57359;13.6;4.5
38;2021-04-06;4346;2399;175870;59758;13.9;4.7
38;2021-04-07;4415;2732;180285;62490;14.3;4.9
38;2021-04-08;5650;2665;185935;65155;14.7;5.2
38;2021-04-09;8561;2730;194496;67885;15.4;5.4
38;2021-04-10;3597;1478;198093;69363;15.7;5.5
38;2021-04-11;1048;100;199141;69463;15.7;5.5
38;2021-04-12;4203;2250;203344;71713;16.1;5.7
38;2021-04-13;6123;2469;209467;74182;16.6;5.9
38;2021-04-14;5117;2457;214584;76639;17.0;6.1
38;2021-04-15;6363;2768;220947;79407;17.5;6.3
38;2021-04-16;6213;2705;227160;82112;18.0;6.5
38;2021-04-17;2588;993;229748;83105;18.2;6.6
38;2021-04-18;1331;72;231079;83177;18.3;6.6
38;2021-04-19;3948;2836;235027;86013;18.6;6.8
38;2021-04-20;5425;2854;240452;88867;19.0;7.0
38;2021-04-21;4977;2707;245429;91574;19.4;7.2
38;2021-04-22;5790;2830;251219;94404;19.9;7.5
38;2021-04-23;6040;2821;257259;97225;20.3;7.7
38;2021-04-24;2665;1350;259924;98575;20.5;7.8
38;2021-04-25;805;590;260729;99165;20.6;7.8
38;2021-04-26;4487;2475;265216;101640;21.0;8.0
38;2021-04-27;6040;2719;271256;104359;21.4;8.2
38;2021-04-28;6198;2505;277454;106864;21.9;8.4
38;2021-04-29;8332;3064;285786;109928;22.6;8.7
38;2021-04-30;7674;4042;293460;113970;23.2;9.0
38;2021-05-01;1546;195;295006;114165;23.3;9.0
38;2021-05-02;847;74;295853;114239;23.4;9.0
38;2021-05-03;5300;3588;301153;117827;23.8;9.3
38;2021-05-04;6201;5082;307354;122909;24.3;9.7
38;2021-05-05;6067;4602;313421;127511;24.8;10.1
38;2021-05-06;6708;5328;320129;132839;25.3;10.5
38;2021-05-07;7284;6437;327413;139276;25.9;11.0
38;2021-05-08;3778;720;331191;139996;26.2;11.1
38;2021-05-09;2853;1931;334044;141927;26.4;11.2
38;2021-05-10;6157;5302;340201;147229;26.9;11.6
38;2021-05-11;8226;6016;348427;153245;27.5;12.1
38;2021-05-12;9044;4703;357471;157948;28.3;12.5
38;2021-05-13;6635;1417;364106;159365;28.8;12.6
38;2021-05-14;9565;3422;373671;162787;29.5;12.9
38;2021-05-15;6864;1450;380535;164237;30.1;13.0
38;2021-05-16;5474;650;386009;164887;30.5;13.0
38;2021-05-17;7671;3002;393680;167889;31.1;13.3
38;2021-05-18;8622;4032;402302;171921;31.8;13.6
38;2021-05-19;8157;3348;410459;175269;32.4;13.9
38;2021-05-20;8978;4492;419437;179761;33.2;14.2
38;2021-05-21;9960;4584;429397;184345;33.9;14.6
38;2021-05-22;7456;1905;436853;186250;34.5;14.7
38;2021-05-23;5589;580;442442;186830;35.0;14.8
38;2021-05-24;7503;1626;449945;188456;35.6;14.9
38;2021-05-25;9544;4850;459489;193306;36.3;15.3
38;2021-05-26;8126;4725;467615;198031;37.0;15.7
38;2021-05-27;9134;5657;476749;203688;37.7;16.1
38;2021-05-28;8786;6483;485535;210171;38.4;16.6
38;2021-05-29;5821;3246;491356;213417;38.8;16.9
38;2021-05-30;2695;1593;494051;215010;39.1;17.0
38;2021-05-31;8272;5131;502323;220141;39.7;17.4
38;2021-06-01;7964;6423;510287;226564;40.3;17.9
38;2021-06-02;7141;5615;517428;232179;40.9;18.4
38;2021-06-03;7393;6822;524821;239001;41.5;18.9
38;2021-06-04;8130;7610;532951;246611;42.1;19.5
38;2021-06-05;5794;3946;538745;250557;42.6;19.8
38;2021-06-06;2507;1463;541252;252020;42.8;19.9
38;2021-06-07;5554;6864;546806;258884;43.2;20.5
38;2021-06-08;5879;7523;552685;266407;43.7;21.1
38;2021-06-09;5048;6464;557733;272871;44.1;21.6
38;2021-06-10;5426;6789;563159;279660;44.5;22.1
38;2021-06-11;5888;7782;569047;287442;45.0;22.7
38;2021-06-12;3945;3259;572992;290701;45.3;23.0
38;2021-06-13;1256;1299;574248;292000;45.4;23.1
38;2021-06-14;3868;7661;578116;299661;45.7;23.7
38;2021-06-15;5234;8145;583350;307806;46.1;24.3
38;2021-06-16;5124;7402;588474;315208;46.5;24.9
38;2021-06-17;4523;7057;592997;322265;46.9;25.5
38;2021-06-18;6163;9227;599160;331492;47.4;26.2
38;2021-06-19;3596;4971;602756;336463;47.6;26.6
38;2021-06-20;1038;2901;603794;339364;47.7;26.8
38;2021-06-21;3748;8709;607542;348073;48.0;27.5
38;2021-06-22;3791;10104;611333;358177;48.3;28.3
38;2021-06-23;3155;9544;614488;367721;48.6;29.1
38;2021-06-24;3380;8587;617868;376308;48.8;29.7
38;2021-06-25;3786;11486;621654;387794;49.1;30.7
38;2021-06-26;2229;7851;623883;395645;49.3;31.3
38;2021-06-27;1098;4356;624981;400001;49.4;31.6
38;2021-06-28;2952;10302;627933;410303;49.6;32.4
38;2021-06-29;3784;10449;631717;420752;49.9;33.3
38;2021-06-30;4061;9941;635778;430693;50.3;34.0
38;2021-07-01;3548;9009;639326;439702;50.5;34.8
38;2021-07-02;3727;11616;643053;451318;50.8;35.7
38;2021-07-03;1739;8785;644792;460103;51.0;36.4
38;2021-07-04;1243;3209;646035;463312;51.1;36.6
38;2021-07-05;3058;10543;649093;473855;51.3;37.5
38;2021-07-06;3460;10235;652553;484090;51.6;38.3
38;2021-07-07;3569;9399;656122;493489;51.9;39.0
38;2021-07-08;3548;8221;659670;501710;52.1;39.7
38;2021-07-09;3897;10738;663567;512448;52.5;40.5
38;2021-07-10;2405;7801;665972;520249;52.6;41.1
38;2021-07-11;777;2030;666749;522279;52.7;41.3
38;2021-07-12;3483;10676;670232;532955;53.0;42.1
38;2021-07-13;6600;10932;676832;543887;53.5;43.0
38;2021-07-14;4670;3330;681502;547217;53.9;43.3
38;2021-07-15;8733;9667;690235;556884;54.6;44.0
38;2021-07-16;8759;10701;698994;567585;55.3;44.9
38;2021-07-17;4739;7485;703733;575070;55.6;45.5
38;2021-07-18;2570;2488;706303;577558;55.8;45.7
38;2021-07-19;5824;9220;712127;586778;56.3;46.4
38;2021-07-20;6289;8303;718416;595081;56.8;47.0
38;2021-07-21;7864;8027;726280;603108;57.4;47.7
38;2021-07-22;7598;6995;733878;610103;58.0;48.2
38;2021-07-23;8942;9043;742820;619146;58.7;48.9
38;2021-07-24;5577;5535;748397;624681;59.2;49.4
38;2021-07-25;2869;1654;751266;626335;59.4;49.5
38;2021-07-26;7869;7500;759135;633835;60.0;50.1
38;2021-07-27;7626;6274;766761;640109;60.6;50.6
38;2021-07-28;8621;5712;775382;645821;61.3;51.1
38;2021-07-29;7685;4681;783067;650502;61.9;51.4
38;2021-07-30;7810;6665;790877;657167;62.5;52.0
38;2021-07-31;4359;3604;795236;660771;62.9;52.2
38;2021-08-01;1298;1084;796534;661855;63.0;52.3
38;2021-08-02;3940;4453;800474;666308;63.3;52.7
38;2021-08-03;4590;4555;805064;670863;63.6;53.0
38;2021-08-04;4637;4354;809701;675217;64.0;53.4
38;2021-08-05;3741;4641;813442;679858;64.3;53.7
38;2021-08-06;4158;5949;817600;685807;64.6;54.2
38;2021-08-07;2319;3532;819919;689339;64.8;54.5
38;2021-08-08;791;2015;820710;691354;64.9;54.7
38;2021-08-09;3605;5576;824315;696930;65.2;55.1
38;2021-08-10;4897;6253;829212;703183;65.6;55.6
38;2021-08-11;3971;4665;833183;707848;65.9;56.0
38;2021-08-12;3393;4607;836576;712455;66.1;56.3
38;2021-08-13;4201;6033;840777;718488;66.5;56.8
38;2021-08-14;1785;4019;842562;722507;66.6;57.1
38;2021-08-15;538;1917;843100;724424;66.6;57.3
38;2021-08-16;2978;7924;846078;732348;66.9;57.9
38;2021-08-17;3445;5962;849523;738310;67.2;58.4
38;2021-08-18;2995;7138;852518;745448;67.4;58.9
38;2021-08-19;2614;4829;855132;750277;67.6;59.3
38;2021-08-20;2897;8428;858029;758705;67.8;60.0
38;2021-08-21;1206;5014;859235;763719;67.9;60.4
38;2021-08-22;510;1511;859745;765230;68.0;60.5
38;2021-08-23;2591;7627;862336;772857;68.2;61.1
38;2021-08-24;2568;5329;864904;778186;68.4;61.5
38;2021-08-25;2616;5876;867520;784062;68.6;62.0
38;2021-08-26;2281;4244;869801;788306;68.8;62.3
38;2021-08-27;2507;5931;872308;794237;69.0;62.8
38;2021-08-28;1423;3688;873731;797925;69.1;63.1
38;2021-08-29;376;1084;874107;799009;69.1;63.2
38;2021-08-30;2331;5783;876438;804792;69.3;63.6
38;2021-08-31;2220;4729;878658;809521;69.5;64.0
38;2021-09-01;2208;4376;880866;813897;69.6;64.3
38;2021-09-02;1667;3385;882533;817282;69.8;64.6
38;2021-09-03;2014;5074;884547;822356;69.9;65.0
38;2021-09-04;1151;2824;885698;825180;70.0;65.2
38;2021-09-05;391;724;886089;825904;70.0;65.3
38;2021-09-06;1193;3414;887282;829318;70.1;65.6
38;2021-09-07;1300;3374;888582;832692;70.2;65.8
38;2021-09-08;1722;3654;890304;836346;70.4;66.1
38;2021-09-09;1119;2361;891423;838707;70.5;66.3
38;2021-09-10;1586;3906;893009;842613;70.6;66.6
38;2021-09-11;1040;2396;894049;845009;70.7;66.8
38;2021-09-12;215;548;894264;845557;70.7;66.8
38;2021-09-13;906;2789;895170;848346;70.8;67.1
38;2021-09-14;909;2614;896079;850960;70.8;67.3
38;2021-09-15;1305;2761;897384;853721;70.9;67.5
38;2021-09-16;680;1553;898064;855274;71.0;67.6
38;2021-09-17;891;2500;898955;857774;71.1;67.8
38;2021-09-18;705;2220;899660;859994;71.1;68.0
38;2021-09-19;101;372;899761;860366;71.1;68.0
38;2021-09-20;598;1720;900359;862086;71.2;68.2
38;2021-09-21;491;1399;900850;863485;71.2;68.3
38;2021-09-22;688;2732;901538;866217;71.3;68.5
38;2021-09-23;446;1396;901984;867613;71.3;68.6
38;2021-09-24;772;2194;902756;869807;71.4;68.8
38;2021-09-25;493;1935;903249;871742;71.4;68.9
38;2021-09-26;94;378;903343;872120;71.4;68.9
38;2021-09-27;427;1227;903770;873347;71.4;69.0
38;2021-09-28;507;1116;904277;874463;71.5;69.1
38;2021-09-29;678;1905;904955;876368;71.5;69.3
38;2021-09-30;438;821;905393;877189;71.6;69.3
38;2021-10-01;598;1410;905991;878599;71.6;69.5
38;2021-10-02;474;1157;906465;879756;71.7;69.5
38;2021-10-03;90;192;906555;879948;71.7;69.6
39;2020-12-27;0;0;0;0;0.0;0.0
39;2020-12-28;0;0;0;0;0.0;0.0
39;2020-12-29;0;0;0;0;0.0;0.0
39;2020-12-30;0;0;0;0;0.0;0.0
39;2020-12-31;0;0;0;0;0.0;0.0
39;2021-01-01;0;0;0;0;0.0;0.0
39;2021-01-02;0;0;0;0;0.0;0.0
39;2021-01-03;0;0;0;0;0.0;0.0
39;2021-01-04;3;0;3;0;0.0;0.0
39;2021-01-05;3;0;6;0;0.0;0.0
39;2021-01-06;57;3;63;3;0.0;0.0
39;2021-01-07;333;2;396;5;0.2;0.0
39;2021-01-08;657;2;1053;7;0.4;0.0
39;2021-01-09;169;0;1222;7;0.5;0.0
39;2021-01-10;1;0;1223;7;0.5;0.0
39;2021-01-11;474;1;1697;8;0.7;0.0
39;2021-01-12;431;1;2128;9;0.8;0.0
39;2021-01-13;408;2;2536;11;1.0;0.0
39;2021-01-14;574;3;3110;14;1.2;0.0
39;2021-01-15;471;1;3581;15;1.4;0.0
39;2021-01-16;141;1;3722;16;1.4;0.0
39;2021-01-17;0;1;3722;17;1.4;0.0
39;2021-01-18;924;7;4646;24;1.8;0.0
39;2021-01-19;1181;6;5827;30;2.3;0.0
39;2021-01-20;905;4;6732;34;2.6;0.0
39;2021-01-21;1179;2;7911;36;3.1;0.0
39;2021-01-22;985;2;8896;38;3.5;0.0
39;2021-01-23;383;1;9279;39;3.6;0.0
39;2021-01-24;0;0;9279;39;3.6;0.0
39;2021-01-25;642;2;9921;41;3.8;0.0
39;2021-01-26;1123;11;11044;52;4.3;0.0
39;2021-01-27;928;16;11972;68;4.6;0.0
39;2021-01-28;741;232;12713;300;4.9;0.1
39;2021-01-29;583;410;13296;710;5.2;0.3
39;2021-01-30;265;104;13561;814;5.3;0.3
39;2021-01-31;1;0;13562;814;5.3;0.3
39;2021-02-01;562;251;14124;1065;5.5;0.4
39;2021-02-02;753;278;14877;1343;5.8;0.5
39;2021-02-03;531;497;15408;1840;6.0;0.7
39;2021-02-04;554;429;15962;2269;6.2;0.9
39;2021-02-05;437;403;16399;2672;6.4;1.0
39;2021-02-06;265;107;16664;2779;6.5;1.1
39;2021-02-07;0;1;16664;2780;6.5;1.1
39;2021-02-08;321;345;16985;3125;6.6;1.2
39;2021-02-09;383;463;17368;3588;6.7;1.4
39;2021-02-10;253;315;17621;3903;6.8;1.5
39;2021-02-11;587;499;18208;4402;7.1;1.7
39;2021-02-12;385;412;18593;4814;7.2;1.9
39;2021-02-13;99;62;18692;4876;7.2;1.9
39;2021-02-14;0;0;18692;4876;7.2;1.9
39;2021-02-15;99;663;18791;5539;7.3;2.1
39;2021-02-16;99;845;18890;6384;7.3;2.5
39;2021-02-17;58;630;18948;7014;7.3;2.7
39;2021-02-18;109;785;19057;7799;7.4;3.0
39;2021-02-19;100;438;19157;8237;7.4;3.2
39;2021-02-20;18;336;19175;8573;7.4;3.3
39;2021-02-21;0;0;19175;8573;7.4;3.3
39;2021-02-22;100;667;19275;9240;7.5;3.6
39;2021-02-23;4;716;19279;9956;7.5;3.9
39;2021-02-24;125;789;19404;10745;7.5;4.2
39;2021-02-25;214;698;19618;11443;7.6;4.4
39;2021-02-26;218;437;19836;11880;7.7;4.6
39;2021-02-27;169;264;20005;12144;7.8;4.7
39;2021-02-28;1;0;20006;12144;7.8;4.7
39;2021-03-01;218;606;20224;12750;7.8;4.9
39;2021-03-02;329;790;20553;13540;8.0;5.3
39;2021-03-03;602;513;21155;14053;8.2;5.5
39;2021-03-04;658;444;21813;14497;8.5;5.6
39;2021-03-05;670;307;22483;14804;8.7;5.7
39;2021-03-06;775;229;23258;15033;9.0;5.8
39;2021-03-07;242;84;23500;15117;9.1;5.9
39;2021-03-08;285;438;23785;15555;9.2;6.0
39;2021-03-09;844;448;24629;16003;9.6;6.2
39;2021-03-10;985;332;25614;16335;9.9;6.3
39;2021-03-11;829;450;26443;16785;10.3;6.5
39;2021-03-12;805;280;27248;17065;10.6;6.6
39;2021-03-13;789;102;28037;17167;10.9;6.7
39;2021-03-14;35;10;28072;17177;10.9;6.7
39;2021-03-15;513;107;28585;17284;11.1;6.7
39;2021-03-16;555;69;29140;17353;11.3;6.7
39;2021-03-17;611;56;29751;17409;11.5;6.8
39;2021-03-18;600;71;30351;17480;11.8;6.8
39;2021-03-19;393;68;30744;17548;11.9;6.8
39;2021-03-20;312;12;31056;17560;12.0;6.8
39;2021-03-21;3;0;31059;17560;12.0;6.8
39;2021-03-22;755;115;31814;17675;12.3;6.9
39;2021-03-23;1129;44;32943;17719;12.8;6.9
39;2021-03-24;1179;98;34122;17817;13.2;6.9
39;2021-03-25;2042;135;36164;17952;14.0;7.0
39;2021-03-26;797;115;36961;18067;14.3;7.0
39;2021-03-27;345;7;37306;18074;14.5;7.0
39;2021-03-28;36;4;37342;18078;14.5;7.0
39;2021-03-29;1036;194;38378;18272;14.9;7.1
39;2021-03-30;1400;268;39778;18540;15.4;7.2
39;2021-03-31;658;527;40436;19067;15.7;7.4
39;2021-04-01;1310;317;41746;19384;16.2;7.5
39;2021-04-02;626;129;42372;19513;16.4;7.6
39;2021-04-03;180;8;42552;19521;16.5;7.6
39;2021-04-04;4;1;42556;19522;16.5;7.6
39;2021-04-05;1;0;42557;19522;16.5;7.6
39;2021-04-06;824;634;43381;20156;16.8;7.8
39;2021-04-07;1133;680;44514;20836;17.3;8.1
39;2021-04-08;1790;580;46304;21416;18.0;8.3
39;2021-04-09;1675;293;47979;21709;18.6;8.4
39;2021-04-10;346;187;48325;21896;18.7;8.5
39;2021-04-11;2;0;48327;21896;18.7;8.5
39;2021-04-12;680;398;49007;22294;19.0;8.6
39;2021-04-13;1200;579;50207;22873;19.5;8.9
39;2021-04-14;845;640;51052;23513;19.8;9.1
39;2021-04-15;1479;722;52531;24235;20.4;9.4
39;2021-04-16;1090;176;53621;24411;20.8;9.5
39;2021-04-17;197;61;53818;24472;20.9;9.5
39;2021-04-18;0;0;53818;24472;20.9;9.5
39;2021-04-19;523;696;54341;25168;21.1;9.8
39;2021-04-20;766;547;55107;25715;21.4;10.0
39;2021-04-21;1143;723;56250;26438;21.8;10.3
39;2021-04-22;1012;1129;57262;27567;22.2;10.7
39;2021-04-23;457;364;57719;27931;22.4;10.8
39;2021-04-24;275;149;57994;28080;22.5;10.9
39;2021-04-25;12;3;58006;28083;22.5;10.9
39;2021-04-26;568;1040;58574;29123;22.7;11.3
39;2021-04-27;788;983;59362;30106;23.0;11.7
39;2021-04-28;1720;418;61082;30524;23.7;11.8
39;2021-04-29;2570;972;63652;31496;24.7;12.2
39;2021-04-30;2473;392;66125;31888;25.6;12.4
39;2021-05-01;41;53;66166;31941;25.7;12.4
39;2021-05-02;0;0;66166;31941;25.7;12.4
39;2021-05-03;917;811;67083;32752;26.0;12.7
39;2021-05-04;948;1122;68031;33874;26.4;13.1
39;2021-05-05;1954;882;69985;34756;27.1;13.5
39;2021-05-06;2424;1343;72409;36099;28.1;14.0
39;2021-05-07;1286;573;73695;36672;28.6;14.2
39;2021-05-08;179;55;73874;36727;28.7;14.2
39;2021-05-09;10;8;73884;36735;28.7;14.2
39;2021-05-10;1762;850;75646;37585;29.3;14.6
39;2021-05-11;1774;1514;77420;39099;30.0;15.2
39;2021-05-12;1810;1493;79230;40592;30.7;15.7
39;2021-05-13;246;23;79476;40615;30.8;15.8
39;2021-05-14;2392;335;81868;40950;31.8;15.9
39;2021-05-15;1848;255;83716;41205;32.5;16.0
39;2021-05-16;0;0;83716;41205;32.5;16.0
39;2021-05-17;1986;726;85702;41931;33.2;16.3
39;2021-05-18;1690;1180;87392;43111;33.9;16.7
39;2021-05-19;2496;555;89888;43666;34.9;16.9
39;2021-05-20;2465;756;92353;44422;35.8;17.2
39;2021-05-21;1800;561;94153;44983;36.5;17.4
39;2021-05-22;322;218;94475;45201;36.6;17.5
39;2021-05-23;8;36;94483;45237;36.6;17.5
39;2021-05-24;8;28;94491;45265;36.6;17.6
39;2021-05-25;1725;1197;96216;46462;37.3;18.0
39;2021-05-26;1643;1376;97859;47838;38.0;18.6
39;2021-05-27;1485;1623;99344;49461;38.5;19.2
39;2021-05-28;856;1219;100200;50680;38.9;19.7
39;2021-05-29;261;273;100461;50953;39.0;19.8
39;2021-05-30;2;40;100463;50993;39.0;19.8
39;2021-05-31;1625;1245;102088;52238;39.6;20.3
39;2021-06-01;1893;1321;103981;53559;40.3;20.8
39;2021-06-02;1706;1166;105687;54725;41.0;21.2
39;2021-06-03;1326;1158;107013;55883;41.5;21.7
39;2021-06-04;940;1070;107953;56953;41.9;22.1
39;2021-06-05;766;514;108719;57467;42.2;22.3
39;2021-06-06;1;36;108720;57503;42.2;22.3
39;2021-06-07;2103;918;110823;58421;43.0;22.7
39;2021-06-08;2209;1153;113032;59574;43.8;23.1
39;2021-06-09;1733;1240;114765;60814;44.5;23.6
39;2021-06-10;1616;2080;116381;62894;45.1;24.4
39;2021-06-11;1568;1270;117949;64164;45.7;24.9
39;2021-06-12;1262;348;119211;64512;46.2;25.0
39;2021-06-13;11;18;119222;64530;46.2;25.0
39;2021-06-14;1336;1889;120558;66419;46.8;25.8
39;2021-06-15;1386;1259;121944;67678;47.3;26.2
39;2021-06-16;1171;1532;123115;69210;47.7;26.8
39;2021-06-17;1044;1718;124159;70928;48.2;27.5
39;2021-06-18;1638;1180;125797;72108;48.8;28.0
39;2021-06-19;249;404;126046;72512;48.9;28.1
39;2021-06-20;2;18;126048;72530;48.9;28.1
39;2021-06-21;351;2495;126399;75025;49.0;29.1
39;2021-06-22;814;2293;127213;77318;49.3;30.0
39;2021-06-23;1200;1301;128413;78619;49.8;30.5
39;2021-06-24;736;1043;129149;79662;50.1;30.9
39;2021-06-25;679;2961;129828;82623;50.4;32.0
39;2021-06-26;206;1564;130034;84187;50.4;32.6
39;2021-06-27;0;0;130034;84187;50.4;32.6
39;2021-06-28;305;2743;130339;86930;50.5;33.7
39;2021-06-29;497;2697;130836;89627;50.7;34.8
39;2021-06-30;895;2424;131731;92051;51.1;35.7
39;2021-07-01;645;1939;132376;93990;51.3;36.5
39;2021-07-02;1111;1406;133487;95396;51.8;37.0
39;2021-07-03;554;524;134041;95920;52.0;37.2
39;2021-07-04;2;1;134043;95921;52.0;37.2
39;2021-07-05;602;2589;134645;98510;52.2;38.2
39;2021-07-06;835;1887;135480;100397;52.5;38.9
39;2021-07-07;591;1386;136071;101783;52.8;39.5
39;2021-07-08;700;906;136771;102689;53.0;39.8
39;2021-07-09;1078;1585;137849;104274;53.5;40.4
39;2021-07-10;739;476;138588;104750;53.7;40.6
39;2021-07-11;28;8;138616;104758;53.8;40.6
39;2021-07-12;577;2599;139193;107357;54.0;41.6
39;2021-07-13;1638;2660;140831;110017;54.6;42.7
39;2021-07-14;17;21;140848;110038;54.6;42.7
39;2021-07-15;1906;1838;142754;111876;55.4;43.4
39;2021-07-16;3226;2052;145980;113928;56.6;44.2
39;2021-07-17;2225;1163;148205;115091;57.5;44.6
39;2021-07-18;164;52;148369;115143;57.5;44.7
39;2021-07-19;1399;2950;149768;118093;58.1;45.8
39;2021-07-20;1842;2812;151610;120905;58.8;46.9
39;2021-07-21;2587;2581;154197;123486;59.8;47.9
39;2021-07-22;1934;1843;156131;125329;60.6;48.6
39;2021-07-23;1814;1933;157945;127262;61.3;49.4
39;2021-07-24;1400;1428;159345;128690;61.8;49.9
39;2021-07-25;0;1;159345;128691;61.8;49.9
39;2021-07-26;1318;2001;160663;130692;62.3;50.7
39;2021-07-27;2343;1904;163006;132596;63.2;51.4
39;2021-07-28;2688;1475;165694;134071;64.3;52.0
39;2021-07-29;2200;1743;167894;135814;65.1;52.7
39;2021-07-30;2045;1466;169939;137280;65.9;53.2
39;2021-07-31;1367;657;171306;137937;66.4;53.5
39;2021-08-01;10;18;171316;137955;66.4;53.5
39;2021-08-02;1205;1401;172521;139356;66.9;54.0
39;2021-08-03;1920;1486;174441;140842;67.7;54.6
39;2021-08-04;1046;659;175487;141501;68.1;54.9
39;2021-08-05;1241;740;176728;142241;68.5;55.2
39;2021-08-06;1375;2289;178103;144530;69.1;56.1
39;2021-08-07;1069;1213;179172;145743;69.5;56.5
39;2021-08-08;26;10;179198;145753;69.5;56.5
39;2021-08-09;436;304;179634;146057;69.7;56.6
39;2021-08-10;1230;931;180864;146988;70.1;57.0
39;2021-08-11;893;1532;181757;148520;70.5;57.6
39;2021-08-12;1596;2170;183353;150690;71.1;58.4
39;2021-08-13;1334;2119;184687;152809;71.6;59.3
39;2021-08-14;361;1106;185048;153915;71.8;59.7
39;2021-08-15;1;1;185049;153916;71.8;59.7
39;2021-08-16;488;736;185537;154652;72.0;60.0
39;2021-08-17;573;1442;186110;156094;72.2;60.5
39;2021-08-18;862;1727;186972;157821;72.5;61.2
39;2021-08-19;906;1593;187878;159414;72.9;61.8
39;2021-08-20;639;2500;188517;161914;73.1;62.8
39;2021-08-21;467;1291;188984;163205;73.3;63.3
39;2021-08-22;7;11;188991;163216;73.3;63.3
39;2021-08-23;266;972;189257;164188;73.4;63.7
39;2021-08-24;456;1607;189713;165795;73.6;64.3
39;2021-08-25;629;1604;190342;167399;73.8;64.9
39;2021-08-26;717;1859;191059;169258;74.1;65.6
39;2021-08-27;405;2060;191464;171318;74.3;66.4
39;2021-08-28;325;1369;191789;172687;74.4;67.0
39;2021-08-29;0;1;191789;172688;74.4;67.0
39;2021-08-30;345;1018;192134;173706;74.5;67.4
39;2021-08-31;399;1036;192533;174742;74.7;67.8
39;2021-09-01;512;1580;193045;176322;74.9;68.4
39;2021-09-02;332;1418;193377;177740;75.0;68.9
39;2021-09-03;475;2312;193852;180052;75.2;69.8
39;2021-09-04;148;203;194000;180255;75.2;69.9
39;2021-09-05;0;1;194000;180256;75.2;69.9
39;2021-09-06;239;502;194239;180758;75.3;70.1
39;2021-09-07;228;344;194467;181102;75.4;70.2
39;2021-09-08;441;779;194908;181881;75.6;70.5
39;2021-09-09;431;1118;195339;182999;75.8;71.0
39;2021-09-10;198;737;195537;183736;75.8;71.3
39;2021-09-11;282;889;195819;184625;75.9;71.6
39;2021-09-12;0;32;195819;184657;75.9;71.6
39;2021-09-13;141;221;195960;184878;76.0;71.7
39;2021-09-14;182;414;196142;185292;76.1;71.9
39;2021-09-15;266;585;196408;185877;76.2;72.1
39;2021-09-16;469;1051;196877;186928;76.4;72.5
39;2021-09-17;420;667;197297;187595;76.5;72.8
39;2021-09-18;96;237;197393;187832;76.6;72.8
39;2021-09-19;3;3;197396;187835;76.6;72.8
39;2021-09-20;70;128;197466;187963;76.6;72.9
39;2021-09-21;87;125;197553;188088;76.6;72.9
39;2021-09-22;268;777;197821;188865;76.7;73.2
39;2021-09-23;173;312;197994;189177;76.8;73.4
39;2021-09-24;206;584;198200;189761;76.9;73.6
39;2021-09-25;65;250;198265;190011;76.9;73.7
39;2021-09-26;0;0;198265;190011;76.9;73.7
39;2021-09-27;131;318;198396;190329;76.9;73.8
39;2021-09-28;55;138;198451;190467;77.0;73.9
39;2021-09-29;195;511;198646;190978;77.0;74.1
39;2021-09-30;196;446;198842;191424;77.1;74.2
39;2021-10-01;103;199;198945;191623;77.2;74.3
39;2021-10-02;97;228;199042;191851;77.2;74.4
39;2021-10-03;2;1;199044;191852;77.2;74.4
40;2020-12-27;0;0;0;0;0.0;0.0
40;2020-12-28;0;0;0;0;0.0;0.0
40;2020-12-29;0;0;0;0;0.0;0.0
40;2020-12-30;0;0;0;0;0.0;0.0
40;2020-12-31;1;0;1;0;0.0;0.0
40;2021-01-01;0;0;1;0;0.0;0.0
40;2021-01-02;0;0;1;0;0.0;0.0
40;2021-01-03;0;0;1;0;0.0;0.0
40;2021-01-04;0;0;1;0;0.0;0.0
40;2021-01-05;0;0;1;0;0.0;0.0
40;2021-01-06;1;0;2;0;0.0;0.0
40;2021-01-07;212;0;214;0;0.1;0.0
40;2021-01-08;391;2;605;2;0.1;0.0
40;2021-01-09;0;0;605;2;0.1;0.0
40;2021-01-10;1;0;606;2;0.1;0.0
40;2021-01-11;111;0;717;2;0.2;0.0
40;2021-01-12;0;0;717;2;0.2;0.0
40;2021-01-13;681;5;1398;7;0.3;0.0
40;2021-01-14;901;7;2299;14;0.6;0.0
40;2021-01-15;811;3;3110;17;0.8;0.0
40;2021-01-16;157;0;3267;17;0.8;0.0
40;2021-01-17;1;1;3268;18;0.8;0.0
40;2021-01-18;406;0;3674;18;0.9;0.0
40;2021-01-19;1202;3;4876;21;1.2;0.0
40;2021-01-20;881;2;5757;23;1.4;0.0
40;2021-01-21;1266;5;7023;28;1.7;0.0
40;2021-01-22;811;2;7834;30;1.9;0.0
40;2021-01-23;289;0;8123;30;2.0;0.0
40;2021-01-24;2;0;8125;30;2.0;0.0
40;2021-01-25;394;2;8519;32;2.1;0.0
40;2021-01-26;802;5;9321;37;2.3;0.0
40;2021-01-27;1118;11;10439;48;2.5;0.0
40;2021-01-28;709;109;11148;157;2.7;0.0
40;2021-01-29;601;225;11749;382;2.9;0.1
40;2021-01-30;237;3;11986;385;2.9;0.1
40;2021-01-31;1;0;11987;385;2.9;0.1
40;2021-02-01;359;127;12346;512;3.0;0.1
40;2021-02-02;922;50;13268;562;3.2;0.1
40;2021-02-03;895;294;14163;856;3.4;0.2
40;2021-02-04;1059;543;15222;1399;3.7;0.3
40;2021-02-05;794;333;16016;1732;3.9;0.4
40;2021-02-06;382;81;16398;1813;4.0;0.4
40;2021-02-07;10;0;16408;1813;4.0;0.4
40;2021-02-08;375;103;16783;1916;4.1;0.5
40;2021-02-09;812;499;17595;2415;4.3;0.6
40;2021-02-10;749;394;18344;2809;4.5;0.7
40;2021-02-11;739;556;19083;3365;4.6;0.8
40;2021-02-12;627;570;19710;3935;4.8;1.0
40;2021-02-13;400;83;20110;4018;4.9;1.0
40;2021-02-14;0;0;20110;4018;4.9;1.0
40;2021-02-15;48;318;20158;4336;4.9;1.1
40;2021-02-16;284;487;20442;4823;5.0;1.2
40;2021-02-17;359;804;20801;5627;5.0;1.4
40;2021-02-18;383;587;21184;6214;5.1;1.5
40;2021-02-19;145;551;21329;6765;5.2;1.6
40;2021-02-20;39;80;21368;6845;5.2;1.7
40;2021-02-21;1;63;21369;6908;5.2;1.7
40;2021-02-22;53;453;21422;7361;5.2;1.8
40;2021-02-23;180;688;21602;8049;5.2;2.0
40;2021-02-24;283;570;21885;8619;5.3;2.1
40;2021-02-25;726;861;22611;9480;5.5;2.3
40;2021-02-26;656;518;23267;9998;5.6;2.4
40;2021-02-27;384;91;23651;10089;5.7;2.4
40;2021-02-28;2;0;23653;10089;5.7;2.4
40;2021-03-01;418;443;24071;10532;5.8;2.6
40;2021-03-02;733;863;24804;11395;6.0;2.8
40;2021-03-03;934;760;25738;12155;6.2;3.0
40;2021-03-04;1324;722;27062;12877;6.6;3.1
40;2021-03-05;1233;645;28295;13522;6.9;3.3
40;2021-03-06;868;338;29163;13860;7.1;3.4
40;2021-03-07;92;2;29255;13862;7.1;3.4
40;2021-03-08;838;435;30093;14297;7.3;3.5
40;2021-03-09;1505;555;31598;14852;7.7;3.6
40;2021-03-10;1754;672;33352;15524;8.1;3.8
40;2021-03-11;1986;631;35338;16155;8.6;3.9
40;2021-03-12;2051;519;37389;16674;9.1;4.0
40;2021-03-13;972;245;38361;16919;9.3;4.1
40;2021-03-14;98;0;38459;16919;9.3;4.1
40;2021-03-15;925;87;39384;17006;9.6;4.1
40;2021-03-16;988;260;40372;17266;9.8;4.2
40;2021-03-17;1577;335;41949;17601;10.2;4.3
40;2021-03-18;1559;332;43508;17933;10.6;4.4
40;2021-03-19;1808;140;45316;18073;11.0;4.4
40;2021-03-20;706;14;46022;18087;11.2;4.4
40;2021-03-21;52;1;46074;18088;11.2;4.4
40;2021-03-22;1174;35;47248;18123;11.5;4.4
40;2021-03-23;2325;167;49573;18290;12.0;4.4
40;2021-03-24;2327;232;51900;18522;12.6;4.5
40;2021-03-25;2768;380;54668;18902;13.3;4.6
40;2021-03-26;3123;202;57791;19104;14.0;4.6
40;2021-03-27;923;47;58714;19151;14.3;4.6
40;2021-03-28;178;47;58892;19198;14.3;4.7
40;2021-03-29;1153;374;60045;19572;14.6;4.8
40;2021-03-30;2298;387;62343;19959;15.1;4.8
40;2021-03-31;1994;300;64337;20259;15.6;4.9
40;2021-04-01;2413;333;66750;20592;16.2;5.0
40;2021-04-02;2361;219;69111;20811;16.8;5.1
40;2021-04-03;741;120;69852;20931;17.0;5.1
40;2021-04-04;362;8;70214;20939;17.0;5.1
40;2021-04-05;523;40;70737;20979;17.2;5.1
40;2021-04-06;2095;802;72832;21781;17.7;5.3
40;2021-04-07;2664;869;75496;22650;18.3;5.5
40;2021-04-08;3062;895;78558;23545;19.1;5.7
40;2021-04-09;3826;604;82384;24149;20.0;5.9
40;2021-04-10;1599;341;83983;24490;20.4;5.9
40;2021-04-11;52;6;84035;24496;20.4;5.9
40;2021-04-12;2178;729;86213;25225;20.9;6.1
40;2021-04-13;2567;1089;88780;26314;21.5;6.4
40;2021-04-14;2572;1375;91352;27689;22.2;6.7
40;2021-04-15;2987;1505;94339;29194;22.9;7.1
40;2021-04-16;2878;1180;97217;30374;23.6;7.4
40;2021-04-17;1464;345;98681;30719;24.0;7.5
40;2021-04-18;57;24;98738;30743;24.0;7.5
40;2021-04-19;1056;1019;99794;31762;24.2;7.7
40;2021-04-20;1622;1743;101416;33505;24.6;8.1
40;2021-04-21;1777;1734;103193;35239;25.0;8.6
40;2021-04-22;2112;1771;105305;37010;25.6;9.0
40;2021-04-23;2163;1390;107468;38400;26.1;9.3
40;2021-04-24;1329;622;108797;39022;26.4;9.5
40;2021-04-25;37;57;108834;39079;26.4;9.5
40;2021-04-26;1251;1133;110085;40212;26.7;9.8
40;2021-04-27;1487;2030;111572;42242;27.1;10.3
40;2021-04-28;2052;1365;113624;43607;27.6;10.6
40;2021-04-29;2609;1888;116233;45495;28.2;11.0
40;2021-04-30;2701;1613;118934;47108;28.9;11.4
40;2021-05-01;1228;781;120162;47889;29.2;11.6
40;2021-05-02;143;322;120305;48211;29.2;11.7
40;2021-05-03;1857;1498;122162;49709;29.7;12.1
40;2021-05-04;1880;2464;124042;52173;30.1;12.7
40;2021-05-05;2187;2668;126229;54841;30.6;13.3
40;2021-05-06;2237;2864;128466;57705;31.2;14.0
40;2021-05-07;1902;3003;130368;60708;31.6;14.7
40;2021-05-08;675;469;131043;61177;31.8;14.8
40;2021-05-09;316;22;131359;61199;31.9;14.9
40;2021-05-10;1400;2040;132759;63239;32.2;15.4
40;2021-05-11;2196;2504;134955;65743;32.8;16.0
40;2021-05-12;2731;1943;137686;67686;33.4;16.4
40;2021-05-13;1984;511;139670;68197;33.9;16.6
40;2021-05-14;2324;1657;141994;69854;34.5;17.0
40;2021-05-15;1340;961;143334;70815;34.8;17.2
40;2021-05-16;434;24;143768;70839;34.9;17.2
40;2021-05-17;2119;1305;145887;72144;35.4;17.5
40;2021-05-18;2508;1404;148395;73548;36.0;17.9
40;2021-05-19;2954;1105;151349;74653;36.7;18.1
40;2021-05-20;3584;1159;154933;75812;37.6;18.4
40;2021-05-21;2925;1319;157858;77131;38.3;18.7
40;2021-05-22;1146;794;159004;77925;38.6;18.9
40;2021-05-23;631;29;159635;77954;38.7;18.9
40;2021-05-24;1212;332;160847;78286;39.0;19.0
40;2021-05-25;2168;1310;163015;79596;39.6;19.3
40;2021-05-26;2614;1562;165629;81158;40.2;19.7
40;2021-05-27;2733;1998;168362;83156;40.9;20.2
40;2021-05-28;2567;2270;170929;85426;41.5;20.7
40;2021-05-29;1558;1252;172487;86678;41.9;21.0
40;2021-05-30;4;52;172491;86730;41.9;21.1
40;2021-05-31;2566;1207;175057;87937;42.5;21.3
40;2021-06-01;3011;1766;178068;89703;43.2;21.8
40;2021-06-02;3170;1988;181238;91691;44.0;22.3
40;2021-06-03;3591;2330;184829;94021;44.9;22.8
40;2021-06-04;3015;2802;187844;96823;45.6;23.5
40;2021-06-05;1780;1395;189624;98218;46.0;23.8
40;2021-06-06;458;79;190082;98297;46.1;23.9
40;2021-06-07;2184;2021;192266;100318;46.7;24.4
40;2021-06-08;2954;2096;195220;102414;47.4;24.9
40;2021-06-09;3212;2266;198432;104680;48.2;25.4
40;2021-06-10;2993;2097;201425;106777;48.9;25.9
40;2021-06-11;3142;2792;204567;109569;49.7;26.6
40;2021-06-12;1963;1634;206530;111203;50.1;27.0
40;2021-06-13;645;162;207175;111365;50.3;27.0
40;2021-06-14;1457;2494;208632;113859;50.6;27.6
40;2021-06-15;2235;2818;210867;116677;51.2;28.3
40;2021-06-16;2608;2459;213475;119136;51.8;28.9
40;2021-06-17;2431;2439;215906;121575;52.4;29.5
40;2021-06-18;2326;2902;218232;124477;53.0;30.2
40;2021-06-19;1799;1226;220031;125703;53.4;30.5
40;2021-06-20;346;276;220377;125979;53.5;30.6
40;2021-06-21;1395;2317;221772;128296;53.8;31.1
40;2021-06-22;1690;2995;223462;131291;54.2;31.9
40;2021-06-23;1603;3343;225065;134634;54.6;32.7
40;2021-06-24;1733;2384;226798;137018;55.1;33.3
40;2021-06-25;1757;3258;228555;140276;55.5;34.0
40;2021-06-26;1328;1712;229883;141988;55.8;34.5
40;2021-06-27;262;354;230145;142342;55.9;34.6
40;2021-06-28;1334;2818;231479;145160;56.2;35.2
40;2021-06-29;1712;3392;233191;148552;56.6;36.1
40;2021-06-30;1773;3638;234964;152190;57.0;36.9
40;2021-07-01;1714;3951;236678;156141;57.4;37.9
40;2021-07-02;1561;3809;238239;159950;57.8;38.8
40;2021-07-03;676;1919;238915;161869;58.0;39.3
40;2021-07-04;219;483;239134;162352;58.0;39.4
40;2021-07-05;1477;3020;240611;165372;58.4;40.1
40;2021-07-06;1768;3613;242379;168985;58.8;41.0
40;2021-07-07;1973;3847;244352;172832;59.3;42.0
40;2021-07-08;2099;3408;246451;176240;59.8;42.8
40;2021-07-09;2108;3946;248559;180186;60.3;43.7
40;2021-07-10;1004;2156;249563;182342;60.6;44.3
40;2021-07-11;207;294;249770;182636;60.6;44.3
40;2021-07-12;1314;4046;251084;186682;60.9;45.3
40;2021-07-13;2428;4697;253512;191379;61.5;46.5
40;2021-07-14;2198;2060;255710;193439;62.1;47.0
40;2021-07-15;2842;4860;258552;198299;62.8;48.1
40;2021-07-16;3311;3943;261863;202242;63.6;49.1
40;2021-07-17;2110;2595;263973;204837;64.1;49.7
40;2021-07-18;472;542;264445;205379;64.2;49.9
40;2021-07-19;2565;3697;267010;209076;64.8;50.7
40;2021-07-20;3065;4050;270075;213126;65.6;51.7
40;2021-07-21;3203;3887;273278;217013;66.3;52.7
40;2021-07-22;3857;3933;277135;220946;67.3;53.6
40;2021-07-23;4092;4110;281227;225056;68.3;54.6
40;2021-07-24;2795;2113;284022;227169;68.9;55.1
40;2021-07-25;958;491;284980;227660;69.2;55.3
40;2021-07-26;2940;3076;287920;230736;69.9;56.0
40;2021-07-27;3526;3602;291446;234338;70.7;56.9
40;2021-07-28;3379;3396;294825;237734;71.6;57.7
40;2021-07-29;3546;3432;298371;241166;72.4;58.5
40;2021-07-30;3136;3405;301507;244571;73.2;59.4
40;2021-07-31;1781;1907;303288;246478;73.6;59.8
40;2021-08-01;342;287;303630;246765;73.7;59.9
40;2021-08-02;2003;2382;305633;249147;74.2;60.5
40;2021-08-03;2335;2695;307968;251842;74.8;61.1
40;2021-08-04;2094;2323;310062;254165;75.3;61.7
40;2021-08-05;1971;2669;312033;256834;75.7;62.3
40;2021-08-06;1886;3067;313919;259901;76.2;63.1
40;2021-08-07;1218;1746;315137;261647;76.5;63.5
40;2021-08-08;84;154;315221;261801;76.5;63.5
40;2021-08-09;1600;3124;316821;264925;76.9;64.3
40;2021-08-10;1429;3158;318250;268083;77.2;65.1
40;2021-08-11;1422;2844;319672;270927;77.6;65.8
40;2021-08-12;1277;3102;320949;274029;77.9;66.5
40;2021-08-13;1138;2979;322087;277008;78.2;67.2
40;2021-08-14;618;2033;322705;279041;78.3;67.7
40;2021-08-15;5;172;322710;279213;78.3;67.8
40;2021-08-16;1108;3383;323818;282596;78.6;68.6
40;2021-08-17;1159;3418;324977;286014;78.9;69.4
40;2021-08-18;989;3258;325966;289272;79.1;70.2
40;2021-08-19;855;2972;326821;292244;79.3;70.9
40;2021-08-20;811;3033;327632;295277;79.5;71.7
40;2021-08-21;523;1901;328155;297178;79.7;72.1
40;2021-08-22;71;464;328226;297642;79.7;72.2
40;2021-08-23;730;2818;328956;300460;79.8;72.9
40;2021-08-24;696;2540;329652;303000;80.0;73.5
40;2021-08-25;678;2002;330330;305002;80.2;74.0
40;2021-08-26;493;1674;330823;306676;80.3;74.4
40;2021-08-27;638;2468;331461;309144;80.5;75.0
40;2021-08-28;328;1215;331789;310359;80.5;75.3
40;2021-08-29;1;9;331790;310368;80.5;75.3
40;2021-08-30;600;2160;332390;312528;80.7;75.9
40;2021-08-31;469;1466;332859;313994;80.8;76.2
40;2021-09-01;449;1548;333308;315542;80.9;76.6
40;2021-09-02;403;1501;333711;317043;81.0;77.0
40;2021-09-03;441;1631;334152;318674;81.1;77.4
40;2021-09-04;369;1187;334521;319861;81.2;77.6
40;2021-09-05;4;26;334525;319887;81.2;77.6
40;2021-09-06;244;880;334769;320767;81.3;77.9
40;2021-09-07;293;977;335062;321744;81.3;78.1
40;2021-09-08;415;1237;335477;322981;81.4;78.4
40;2021-09-09;263;1037;335740;324018;81.5;78.6
40;2021-09-10;358;1279;336098;325297;81.6;79.0
40;2021-09-11;248;887;336346;326184;81.6;79.2
40;2021-09-12;8;8;336354;326192;81.6;79.2
40;2021-09-13;370;950;336724;327142;81.7;79.4
40;2021-09-14;291;884;337015;328026;81.8;79.6
40;2021-09-15;444;895;337459;328921;81.9;79.8
40;2021-09-16;238;348;337697;329269;82.0;79.9
40;2021-09-17;365;788;338062;330057;82.1;80.1
40;2021-09-18;179;634;338241;330691;82.1;80.3
40;2021-09-19;0;9;338241;330700;82.1;80.3
40;2021-09-20;151;382;338392;331082;82.1;80.4
40;2021-09-21;149;286;338541;331368;82.2;80.4
40;2021-09-22;229;559;338770;331927;82.2;80.6
40;2021-09-23;164;297;338934;332224;82.3;80.6
40;2021-09-24;237;606;339171;332830;82.3;80.8
40;2021-09-25;134;427;339305;333257;82.4;80.9
40;2021-09-26;0;2;339305;333259;82.4;80.9
40;2021-09-27;86;224;339391;333483;82.4;80.9
40;2021-09-28;82;229;339473;333712;82.4;81.0
40;2021-09-29;203;583;339676;334295;82.4;81.1
40;2021-09-30;98;220;339774;334515;82.5;81.2
40;2021-10-01;223;435;339997;334950;82.5;81.3
40;2021-10-02;180;321;340177;335271;82.6;81.4
40;2021-10-03;0;2;340177;335273;82.6;81.4
41;2020-12-27;0;0;0;0;0.0;0.0
41;2020-12-28;0;0;0;0;0.0;0.0
41;2020-12-29;0;0;0;0;0.0;0.0
41;2020-12-30;0;0;0;0;0.0;0.0
41;2020-12-31;0;0;0;0;0.0;0.0
41;2021-01-01;0;0;0;0;0.0;0.0
41;2021-01-02;2;0;2;0;0.0;0.0
41;2021-01-03;0;0;2;0;0.0;0.0
41;2021-01-04;0;0;2;0;0.0;0.0
41;2021-01-05;35;0;37;0;0.0;0.0
41;2021-01-06;71;0;108;0;0.0;0.0
41;2021-01-07;21;0;129;0;0.0;0.0
41;2021-01-08;1;0;130;0;0.0;0.0
41;2021-01-09;0;0;130;0;0.0;0.0
41;2021-01-10;0;0;130;0;0.0;0.0
41;2021-01-11;133;0;263;0;0.1;0.0
41;2021-01-12;321;1;584;1;0.2;0.0
41;2021-01-13;271;0;855;1;0.3;0.0
41;2021-01-14;284;1;1139;2;0.3;0.0
41;2021-01-15;215;1;1354;3;0.4;0.0
41;2021-01-16;0;0;1354;3;0.4;0.0
41;2021-01-17;0;0;1354;3;0.4;0.0
41;2021-01-18;397;2;1751;5;0.5;0.0
41;2021-01-19;857;2;2608;7;0.8;0.0
41;2021-01-20;1060;3;3668;10;1.1;0.0
41;2021-01-21;1568;2;5236;12;1.6;0.0
41;2021-01-22;839;1;6075;13;1.9;0.0
41;2021-01-23;92;0;6167;13;1.9;0.0
41;2021-01-24;0;0;6167;13;1.9;0.0
41;2021-01-25;421;1;6588;14;2.0;0.0
41;2021-01-26;473;3;7061;17;2.2;0.0
41;2021-01-27;441;2;7502;19;2.3;0.0
41;2021-01-28;604;56;8106;75;2.5;0.0
41;2021-01-29;260;13;8366;88;2.6;0.0
41;2021-01-30;0;0;8366;88;2.6;0.0
41;2021-01-31;0;0;8366;88;2.6;0.0
41;2021-02-01;349;121;8715;209;2.7;0.1
41;2021-02-02;471;216;9186;425;2.8;0.1
41;2021-02-03;341;200;9527;625;2.9;0.2
41;2021-02-04;559;136;10086;761;3.1;0.2
41;2021-02-05;329;167;10415;928;3.2;0.3
41;2021-02-06;5;0;10420;928;3.2;0.3
41;2021-02-07;2;0;10422;928;3.2;0.3
41;2021-02-08;305;273;10727;1201;3.3;0.4
41;2021-02-09;599;410;11326;1611;3.5;0.5
41;2021-02-10;486;671;11812;2282;3.6;0.7
41;2021-02-11;1066;1152;12878;3434;3.9;1.0
41;2021-02-12;688;355;13566;3789;4.1;1.2
41;2021-02-13;9;5;13575;3794;4.1;1.2
41;2021-02-14;3;27;13578;3821;4.1;1.2
41;2021-02-15;314;259;13892;4080;4.2;1.2
41;2021-02-16;354;468;14246;4548;4.3;1.4
41;2021-02-17;317;400;14563;4948;4.4;1.5
41;2021-02-18;616;267;15179;5215;4.6;1.6
41;2021-02-19;456;279;15635;5494;4.8;1.7
41;2021-02-20;68;37;15703;5531;4.8;1.7
41;2021-02-21;0;0;15703;5531;4.8;1.7
41;2021-02-22;311;332;16014;5863;4.9;1.8
41;2021-02-23;454;270;16468;6133;5.0;1.9
41;2021-02-24;282;365;16750;6498;5.1;2.0
41;2021-02-25;675;383;17425;6881;5.3;2.1
41;2021-02-26;630;220;18055;7101;5.5;2.2
41;2021-02-27;161;4;18216;7105;5.6;2.2
41;2021-02-28;4;31;18220;7136;5.6;2.2
41;2021-03-01;311;260;18531;7396;5.7;2.3
41;2021-03-02;649;337;19180;7733;5.9;2.4
41;2021-03-03;497;366;19677;8099;6.0;2.5
41;2021-03-04;786;749;20463;8848;6.2;2.7
41;2021-03-05;840;638;21303;9486;6.5;2.9
41;2021-03-06;715;22;22018;9508;6.7;2.9
41;2021-03-07;498;18;22516;9526;6.9;2.9
41;2021-03-08;301;334;22817;9860;7.0;3.0
41;2021-03-09;1042;402;23859;10262;7.3;3.1
41;2021-03-10;721;440;24580;10702;7.5;3.3
41;2021-03-11;1182;636;25762;11338;7.9;3.5
41;2021-03-12;1115;398;26877;11736;8.2;3.6
41;2021-03-13;1224;19;28101;11755;8.6;3.6
41;2021-03-14;392;7;28493;11762;8.7;3.6
41;2021-03-15;798;340;29291;12102;8.9;3.7
41;2021-03-16;1061;402;30352;12504;9.3;3.8
41;2021-03-17;587;236;30939;12740;9.4;3.9
41;2021-03-18;926;395;31865;13135;9.7;4.0
41;2021-03-19;911;328;32776;13463;10.0;4.1
41;2021-03-20;543;16;33319;13479;10.2;4.1
41;2021-03-21;1;0;33320;13479;10.2;4.1
41;2021-03-22;810;271;34130;13750;10.4;4.2
41;2021-03-23;1309;482;35439;14232;10.8;4.3
41;2021-03-24;1231;363;36670;14595;11.2;4.5
41;2021-03-25;2026;436;38696;15031;11.8;4.6
41;2021-03-26;1655;325;40351;15356;12.3;4.7
41;2021-03-27;451;58;40802;15414;12.4;4.7
41;2021-03-28;1;0;40803;15414;12.4;4.7
41;2021-03-29;939;306;41742;15720;12.7;4.8
41;2021-03-30;1496;592;43238;16312;13.2;5.0
41;2021-03-31;1148;490;44386;16802;13.5;5.1
41;2021-04-01;2252;565;46638;17367;14.2;5.3
41;2021-04-02;1241;473;47879;17840;14.6;5.4
41;2021-04-03;321;5;48200;17845;14.7;5.4
41;2021-04-04;39;0;48239;17845;14.7;5.4
41;2021-04-05;140;2;48379;17847;14.8;5.4
41;2021-04-06;1302;623;49681;18470;15.2;5.6
41;2021-04-07;1852;703;51533;19173;15.7;5.8
41;2021-04-08;2294;915;53827;20088;16.4;6.1
41;2021-04-09;2568;612;56395;20700;17.2;6.3
41;2021-04-10;954;496;57349;21196;17.5;6.5
41;2021-04-11;279;376;57628;21572;17.6;6.6
41;2021-04-12;1689;656;59317;22228;18.1;6.8
41;2021-04-13;2259;987;61576;23215;18.8;7.1
41;2021-04-14;1794;546;63370;23761;19.3;7.2
41;2021-04-15;2384;975;65754;24736;20.1;7.5
41;2021-04-16;1929;625;67683;25361;20.6;7.7
41;2021-04-17;647;137;68330;25498;20.8;7.8
41;2021-04-18;5;0;68335;25498;20.8;7.8
41;2021-04-19;1260;744;69595;26242;21.2;8.0
41;2021-04-20;2004;1197;71599;27439;21.8;8.4
41;2021-04-21;1503;919;73102;28358;22.3;8.7
41;2021-04-22;2236;1599;75338;29957;23.0;9.1
41;2021-04-23;1736;1078;77074;31035;23.5;9.5
41;2021-04-24;1544;283;78618;31318;24.0;9.6
41;2021-04-25;1007;21;79625;31339;24.3;9.6
41;2021-04-26;1355;625;80980;31964;24.7;9.8
41;2021-04-27;2092;1033;83072;32997;25.3;10.1
41;2021-04-28;1562;858;84634;33855;25.8;10.3
41;2021-04-29;2210;1376;86844;35231;26.5;10.7
41;2021-04-30;1963;863;88807;36094;27.1;11.0
41;2021-05-01;189;12;88996;36106;27.1;11.0
41;2021-05-02;107;17;89103;36123;27.2;11.0
41;2021-05-03;1864;892;90967;37015;27.7;11.3
41;2021-05-04;2091;1543;93058;38558;28.4;11.8
41;2021-05-05;1882;1188;94940;39746;29.0;12.1
41;2021-05-06;2448;1692;97388;41438;29.7;12.6
41;2021-05-07;2016;1802;99404;43240;30.3;13.2
41;2021-05-08;202;154;99606;43394;30.4;13.2
41;2021-05-09;11;354;99617;43748;30.4;13.3
41;2021-05-10;1590;1556;101207;45304;30.9;13.8
41;2021-05-11;2085;2100;103292;47404;31.5;14.5
41;2021-05-12;1951;1678;105243;49082;32.1;15.0
41;2021-05-13;1485;948;106728;50030;32.6;15.3
41;2021-05-14;1576;1305;108304;51335;33.0;15.7
41;2021-05-15;206;294;108510;51629;33.1;15.7
41;2021-05-16;4;0;108514;51629;33.1;15.7
41;2021-05-17;2483;564;110997;52193;33.9;15.9
41;2021-05-18;3138;1029;114135;53222;34.8;16.2
41;2021-05-19;2553;673;116688;53895;35.6;16.4
41;2021-05-20;3349;1148;120037;55043;36.6;16.8
41;2021-05-21;2727;967;122764;56010;37.4;17.1
41;2021-05-22;396;237;123160;56247;37.6;17.2
41;2021-05-23;6;2;123166;56249;37.6;17.2
41;2021-05-24;2605;150;125771;56399;38.4;17.2
41;2021-05-25;2991;577;128762;56976;39.3;17.4
41;2021-05-26;3036;650;131798;57626;40.2;17.6
41;2021-05-27;3294;1109;135092;58735;41.2;17.9
41;2021-05-28;3144;971;138236;59706;42.2;18.2
41;2021-05-29;2073;429;140309;60135;42.8;18.3
41;2021-05-30;344;22;140653;60157;42.9;18.3
41;2021-05-31;1710;1499;142363;61656;43.4;18.8
41;2021-06-01;2263;2010;144626;63666;44.1;19.4
41;2021-06-02;1832;1288;146458;64954;44.7;19.8
41;2021-06-03;2597;1940;149055;66894;45.5;20.4
41;2021-06-04;2303;1958;151358;68852;46.2;21.0
41;2021-06-05;611;1583;151969;70435;46.4;21.5
41;2021-06-06;109;927;152078;71362;46.4;21.8
41;2021-06-07;1515;1530;153593;72892;46.9;22.2
41;2021-06-08;1712;2409;155305;75301;47.4;23.0
41;2021-06-09;1615;1635;156920;76936;47.9;23.5
41;2021-06-10;1917;1813;158837;78749;48.5;24.0
41;2021-06-11;1572;1790;160409;80539;48.9;24.6
41;2021-06-12;664;648;161073;81187;49.1;24.8
41;2021-06-13;13;77;161086;81264;49.1;24.8
41;2021-06-14;1269;1962;162355;83226;49.5;25.4
41;2021-06-15;1834;2757;164189;85983;50.1;26.2
41;2021-06-16;1724;2308;165913;88291;50.6;26.9
41;2021-06-17;1810;2573;167723;90864;51.2;27.7
41;2021-06-18;1662;2399;169385;93263;51.7;28.4
41;2021-06-19;412;529;169797;93792;51.8;28.6
41;2021-06-20;11;32;169808;93824;51.8;28.6
41;2021-06-21;1325;1779;171133;95603;52.2;29.2
41;2021-06-22;1619;2561;172752;98164;52.7;29.9
41;2021-06-23;1375;2038;174127;100202;53.1;30.6
41;2021-06-24;1483;2307;175610;102509;53.6;31.3
41;2021-06-25;1294;2617;176904;105126;54.0;32.1
41;2021-06-26;433;614;177337;105740;54.1;32.3
41;2021-06-27;1;4;177338;105744;54.1;32.3
41;2021-06-28;404;2696;177742;108440;54.2;33.1
41;2021-06-29;664;3442;178406;111882;54.4;34.1
41;2021-06-30;552;3067;178958;114949;54.6;35.1
41;2021-07-01;765;3098;179723;118047;54.8;36.0
41;2021-07-02;589;3500;180312;121547;55.0;37.1
41;2021-07-03;158;646;180470;122193;55.0;37.3
41;2021-07-04;2;2;180472;122195;55.0;37.3
41;2021-07-05;285;2818;180757;125013;55.1;38.1
41;2021-07-06;666;3633;181423;128646;55.3;39.2
41;2021-07-07;479;3137;181902;131783;55.5;40.2
41;2021-07-08;940;3365;182842;135148;55.8;41.2
41;2021-07-09;540;3641;183382;138789;55.9;42.3
41;2021-07-10;247;2087;183629;140876;56.0;43.0
41;2021-07-11;5;280;183634;141156;56.0;43.1
41;2021-07-12;861;2291;184495;143447;56.3;43.8
41;2021-07-13;1198;3282;185693;146729;56.6;44.8
41;2021-07-14;141;1080;185834;147809;56.7;45.1
41;2021-07-15;1334;3319;187168;151128;57.1;46.1
41;2021-07-16;1091;3389;188259;154517;57.4;47.1
41;2021-07-17;344;807;188603;155324;57.5;47.4
41;2021-07-18;24;32;188627;155356;57.5;47.4
41;2021-07-19;1191;2319;189818;157675;57.9;48.1
41;2021-07-20;1643;2743;191461;160418;58.4;48.9
41;2021-07-21;1709;2083;193170;162501;58.9;49.6
41;2021-07-22;2263;2290;195433;164791;59.6;50.3
41;2021-07-23;2104;2468;197537;167259;60.3;51.0
41;2021-07-24;329;841;197866;168100;60.4;51.3
41;2021-07-25;19;23;197885;168123;60.4;51.3
41;2021-07-26;1902;1677;199787;169800;60.9;51.8
41;2021-07-27;2534;2341;202321;172141;61.7;52.5
41;2021-07-28;2161;1829;204482;173970;62.4;53.1
41;2021-07-29;2345;2026;206827;175996;63.1;53.7
41;2021-07-30;2151;2085;208978;178081;63.7;54.3
41;2021-07-31;380;581;209358;178662;63.9;54.5
41;2021-08-01;21;7;209379;178669;63.9;54.5
41;2021-08-02;1550;1605;210929;180274;64.3;55.0
41;2021-08-03;2517;1857;213446;182131;65.1;55.6
41;2021-08-04;2302;1199;215748;183330;65.8;55.9
41;2021-08-05;3046;1265;218794;184595;66.7;56.3
41;2021-08-06;2214;1302;221008;185897;67.4;56.7
41;2021-08-07;511;347;221519;186244;67.6;56.8
41;2021-08-08;13;20;221532;186264;67.6;56.8
41;2021-08-09;1689;1357;223221;187621;68.1;57.2
41;2021-08-10;2563;1421;225784;189042;68.9;57.7
41;2021-08-11;1593;1440;227377;190482;69.4;58.1
41;2021-08-12;1942;1339;229319;191821;69.9;58.5
41;2021-08-13;1474;1697;230793;193518;70.4;59.0
41;2021-08-14;364;205;231157;193723;70.5;59.1
41;2021-08-15;0;16;231157;193739;70.5;59.1
41;2021-08-16;864;2069;232021;195808;70.8;59.7
41;2021-08-17;1498;1634;233519;197442;71.2;60.2
41;2021-08-18;1135;1971;234654;199413;71.6;60.8
41;2021-08-19;1311;1554;235965;200967;72.0;61.3
41;2021-08-20;915;2313;236880;203280;72.3;62.0
41;2021-08-21;120;227;237000;203507;72.3;62.1
41;2021-08-22;1;32;237001;203539;72.3;62.1
41;2021-08-23;694;2295;237695;205834;72.5;62.8
41;2021-08-24;1415;2313;239110;208147;72.9;63.5
41;2021-08-25;620;2200;239730;210347;73.1;64.2
41;2021-08-26;843;2821;240573;213168;73.4;65.0
41;2021-08-27;620;2763;241193;215931;73.6;65.9
41;2021-08-28;99;622;241292;216553;73.6;66.1
41;2021-08-29;46;24;241338;216577;73.6;66.1
41;2021-08-30;668;2118;242006;218695;73.8;66.7
41;2021-08-31;765;2597;242771;221292;74.1;67.5
41;2021-09-01;500;1831;243271;223123;74.2;68.1
41;2021-09-02;628;2155;243899;225278;74.4;68.7
41;2021-09-03;650;2228;244549;227506;74.6;69.4
41;2021-09-04;194;592;244743;228098;74.7;69.6
41;2021-09-05;3;1;244746;228099;74.7;69.6
41;2021-09-06;291;1094;245037;229193;74.7;69.9
41;2021-09-07;415;1355;245452;230548;74.9;70.3
41;2021-09-08;314;1276;245766;231824;75.0;70.7
41;2021-09-09;295;1297;246061;233121;75.1;71.1
41;2021-09-10;381;1373;246442;234494;75.2;71.5
41;2021-09-11;85;392;246527;234886;75.2;71.6
41;2021-09-12;0;9;246527;234895;75.2;71.7
41;2021-09-13;200;912;246727;235807;75.3;71.9
41;2021-09-14;364;1056;247091;236863;75.4;72.3
41;2021-09-15;279;1070;247370;237933;75.5;72.6
41;2021-09-16;236;833;247606;238766;75.5;72.8
41;2021-09-17;360;713;247966;239479;75.6;73.0
41;2021-09-18;78;169;248044;239648;75.7;73.1
41;2021-09-19;0;7;248044;239655;75.7;73.1
41;2021-09-20;176;513;248220;240168;75.7;73.3
41;2021-09-21;181;515;248401;240683;75.8;73.4
41;2021-09-22;268;801;248669;241484;75.9;73.7
41;2021-09-23;237;662;248906;242146;75.9;73.9
41;2021-09-24;313;630;249219;242776;76.0;74.1
41;2021-09-25;70;233;249289;243009;76.0;74.1
41;2021-09-26;0;3;249289;243012;76.0;74.1
41;2021-09-27;165;342;249454;243354;76.1;74.2
41;2021-09-28;156;421;249610;243775;76.1;74.4
41;2021-09-29;178;489;249788;244264;76.2;74.5
41;2021-09-30;100;337;249888;244601;76.2;74.6
41;2021-10-01;210;390;250098;244991;76.3;74.7
41;2021-10-02;80;140;250178;245131;76.3;74.8
41;2021-10-03;0;0;250178;245131;76.3;74.8
42;2020-12-27;1;0;1;0;0.0;0.0
42;2020-12-28;0;0;1;0;0.0;0.0
42;2020-12-29;0;0;1;0;0.0;0.0
42;2020-12-30;0;0;1;0;0.0;0.0
42;2020-12-31;0;0;1;0;0.0;0.0
42;2021-01-01;0;0;1;0;0.0;0.0
42;2021-01-02;0;0;1;0;0.0;0.0
42;2021-01-03;0;0;1;0;0.0;0.0
42;2021-01-04;1;0;2;0;0.0;0.0
42;2021-01-05;1;0;3;0;0.0;0.0
42;2021-01-06;178;1;181;1;0.0;0.0
42;2021-01-07;256;0;437;1;0.1;0.0
42;2021-01-08;264;1;701;2;0.1;0.0
42;2021-01-09;136;0;837;2;0.1;0.0
42;2021-01-10;0;0;837;2;0.1;0.0
42;2021-01-11;293;2;1130;4;0.1;0.0
42;2021-01-12;412;1;1542;5;0.2;0.0
42;2021-01-13;526;2;2068;7;0.3;0.0
42;2021-01-14;775;2;2843;9;0.4;0.0
42;2021-01-15;707;4;3550;13;0.5;0.0
42;2021-01-16;298;2;3848;15;0.5;0.0
42;2021-01-17;219;0;4067;15;0.5;0.0
42;2021-01-18;967;1;5034;16;0.7;0.0
42;2021-01-19;1329;8;6363;24;0.8;0.0
42;2021-01-20;956;3;7319;27;1.0;0.0
42;2021-01-21;1023;6;8342;33;1.1;0.0
42;2021-01-22;991;6;9333;39;1.2;0.0
42;2021-01-23;401;0;9734;39;1.3;0.0
42;2021-01-24;358;0;10092;39;1.3;0.0
42;2021-01-25;1099;12;11191;51;1.5;0.0
42;2021-01-26;1750;18;12941;69;1.7;0.0
42;2021-01-27;1456;118;14397;187;1.9;0.0
42;2021-01-28;1667;133;16064;320;2.1;0.0
42;2021-01-29;946;109;17010;429;2.2;0.1
42;2021-01-30;257;96;17267;525;2.3;0.1
42;2021-01-31;258;2;17525;527;2.3;0.1
42;2021-02-01;738;58;18263;585;2.4;0.1
42;2021-02-02;1854;265;20117;850;2.6;0.1
42;2021-02-03;1517;456;21634;1306;2.8;0.2
42;2021-02-04;1279;556;22913;1862;3.0;0.2
42;2021-02-05;684;482;23597;2344;3.1;0.3
42;2021-02-06;304;128;23901;2472;3.1;0.3
42;2021-02-07;276;134;24177;2606;3.2;0.3
42;2021-02-08;507;492;24684;3098;3.2;0.4
42;2021-02-09;703;629;25387;3727;3.3;0.5
42;2021-02-10;742;553;26129;4280;3.4;0.6
42;2021-02-11;772;553;26901;4833;3.5;0.6
42;2021-02-12;675;602;27576;5435;3.6;0.7
42;2021-02-13;428;242;28004;5677;3.7;0.7
42;2021-02-14;186;172;28190;5849;3.7;0.8
42;2021-02-15;520;623;28710;6472;3.8;0.8
42;2021-02-16;490;996;29200;7468;3.8;1.0
42;2021-02-17;518;1334;29718;8802;3.9;1.2
42;2021-02-18;756;1164;30474;9966;4.0;1.3
42;2021-02-19;768;847;31242;10813;4.1;1.4
42;2021-02-20;248;332;31490;11145;4.1;1.5
42;2021-02-21;63;254;31553;11399;4.1;1.5
42;2021-02-22;574;804;32127;12203;4.2;1.6
42;2021-02-23;1211;1301;33338;13504;4.4;1.8
42;2021-02-24;1244;1036;34582;14540;4.5;1.9
42;2021-02-25;1667;1306;36249;15846;4.7;2.1
42;2021-02-26;1646;824;37895;16670;5.0;2.2
42;2021-02-27;580;243;38475;16913;5.0;2.2
42;2021-02-28;167;98;38642;17011;5.1;2.2
42;2021-03-01;807;753;39449;17764;5.2;2.3
42;2021-03-02;1275;724;40724;18488;5.3;2.4
42;2021-03-03;1368;715;42092;19203;5.5;2.5
42;2021-03-04;1705;648;43797;19851;5.7;2.6
42;2021-03-05;2623;619;46420;20470;6.1;2.7
42;2021-03-06;1933;245;48353;20715;6.3;2.7
42;2021-03-07;1491;94;49844;20809;6.5;2.7
42;2021-03-08;1405;487;51249;21296;6.7;2.8
42;2021-03-09;1983;434;53232;21730;7.0;2.8
42;2021-03-10;2053;491;55285;22221;7.2;2.9
42;2021-03-11;3048;606;58333;22827;7.6;3.0
42;2021-03-12;3008;810;61341;23637;8.0;3.1
42;2021-03-13;1479;352;62820;23989;8.2;3.1
42;2021-03-14;472;161;63292;24150;8.3;3.2
42;2021-03-15;1572;589;64864;24739;8.5;3.2
42;2021-03-16;1472;757;66336;25496;8.7;3.3
42;2021-03-17;1723;1070;68059;26566;8.9;3.5
42;2021-03-18;1804;1024;69863;27590;9.1;3.6
42;2021-03-19;2565;676;72428;28266;9.5;3.7
42;2021-03-20;1672;233;74100;28499;9.7;3.7
42;2021-03-21;526;99;74626;28598;9.8;3.7
42;2021-03-22;1426;730;76052;29328;9.9;3.8
42;2021-03-23;2507;856;78559;30184;10.3;3.9
42;2021-03-24;2783;785;81342;30969;10.6;4.0
42;2021-03-25;3720;934;85062;31903;11.1;4.2
42;2021-03-26;3759;783;88821;32686;11.6;4.3
42;2021-03-27;1806;452;90627;33138;11.9;4.3
42;2021-03-28;1039;216;91666;33354;12.0;4.4
42;2021-03-29;2063;922;93729;34276;12.3;4.5
42;2021-03-30;3146;865;96875;35141;12.7;4.6
42;2021-03-31;2444;1073;99319;36214;13.0;4.7
42;2021-04-01;3391;1054;102710;37268;13.4;4.9
42;2021-04-02;2849;1230;105559;38498;13.8;5.0
42;2021-04-03;1418;609;106977;39107;14.0;5.1
42;2021-04-04;1403;393;108380;39500;14.2;5.2
42;2021-04-05;1901;298;110281;39798;14.4;5.2
42;2021-04-06;2292;1408;112573;41206;14.7;5.4
42;2021-04-07;2761;1832;115334;43038;15.1;5.6
42;2021-04-08;4025;1588;119359;44626;15.6;5.8
42;2021-04-09;5134;1562;124493;46188;16.3;6.0
42;2021-04-10;2591;768;127084;46956;16.6;6.1
42;2021-04-11;1957;432;129041;47388;16.9;6.2
42;2021-04-12;3699;1549;132740;48937;17.4;6.4
42;2021-04-13;4659;1808;137399;50745;18.0;6.6
42;2021-04-14;4309;1903;141708;52648;18.5;6.9
42;2021-04-15;4809;1838;146517;54486;19.2;7.1
42;2021-04-16;4620;1890;151137;56376;19.8;7.4
42;2021-04-17;2982;1071;154119;57447;20.2;7.5
42;2021-04-18;1887;413;156006;57860;20.4;7.6
42;2021-04-19;3090;1537;159096;59397;20.8;7.8
42;2021-04-20;3468;1956;162564;61353;21.3;8.0
42;2021-04-21;3479;1749;166043;63102;21.7;8.3
42;2021-04-22;3768;1953;169811;65055;22.2;8.5
42;2021-04-23;3842;2017;173653;67072;22.7;8.8
42;2021-04-24;2363;1518;176016;68590;23.0;9.0
42;2021-04-25;1658;944;177674;69534;23.2;9.1
42;2021-04-26;3280;1734;180954;71268;23.7;9.3
42;2021-04-27;3253;2208;184207;73476;24.1;9.6
42;2021-04-28;3463;2619;187670;76095;24.5;10.0
42;2021-04-29;3767;2801;191437;78896;25.0;10.3
42;2021-04-30;3359;3023;194796;81919;25.5;10.7
42;2021-05-01;2968;1053;197764;82972;25.9;10.8
42;2021-05-02;1934;1261;199698;84233;26.1;11.0
42;2021-05-03;2868;2768;202566;87001;26.5;11.4
42;2021-05-04;3416;3127;205982;90128;26.9;11.8
42;2021-05-05;3328;3398;209310;93526;27.4;12.2
42;2021-05-06;3888;3771;213198;97297;27.9;12.7
42;2021-05-07;3732;4039;216930;101336;28.4;13.3
42;2021-05-08;3164;1070;220094;102406;28.8;13.4
42;2021-05-09;1505;2213;221599;104619;29.0;13.7
42;2021-05-10;3250;3828;224849;108447;29.4;14.2
42;2021-05-11;5574;3899;230423;112346;30.1;14.7
42;2021-05-12;5339;3568;235762;115914;30.8;15.2
42;2021-05-13;5451;1150;241213;117064;31.5;15.3
42;2021-05-14;5237;2927;246450;119991;32.2;15.7
42;2021-05-15;4880;2127;251330;122118;32.9;16.0
42;2021-05-16;2873;1036;254203;123154;33.2;16.1
42;2021-05-17;5885;2840;260088;125994;34.0;16.5
42;2021-05-18;6251;2979;266339;128973;34.8;16.9
42;2021-05-19;6523;2750;272862;131723;35.7;17.2
42;2021-05-20;7103;2893;279965;134616;36.6;17.6
42;2021-05-21;6351;3275;286316;137891;37.4;18.0
42;2021-05-22;5834;2134;292150;140025;38.2;18.3
42;2021-05-23;2832;874;294982;140899;38.6;18.4
42;2021-05-24;5246;1433;300228;142332;39.3;18.6
42;2021-05-25;5152;3940;305380;146272;39.9;19.1
42;2021-05-26;5160;3459;310540;149731;40.6;19.6
42;2021-05-27;5366;3630;315906;153361;41.3;20.1
42;2021-05-28;5043;4189;320949;157550;42.0;20.6
42;2021-05-29;4340;2984;325289;160534;42.5;21.0
42;2021-05-30;1981;1205;327270;161739;42.8;21.1
42;2021-05-31;4241;3419;331511;165158;43.3;21.6
42;2021-06-01;4592;3562;336103;168720;44.0;22.1
42;2021-06-02;4481;3006;340584;171726;44.5;22.5
42;2021-06-03;4930;3839;345514;175565;45.2;23.0
42;2021-06-04;4766;4213;350280;179778;45.8;23.5
42;2021-06-05;3689;2424;353969;182202;46.3;23.8
42;2021-06-06;1445;1293;355414;183495;46.5;24.0
42;2021-06-07;3992;3377;359406;186872;47.0;24.4
42;2021-06-08;3466;3242;362872;190114;47.5;24.9
42;2021-06-09;2964;3206;365836;193320;47.8;25.3
42;2021-06-10;3242;2931;369078;196251;48.3;25.7
42;2021-06-11;3585;4114;372663;200365;48.7;26.2
42;2021-06-12;2863;2881;375526;203246;49.1;26.6
42;2021-06-13;944;1278;376470;204524;49.2;26.7
42;2021-06-14;2313;4061;378783;208585;49.5;27.3
42;2021-06-15;2830;4071;381613;212656;49.9;27.8
42;2021-06-16;2920;3551;384533;216207;50.3;28.3
42;2021-06-17;2635;3734;387168;219941;50.6;28.8
42;2021-06-18;3093;5143;390261;225084;51.0;29.4
42;2021-06-19;2845;4243;393106;229327;51.4;30.0
42;2021-06-20;857;1844;393963;231171;51.5;30.2
42;2021-06-21;1908;6277;395871;237448;51.8;31.0
42;2021-06-22;1875;5891;397746;243339;52.0;31.8
42;2021-06-23;1845;5321;399591;248660;52.3;32.5
42;2021-06-24;1785;4682;401376;253342;52.5;33.1
42;2021-06-25;2037;6951;403413;260293;52.8;34.0
42;2021-06-26;1408;5818;404821;266111;52.9;34.8
42;2021-06-27;756;2858;405577;268969;53.0;35.2
42;2021-06-28;1746;7063;407323;276032;53.3;36.1
42;2021-06-29;1526;6566;408849;282598;53.5;37.0
42;2021-06-30;1969;5765;410818;288363;53.7;37.7
42;2021-07-01;1779;5119;412597;293482;54.0;38.4
42;2021-07-02;2046;6739;414643;300221;54.2;39.3
42;2021-07-03;1760;5978;416403;306199;54.5;40.0
42;2021-07-04;853;2514;417256;308713;54.6;40.4
42;2021-07-05;1716;6286;418972;314999;54.8;41.2
42;2021-07-06;2106;5576;421078;320575;55.1;41.9
42;2021-07-07;2338;4657;423416;325232;55.4;42.5
42;2021-07-08;2272;3956;425688;329188;55.7;43.0
42;2021-07-09;2416;6096;428104;335284;56.0;43.8
42;2021-07-10;1693;5581;429797;340865;56.2;44.6
42;2021-07-11;921;2304;430718;343169;56.3;44.9
42;2021-07-12;1776;6287;432494;349456;56.6;45.7
42;2021-07-13;3610;6290;436104;355746;57.0;46.5
42;2021-07-14;4479;2053;440583;357799;57.6;46.8
42;2021-07-15;4558;5626;445141;363425;58.2;47.5
42;2021-07-16;4442;6197;449583;369622;58.8;48.3
42;2021-07-17;3219;4709;452802;374331;59.2;48.9
42;2021-07-18;1838;1743;454640;376074;59.5;49.2
42;2021-07-19;3806;5073;458446;381147;59.9;49.8
42;2021-07-20;4719;4821;463165;385968;60.6;50.5
42;2021-07-21;5176;4718;468341;390686;61.2;51.1
42;2021-07-22;5501;3935;473842;394621;62.0;51.6
42;2021-07-23;5500;5120;479342;399741;62.7;52.3
42;2021-07-24;4037;3833;483379;403574;63.2;52.8
42;2021-07-25;1656;1389;485035;404963;63.4;53.0
42;2021-07-26;4731;4312;489766;409275;64.0;53.5
42;2021-07-27;5333;3955;495099;413230;64.7;54.0
42;2021-07-28;5782;3676;500881;416906;65.5;54.5
42;2021-07-29;5678;3432;506559;420338;66.2;55.0
42;2021-07-30;5140;3776;511699;424114;66.9;55.5
42;2021-07-31;4764;3057;516463;427171;67.5;55.9
42;2021-08-01;2498;1317;518961;428488;67.9;56.0
42;2021-08-02;4366;3106;523327;431594;68.4;56.4
42;2021-08-03;3826;3284;527153;434878;68.9;56.9
42;2021-08-04;3473;3222;530626;438100;69.4;57.3
42;2021-08-05;3402;3313;534028;441413;69.8;57.7
42;2021-08-06;3639;3994;537667;445407;70.3;58.2
42;2021-08-07;3022;3067;540689;448474;70.7;58.6
42;2021-08-08;1200;1717;541889;450191;70.9;58.9
42;2021-08-09;2809;3860;544698;454051;71.2;59.4
42;2021-08-10;3275;3909;547973;457960;71.7;59.9
42;2021-08-11;2593;3521;550566;461481;72.0;60.3
42;2021-08-12;2517;3569;553083;465050;72.3;60.8
42;2021-08-13;2334;3908;555417;468958;72.6;61.3
42;2021-08-14;1652;3269;557069;472227;72.8;61.8
42;2021-08-15;600;1027;557669;473254;72.9;61.9
42;2021-08-16;2077;4572;559746;477826;73.2;62.5
42;2021-08-17;2245;4174;561991;482000;73.5;63.0
42;2021-08-18;2053;4145;564044;486145;73.8;63.6
42;2021-08-19;1932;3369;565976;489514;74.0;64.0
42;2021-08-20;2271;4611;568247;494125;74.3;64.6
42;2021-08-21;1083;3865;569330;497990;74.4;65.1
42;2021-08-22;501;2020;569831;500010;74.5;65.4
42;2021-08-23;1625;4667;571456;504677;74.7;66.0
42;2021-08-24;1748;4043;573204;508720;75.0;66.5
42;2021-08-25;1748;3898;574952;512618;75.2;67.0
42;2021-08-26;1445;3048;576397;515666;75.4;67.4
42;2021-08-27;1775;4563;578172;520229;75.6;68.0
42;2021-08-28;1311;3707;579483;523936;75.8;68.5
42;2021-08-29;377;1428;579860;525364;75.8;68.7
42;2021-08-30;1284;3434;581144;528798;76.0;69.1
42;2021-08-31;1238;2860;582382;531658;76.2;69.5
42;2021-09-01;1251;3017;583633;534675;76.3;69.9
42;2021-09-02;1321;2934;584954;537609;76.5;70.3
42;2021-09-03;1567;3302;586521;540911;76.7;70.7
42;2021-09-04;1045;2984;587566;543895;76.8;71.1
42;2021-09-05;381;874;587947;544769;76.9;71.2
42;2021-09-06;763;2167;588710;546936;77.0;71.5
42;2021-09-07;823;1933;589533;548869;77.1;71.8
42;2021-09-08;917;2229;590450;551098;77.2;72.1
42;2021-09-09;656;1779;591106;552877;77.3;72.3
42;2021-09-10;925;2279;592031;555156;77.4;72.6
42;2021-09-11;723;2400;592754;557556;77.5;72.9
42;2021-09-12;163;553;592917;558109;77.5;73.0
42;2021-09-13;546;1620;593463;559729;77.6;73.2
42;2021-09-14;776;1978;594239;561707;77.7;73.5
42;2021-09-15;702;1567;594941;563274;77.8;73.7
42;2021-09-16;525;823;595466;564097;77.9;73.8
42;2021-09-17;732;1636;596198;565733;78.0;74.0
42;2021-09-18;575;1799;596773;567532;78.0;74.2
42;2021-09-19;99;366;596872;567898;78.0;74.3
42;2021-09-20;395;849;597267;568747;78.1;74.4
42;2021-09-21;340;738;597607;569485;78.1;74.5
42;2021-09-22;473;1382;598080;570867;78.2;74.6
42;2021-09-23;371;907;598451;571774;78.3;74.8
42;2021-09-24;470;1562;598921;573336;78.3;75.0
42;2021-09-25;386;1274;599307;574610;78.4;75.1
42;2021-09-26;61;289;599368;574899;78.4;75.2
42;2021-09-27;332;792;599700;575691;78.4;75.3
42;2021-09-28;340;704;600040;576395;78.5;75.4
42;2021-09-29;405;955;600445;577350;78.5;75.5
42;2021-09-30;357;687;600802;578037;78.6;75.6
42;2021-10-01;484;1014;601286;579051;78.6;75.7
42;2021-10-02;378;780;601664;579831;78.7;75.8
42;2021-10-03;89;176;601753;580007;78.7;75.8
43;2020-12-27;0;0;0;0;0.0;0.0
43;2020-12-28;0;0;0;0;0.0;0.0
43;2020-12-29;0;0;0;0;0.0;0.0
43;2020-12-30;0;0;0;0;0.0;0.0
43;2020-12-31;0;0;0;0;0.0;0.0
43;2021-01-01;0;0;0;0;0.0;0.0
43;2021-01-02;0;0;0;0;0.0;0.0
43;2021-01-03;0;0;0;0;0.0;0.0
43;2021-01-04;2;0;2;0;0.0;0.0
43;2021-01-05;0;0;2;0;0.0;0.0
43;2021-01-06;0;0;2;0;0.0;0.0
43;2021-01-07;167;0;169;0;0.1;0.0
43;2021-01-08;151;1;320;1;0.1;0.0
43;2021-01-09;0;0;320;1;0.1;0.0
43;2021-01-10;0;0;320;1;0.1;0.0
43;2021-01-11;137;0;457;1;0.2;0.0
43;2021-01-12;244;0;701;1;0.3;0.0
43;2021-01-13;244;2;945;3;0.4;0.0
43;2021-01-14;294;2;1239;5;0.5;0.0
43;2021-01-15;303;2;1542;7;0.7;0.0
43;2021-01-16;32;0;1574;7;0.7;0.0
43;2021-01-17;0;0;1574;7;0.7;0.0
43;2021-01-18;761;5;2335;12;1.0;0.0
43;2021-01-19;776;5;3111;17;1.4;0.0
43;2021-01-20;519;2;3630;19;1.6;0.0
43;2021-01-21;447;2;4077;21;1.8;0.0
43;2021-01-22;465;6;4542;27;2.0;0.0
43;2021-01-23;1;0;4543;27;2.0;0.0
43;2021-01-24;2;0;4545;27;2.0;0.0
43;2021-01-25;539;0;5084;27;2.2;0.0
43;2021-01-26;615;5;5699;32;2.5;0.0
43;2021-01-27;740;0;6439;32;2.8;0.0
43;2021-01-28;747;30;7186;62;3.2;0.0
43;2021-01-29;722;81;7908;143;3.5;0.1
43;2021-01-30;109;0;8017;143;3.5;0.1
43;2021-01-31;0;0;8017;143;3.5;0.1
43;2021-02-01;403;99;8420;242;3.7;0.1
43;2021-02-02;717;145;9137;387;4.0;0.2
43;2021-02-03;690;41;9827;428;4.3;0.2
43;2021-02-04;525;157;10352;585;4.6;0.3
43;2021-02-05;544;147;10896;732;4.8;0.3
43;2021-02-06;165;16;11061;748;4.9;0.3
43;2021-02-07;0;0;11061;748;4.9;0.3
43;2021-02-08;411;282;11472;1030;5.1;0.5
43;2021-02-09;368;414;11840;1444;5.2;0.6
43;2021-02-10;401;348;12241;1792;5.4;0.8
43;2021-02-11;388;312;12629;2104;5.6;0.9
43;2021-02-12;425;187;13054;2291;5.8;1.0
43;2021-02-13;570;41;13624;2332;6.0;1.0
43;2021-02-14;0;0;13624;2332;6.0;1.0
43;2021-02-15;69;385;13693;2717;6.0;1.2
43;2021-02-16;41;319;13734;3036;6.1;1.3
43;2021-02-17;87;426;13821;3462;6.1;1.5
43;2021-02-18;147;324;13968;3786;6.2;1.7
43;2021-02-19;278;459;14246;4245;6.3;1.9
43;2021-02-20;22;4;14268;4249;6.3;1.9
43;2021-02-21;0;0;14268;4249;6.3;1.9
43;2021-02-22;16;424;14284;4673;6.3;2.1
43;2021-02-23;202;709;14486;5382;6.4;2.4
43;2021-02-24;147;679;14633;6061;6.4;2.7
43;2021-02-25;228;618;14861;6679;6.5;2.9
43;2021-02-26;222;576;15083;7255;6.6;3.2
43;2021-02-27;139;60;15222;7315;6.7;3.2
43;2021-02-28;1;0;15223;7315;6.7;3.2
43;2021-03-01;210;438;15433;7753;6.8;3.4
43;2021-03-02;342;540;15775;8293;7.0;3.7
43;2021-03-03;338;548;16113;8841;7.1;3.9
43;2021-03-04;551;435;16664;9276;7.3;4.1
43;2021-03-05;566;426;17230;9702;7.6;4.3
43;2021-03-06;489;175;17719;9877;7.8;4.4
43;2021-03-07;12;0;17731;9877;7.8;4.4
43;2021-03-08;447;413;18178;10290;8.0;4.5
43;2021-03-09;621;350;18799;10640;8.3;4.7
43;2021-03-10;674;476;19473;11116;8.6;4.9
43;2021-03-11;953;428;20426;11544;9.0;5.1
43;2021-03-12;945;414;21371;11958;9.4;5.3
43;2021-03-13;792;108;22163;12066;9.8;5.3
43;2021-03-14;2;0;22165;12066;9.8;5.3
43;2021-03-15;706;143;22871;12209;10.1;5.4
43;2021-03-16;847;283;23718;12492;10.5;5.5
43;2021-03-17;638;138;24356;12630;10.7;5.6
43;2021-03-18;676;140;25032;12770;11.0;5.6
43;2021-03-19;839;91;25871;12861;11.4;5.7
43;2021-03-20;450;60;26321;12921;11.6;5.7
43;2021-03-21;0;0;26321;12921;11.6;5.7
43;2021-03-22;742;39;27063;12960;11.9;5.7
43;2021-03-23;872;49;27935;13009;12.3;5.7
43;2021-03-24;1174;96;29109;13105;12.8;5.8
43;2021-03-25;1594;160;30703;13265;13.5;5.8
43;2021-03-26;1609;192;32312;13457;14.2;5.9
43;2021-03-27;1449;79;33761;13536;14.9;6.0
43;2021-03-28;420;20;34181;13556;15.1;6.0
43;2021-03-29;1096;171;35277;13727;15.5;6.0
43;2021-03-30;1314;235;36591;13962;16.1;6.2
43;2021-03-31;1306;266;37897;14228;16.7;6.3
43;2021-04-01;1348;340;39245;14568;17.3;6.4
43;2021-04-02;1052;352;40297;14920;17.8;6.6
43;2021-04-03;340;198;40637;15118;17.9;6.7
43;2021-04-04;0;0;40637;15118;17.9;6.7
43;2021-04-05;3;0;40640;15118;17.9;6.7
43;2021-04-06;688;607;41328;15725;18.2;6.9
43;2021-04-07;868;575;42196;16300;18.6;7.2
43;2021-04-08;1086;463;43282;16763;19.1;7.4
43;2021-04-09;1147;663;44429;17426;19.6;7.7
43;2021-04-10;626;264;45055;17690;19.9;7.8
43;2021-04-11;0;0;45055;17690;19.9;7.8
43;2021-04-12;681;649;45736;18339;20.2;8.1
43;2021-04-13;917;726;46653;19065;20.6;8.4
43;2021-04-14;723;669;47376;19734;20.9;8.7
43;2021-04-15;959;701;48335;20435;21.3;9.0
43;2021-04-16;1008;694;49343;21129;21.7;9.3
43;2021-04-17;423;301;49766;21430;21.9;9.4
43;2021-04-18;3;5;49769;21435;21.9;9.4
43;2021-04-19;628;567;50397;22002;22.2;9.7
43;2021-04-20;839;675;51236;22677;22.6;10.0
43;2021-04-21;320;987;51556;23664;22.7;10.4
43;2021-04-22;680;1016;52236;24680;23.0;10.9
43;2021-04-23;401;1102;52637;25782;23.2;11.4
43;2021-04-24;347;1039;52984;26821;23.4;11.8
43;2021-04-25;23;403;53007;27224;23.4;12.0
43;2021-04-26;385;964;53392;28188;23.5;12.4
43;2021-04-27;825;984;54217;29172;23.9;12.9
43;2021-04-28;794;1108;55011;30280;24.2;13.3
43;2021-04-29;1236;1139;56247;31419;24.8;13.8
43;2021-04-30;1199;1067;57446;32486;25.3;14.3
43;2021-05-01;400;27;57846;32513;25.5;14.3
43;2021-05-02;1;0;57847;32513;25.5;14.3
43;2021-05-03;1218;408;59065;32921;26.0;14.5
43;2021-05-04;1237;956;60302;33877;26.6;14.9
43;2021-05-05;1143;848;61445;34725;27.1;15.3
43;2021-05-06;1405;938;62850;35663;27.7;15.7
43;2021-05-07;1089;1172;63939;36835;28.2;16.2
43;2021-05-08;521;136;64460;36971;28.4;16.3
43;2021-05-09;0;2;64460;36973;28.4;16.3
43;2021-05-10;1084;725;65544;37698;28.9;16.6
43;2021-05-11;1553;1010;67097;38708;29.6;17.1
43;2021-05-12;1482;809;68579;39517;30.2;17.4
43;2021-05-13;936;378;69515;39895;30.6;17.6
43;2021-05-14;2204;1110;71719;41005;31.6;18.1
43;2021-05-15;1271;315;72990;41320;32.2;18.2
43;2021-05-16;272;47;73262;41367;32.3;18.2
43;2021-05-17;1625;631;74887;41998;33.0;18.5
43;2021-05-18;1966;675;76853;42673;33.9;18.8
43;2021-05-19;2065;571;78918;43244;34.8;19.1
43;2021-05-20;2338;805;81256;44049;35.8;19.4
43;2021-05-21;2385;709;83641;44758;36.9;19.7
43;2021-05-22;1207;341;84848;45099;37.4;19.9
43;2021-05-23;1;0;84849;45099;37.4;19.9
43;2021-05-24;382;99;85231;45198;37.6;19.9
43;2021-05-25;1407;654;86638;45852;38.2;20.2
43;2021-05-26;1347;559;87985;46411;38.8;20.5
43;2021-05-27;1388;713;89373;47124;39.4;20.8
43;2021-05-28;1348;727;90721;47851;40.0;21.1
43;2021-05-29;1135;604;91856;48455;40.5;21.4
43;2021-05-30;149;17;92005;48472;40.5;21.4
43;2021-05-31;1207;442;93212;48914;41.1;21.6
43;2021-06-01;1280;985;94492;49899;41.6;22.0
43;2021-06-02;1086;700;95578;50599;42.1;22.3
43;2021-06-03;1192;856;96770;51455;42.6;22.7
43;2021-06-04;1351;859;98121;52314;43.2;23.1
43;2021-06-05;823;452;98944;52766;43.6;23.3
43;2021-06-06;10;5;98954;52771;43.6;23.3
43;2021-06-07;748;516;99702;53287;43.9;23.5
43;2021-06-08;664;706;100366;53993;44.2;23.8
43;2021-06-09;538;760;100904;54753;44.5;24.1
43;2021-06-10;807;1120;101711;55873;44.8;24.6
43;2021-06-11;761;1348;102472;57221;45.2;25.2
43;2021-06-12;914;514;103386;57735;45.6;25.4
43;2021-06-13;3;27;103389;57762;45.6;25.5
43;2021-06-14;446;1087;103835;58849;45.8;25.9
43;2021-06-15;629;1191;104464;60040;46.0;26.5
43;2021-06-16;549;974;105013;61014;46.3;26.9
43;2021-06-17;601;1500;105614;62514;46.5;27.6
43;2021-06-18;898;1464;106512;63978;46.9;28.2
43;2021-06-19;447;781;106959;64759;47.1;28.5
43;2021-06-20;0;12;106959;64771;47.1;28.5
43;2021-06-21;424;1306;107383;66077;47.3;29.1
43;2021-06-22;533;1958;107916;68035;47.6;30.0
43;2021-06-23;342;1743;108258;69778;47.7;30.8
43;2021-06-24;511;1492;108769;71270;47.9;31.4
43;2021-06-25;597;2345;109366;73615;48.2;32.4
43;2021-06-26;505;1245;109871;74860;48.4;33.0
43;2021-06-27;10;20;109881;74880;48.4;33.0
43;2021-06-28;341;1785;110222;76665;48.6;33.8
43;2021-06-29;525;2381;110747;79046;48.8;34.8
43;2021-06-30;460;2276;111207;81322;49.0;35.8
43;2021-07-01;473;1910;111680;83232;49.2;36.7
43;2021-07-02;500;1964;112180;85196;49.4;37.5
43;2021-07-03;258;1108;112438;86304;49.6;38.0
43;2021-07-04;1;0;112439;86304;49.6;38.0
43;2021-07-05;526;1202;112965;87506;49.8;38.6
43;2021-07-06;633;1680;113598;89186;50.1;39.3
43;2021-07-07;524;1423;114122;90609;50.3;39.9
43;2021-07-08;837;1417;114959;92026;50.7;40.6
43;2021-07-09;549;1500;115508;93526;50.9;41.2
43;2021-07-10;401;1337;115909;94863;51.1;41.8
43;2021-07-11;23;99;115932;94962;51.1;41.9
43;2021-07-12;604;1684;116536;96646;51.4;42.6
43;2021-07-13;1186;1849;117722;98495;51.9;43.4
43;2021-07-14;848;161;118570;98656;52.3;43.5
43;2021-07-15;1933;1840;120503;100496;53.1;44.3
43;2021-07-16;1752;1616;122255;102112;53.9;45.0
43;2021-07-17;1544;1202;123799;103314;54.6;45.5
43;2021-07-18;4;19;123803;103333;54.6;45.5
43;2021-07-19;1441;1257;125244;104590;55.2;46.1
43;2021-07-20;1895;1451;127139;106041;56.0;46.7
43;2021-07-21;1854;1112;128993;107153;56.8;47.2
43;2021-07-22;2110;1333;131103;108486;57.8;47.8
43;2021-07-23;1619;1325;132722;109811;58.5;48.4
43;2021-07-24;576;1000;133298;110811;58.7;48.8
43;2021-07-25;0;1;133298;110812;58.7;48.8
43;2021-07-26;1643;1071;134941;111883;59.5;49.3
43;2021-07-27;2284;1228;137225;113111;60.5;49.9
43;2021-07-28;1954;1093;139179;114204;61.3;50.3
43;2021-07-29;1986;1016;141165;115220;62.2;50.8
43;2021-07-30;1867;1336;143032;116556;63.0;51.4
43;2021-07-31;706;611;143738;117167;63.3;51.6
43;2021-08-01;13;21;143751;117188;63.4;51.6
43;2021-08-02;1535;968;145286;118156;64.0;52.1
43;2021-08-03;1405;1170;146691;119326;64.6;52.6
43;2021-08-04;1263;1108;147954;120434;65.2;53.1
43;2021-08-05;1254;1285;149208;121719;65.8;53.6
43;2021-08-06;1129;1465;150337;123184;66.3;54.3
43;2021-08-07;758;759;151095;123943;66.6;54.6
43;2021-08-08;5;0;151100;123943;66.6;54.6
43;2021-08-09;822;1636;151922;125579;67.0;55.3
43;2021-08-10;1023;1584;152945;127163;67.4;56.0
43;2021-08-11;680;1340;153625;128503;67.7;56.6
43;2021-08-12;875;1605;154500;130108;68.1;57.3
43;2021-08-13;681;1179;155181;131287;68.4;57.9
43;2021-08-14;364;556;155545;131843;68.6;58.1
43;2021-08-15;5;9;155550;131852;68.6;58.1
43;2021-08-16;686;1675;156236;133527;68.9;58.8
43;2021-08-17;712;1511;156948;135038;69.2;59.5
43;2021-08-18;558;1513;157506;136551;69.4;60.2
43;2021-08-19;641;1611;158147;138162;69.7;60.9
43;2021-08-20;518;1595;158665;139757;69.9;61.6
43;2021-08-21;239;555;158904;140312;70.0;61.8
43;2021-08-22;7;7;158911;140319;70.0;61.8
43;2021-08-23;500;1588;159411;141907;70.3;62.5
43;2021-08-24;518;1398;159929;143305;70.5;63.2
43;2021-08-25;521;1298;160450;144603;70.7;63.7
43;2021-08-26;475;1138;160925;145741;70.9;64.2
43;2021-08-27;529;1359;161454;147100;71.2;64.8
43;2021-08-28;176;499;161630;147599;71.2;65.0
43;2021-08-29;0;1;161630;147600;71.2;65.1
43;2021-08-30;483;1062;162113;148662;71.4;65.5
43;2021-08-31;382;890;162495;149552;71.6;65.9
43;2021-09-01;307;962;162802;150514;71.8;66.3
43;2021-09-02;307;969;163109;151483;71.9;66.8
43;2021-09-03;503;1017;163612;152500;72.1;67.2
43;2021-09-04;319;569;163931;153069;72.2;67.5
43;2021-09-05;39;24;163970;153093;72.3;67.5
43;2021-09-06;250;762;164220;153855;72.4;67.8
43;2021-09-07;237;715;164457;154570;72.5;68.1
43;2021-09-08;207;803;164664;155373;72.6;68.5
43;2021-09-09;268;810;164932;156183;72.7;68.8
43;2021-09-10;328;709;165260;156892;72.8;69.1
43;2021-09-11;265;456;165525;157348;73.0;69.3
43;2021-09-12;0;4;165525;157352;73.0;69.3
43;2021-09-13;147;517;165672;157869;73.0;69.6
43;2021-09-14;210;634;165882;158503;73.1;69.9
43;2021-09-15;221;497;166103;159000;73.2;70.1
43;2021-09-16;196;354;166299;159354;73.3;70.2
43;2021-09-17;234;530;166533;159884;73.4;70.5
43;2021-09-18;157;346;166690;160230;73.5;70.6
43;2021-09-19;2;4;166692;160234;73.5;70.6
43;2021-09-20;102;306;166794;160540;73.5;70.8
43;2021-09-21;149;321;166943;160861;73.6;70.9
43;2021-09-22;124;393;167067;161254;73.6;71.1
43;2021-09-23;71;292;167138;161546;73.7;71.2
43;2021-09-24;170;487;167308;162033;73.7;71.4
43;2021-09-25;102;295;167410;162328;73.8;71.5
43;2021-09-26;0;0;167410;162328;73.8;71.5
43;2021-09-27;152;340;167562;162668;73.8;71.7
43;2021-09-28;388;218;167950;162886;74.0;71.8
43;2021-09-29;144;301;168094;163187;74.1;71.9
43;2021-09-30;79;181;168173;163368;74.1;72.0
43;2021-10-01;136;321;168309;163689;74.2;72.1
43;2021-10-02;100;244;168409;163933;74.2;72.2
43;2021-10-03;3;7;168412;163940;74.2;72.3
44;2020-12-27;1;0;1;0;0.0;0.0
44;2020-12-28;3;0;4;0;0.0;0.0
44;2020-12-29;1;0;5;0;0.0;0.0
44;2020-12-30;2;0;7;0;0.0;0.0
44;2020-12-31;1;0;8;0;0.0;0.0
44;2021-01-01;2;0;10;0;0.0;0.0
44;2021-01-02;0;0;10;0;0.0;0.0
44;2021-01-03;4;0;14;0;0.0;0.0
44;2021-01-04;0;0;14;0;0.0;0.0
44;2021-01-05;2;0;16;0;0.0;0.0
44;2021-01-06;20;1;36;1;0.0;0.0
44;2021-01-07;187;0;223;1;0.0;0.0
44;2021-01-08;528;0;751;1;0.1;0.0
44;2021-01-09;473;0;1224;1;0.1;0.0
44;2021-01-10;456;1;1680;2;0.1;0.0
44;2021-01-11;800;1;2480;3;0.2;0.0
44;2021-01-12;910;1;3390;4;0.2;0.0
44;2021-01-13;1086;1;4476;5;0.3;0.0
44;2021-01-14;1116;6;5592;11;0.4;0.0
44;2021-01-15;987;1;6579;12;0.5;0.0
44;2021-01-16;336;2;6915;14;0.5;0.0
44;2021-01-17;328;1;7243;15;0.5;0.0
44;2021-01-18;856;3;8099;18;0.6;0.0
44;2021-01-19;2624;6;10723;24;0.7;0.0
44;2021-01-20;2744;4;13467;28;0.9;0.0
44;2021-01-21;4538;8;18005;36;1.3;0.0
44;2021-01-22;2415;7;20420;43;1.4;0.0
44;2021-01-23;767;1;21187;44;1.5;0.0
44;2021-01-24;120;0;21307;44;1.5;0.0
44;2021-01-25;840;0;22147;44;1.5;0.0
44;2021-01-26;2563;16;24710;60;1.7;0.0
44;2021-01-27;2103;55;26813;115;1.9;0.0
44;2021-01-28;3732;187;30545;302;2.1;0.0
44;2021-01-29;2370;440;32915;742;2.3;0.1
44;2021-01-30;628;190;33543;932;2.3;0.1
44;2021-01-31;14;176;33557;1108;2.3;0.1
44;2021-02-01;594;502;34151;1610;2.4;0.1
44;2021-02-02;878;696;35029;2306;2.4;0.2
44;2021-02-03;889;814;35918;3120;2.5;0.2
44;2021-02-04;938;661;36856;3781;2.6;0.3
44;2021-02-05;897;561;37753;4342;2.6;0.3
44;2021-02-06;471;230;38224;4572;2.7;0.3
44;2021-02-07;72;174;38296;4746;2.7;0.3
44;2021-02-08;522;385;38818;5131;2.7;0.4
44;2021-02-09;993;1108;39811;6239;2.8;0.4
44;2021-02-10;1143;1143;40954;7382;2.8;0.5
44;2021-02-11;2291;2941;43245;10323;3.0;0.7
44;2021-02-12;1662;1648;44907;11971;3.1;0.8
44;2021-02-13;433;407;45340;12378;3.2;0.9
44;2021-02-14;10;158;45350;12536;3.2;0.9
44;2021-02-15;505;830;45855;13366;3.2;0.9
44;2021-02-16;1439;2148;47294;15514;3.3;1.1
44;2021-02-17;1106;1855;48400;17369;3.4;1.2
44;2021-02-18;1959;3278;50359;20647;3.5;1.4
44;2021-02-19;1580;2289;51939;22936;3.6;1.6
44;2021-02-20;409;489;52348;23425;3.6;1.6
44;2021-02-21;6;171;52354;23596;3.6;1.6
44;2021-02-22;717;682;53071;24278;3.7;1.7
44;2021-02-23;1246;898;54317;25176;3.8;1.8
44;2021-02-24;1238;896;55555;26072;3.9;1.8
44;2021-02-25;2445;819;58000;26891;4.0;1.9
44;2021-02-26;2291;777;60291;27668;4.2;1.9
44;2021-02-27;975;343;61266;28011;4.3;1.9
44;2021-02-28;7;31;61273;28042;4.3;2.0
44;2021-03-01;988;456;62261;28498;4.3;2.0
44;2021-03-02;1814;874;64075;29372;4.5;2.0
44;2021-03-03;1859;977;65934;30349;4.6;2.1
44;2021-03-04;2882;1391;68816;31740;4.8;2.2
44;2021-03-05;3481;1225;72297;32965;5.0;2.3
44;2021-03-06;2507;408;74804;33373;5.2;2.3
44;2021-03-07;988;87;75792;33460;5.3;2.3
44;2021-03-08;1783;524;77575;33984;5.4;2.4
44;2021-03-09;3352;1002;80927;34986;5.6;2.4
44;2021-03-10;3079;1019;84006;36005;5.8;2.5
44;2021-03-11;4438;1693;88444;37698;6.2;2.6
44;2021-03-12;5892;1278;94336;38976;6.6;2.7
44;2021-03-13;3629;281;97965;39257;6.8;2.7
44;2021-03-14;431;62;98396;39319;6.8;2.7
44;2021-03-15;2687;360;101083;39679;7.0;2.8
44;2021-03-16;2149;619;103232;40298;7.2;2.8
44;2021-03-17;1960;653;105192;40951;7.3;2.8
44;2021-03-18;2169;632;107361;41583;7.5;2.9
44;2021-03-19;3785;362;111146;41945;7.7;2.9
44;2021-03-20;3213;297;114359;42242;8.0;2.9
44;2021-03-21;914;19;115273;42261;8.0;2.9
44;2021-03-22;2462;438;117735;42699;8.2;3.0
44;2021-03-23;3960;700;121695;43399;8.5;3.0
44;2021-03-24;4303;628;125998;44027;8.8;3.1
44;2021-03-25;5636;920;131634;44947;9.2;3.1
44;2021-03-26;6510;752;138144;45699;9.6;3.2
44;2021-03-27;3216;401;141360;46100;9.8;3.2
44;2021-03-28;1244;27;142604;46127;9.9;3.2
44;2021-03-29;3121;785;145725;46912;10.1;3.3
44;2021-03-30;5139;1102;150864;48014;10.5;3.3
44;2021-03-31;4612;1296;155476;49310;10.8;3.4
44;2021-04-01;6140;1007;161616;50317;11.2;3.5
44;2021-04-02;5795;950;167411;51267;11.6;3.6
44;2021-04-03;2435;650;169846;51917;11.8;3.6
44;2021-04-04;667;21;170513;51938;11.9;3.6
44;2021-04-05;692;288;171205;52226;11.9;3.6
44;2021-04-06;4216;1371;175421;53597;12.2;3.7
44;2021-04-07;5075;1648;180496;55245;12.6;3.8
44;2021-04-08;7182;1668;187678;56913;13.1;4.0
44;2021-04-09;10065;1815;197743;58728;13.8;4.1
44;2021-04-10;4563;1454;202306;60182;14.1;4.2
44;2021-04-11;2148;424;204454;60606;14.2;4.2
44;2021-04-12;5464;1588;209918;62194;14.6;4.3
44;2021-04-13;6727;2256;216645;64450;15.1;4.5
44;2021-04-14;5912;2239;222557;66689;15.5;4.6
44;2021-04-15;6709;2207;229266;68896;16.0;4.8
44;2021-04-16;7785;2048;237051;70944;16.5;4.9
44;2021-04-17;4300;1383;241351;72327;16.8;5.0
44;2021-04-18;2253;819;243604;73146;17.0;5.1
44;2021-04-19;5042;1901;248646;75047;17.3;5.2
44;2021-04-20;6281;2643;254927;77690;17.7;5.4
44;2021-04-21;6006;2788;260933;80478;18.2;5.6
44;2021-04-22;6958;2508;267891;82986;18.6;5.8
44;2021-04-23;7335;3184;275226;86170;19.2;6.0
44;2021-04-24;3971;2045;279197;88215;19.4;6.1
44;2021-04-25;2076;1058;281273;89273;19.6;6.2
44;2021-04-26;5648;2750;286921;92023;20.0;6.4
44;2021-04-27;7415;4076;294336;96099;20.5;6.7
44;2021-04-28;7608;3773;301944;99872;21.0;6.9
44;2021-04-29;8964;4268;310908;104140;21.6;7.2
44;2021-04-30;9569;4681;320477;108821;22.3;7.6
44;2021-05-01;2848;919;323325;109740;22.5;7.6
44;2021-05-02;1903;618;325228;110358;22.6;7.7
44;2021-05-03;5547;4060;330775;114418;23.0;8.0
44;2021-05-04;6327;5111;337102;119529;23.5;8.3
44;2021-05-05;6071;4607;343173;124136;23.9;8.6
44;2021-05-06;7255;4871;350428;129007;24.4;9.0
44;2021-05-07;7451;5691;357879;134698;24.9;9.4
44;2021-05-08;2583;1262;360462;135960;25.1;9.5
44;2021-05-09;1801;1810;362263;137770;25.2;9.6
44;2021-05-10;6574;5767;368837;143537;25.7;10.0
44;2021-05-11;7787;6252;376624;149789;26.2;10.4
44;2021-05-12;8195;5705;384819;155494;26.8;10.8
44;2021-05-13;5304;1193;390123;156687;27.1;10.9
44;2021-05-14;7587;3969;397710;160656;27.7;11.2
44;2021-05-15;5008;2233;402718;162889;28.0;11.3
44;2021-05-16;2791;739;405509;163628;28.2;11.4
44;2021-05-17;6744;5137;412253;168765;28.7;11.7
44;2021-05-18;7962;5210;420215;173975;29.2;12.1
44;2021-05-19;8165;4270;428380;178245;29.8;12.4
44;2021-05-20;8367;4646;436747;182891;30.4;12.7
44;2021-05-21;8844;5189;445591;188080;31.0;13.1
44;2021-05-22;5097;2231;450688;190311;31.4;13.2
44;2021-05-23;1759;824;452447;191135;31.5;13.3
44;2021-05-24;4884;1616;457331;192751;31.8;13.4
44;2021-05-25;7740;5543;465071;198294;32.4;13.8
44;2021-05-26;8181;5041;473252;203335;32.9;14.1
44;2021-05-27;9659;5340;482911;208675;33.6;14.5
44;2021-05-28;9182;6890;492093;215565;34.2;15.0
44;2021-05-29;5883;3309;497976;218874;34.7;15.2
44;2021-05-30;1775;705;499751;219579;34.8;15.3
44;2021-05-31;8059;6169;507810;225748;35.3;15.7
44;2021-06-01;9906;6543;517716;232291;36.0;16.2
44;2021-06-02;9533;5681;527249;237972;36.7;16.6
44;2021-06-03;10852;5866;538101;243838;37.4;17.0
44;2021-06-04;9959;8068;548060;251906;38.1;17.5
44;2021-06-05;5780;4330;553840;256236;38.5;17.8
44;2021-06-06;2361;1130;556201;257366;38.7;17.9
44;2021-06-07;9548;6927;565749;264293;39.4;18.4
44;2021-06-08;10908;7501;576657;271794;40.1;18.9
44;2021-06-09;10552;6312;587209;278106;40.9;19.4
44;2021-06-10;11425;6037;598634;284143;41.7;19.8
44;2021-06-11;11959;8630;610593;292773;42.5;20.4
44;2021-06-12;7761;4094;618354;296867;43.0;20.7
44;2021-06-13;2792;1004;621146;297871;43.2;20.7
44;2021-06-14;8760;8412;629906;306283;43.8;21.3
44;2021-06-15;11705;8255;641611;314538;44.6;21.9
44;2021-06-16;10976;7658;652587;322196;45.4;22.4
44;2021-06-17;11725;8683;664312;330879;46.2;23.0
44;2021-06-18;10900;10113;675212;340992;47.0;23.7
44;2021-06-19;5883;4318;681095;345310;47.4;24.0
44;2021-06-20;2534;1338;683629;346648;47.6;24.1
44;2021-06-21;7349;10011;690978;356659;48.1;24.8
44;2021-06-22;8469;10623;699447;367282;48.7;25.6
44;2021-06-23;8554;9138;708001;376420;49.3;26.2
44;2021-06-24;9123;8562;717124;384982;49.9;26.8
44;2021-06-25;7643;10814;724767;395796;50.4;27.5
44;2021-06-26;2958;6464;727725;402260;50.6;28.0
44;2021-06-27;816;2403;728541;404663;50.7;28.2
44;2021-06-28;5229;10054;733770;414717;51.1;28.9
44;2021-06-29;6179;12080;739949;426797;51.5;29.7
44;2021-06-30;6184;10446;746133;437243;51.9;30.4
44;2021-07-01;6929;10475;753062;447718;52.4;31.2
44;2021-07-02;6693;12549;759755;460267;52.9;32.0
44;2021-07-03;2584;7002;762339;467269;53.0;32.5
44;2021-07-04;995;2235;763334;469504;53.1;32.7
44;2021-07-05;5315;11868;768649;481372;53.5;33.5
44;2021-07-06;6058;12598;774707;493970;53.9;34.4
44;2021-07-07;6513;11099;781220;505069;54.4;35.1
44;2021-07-08;7392;11952;788612;517021;54.9;36.0
44;2021-07-09;6260;14246;794872;531267;55.3;37.0
44;2021-07-10;2446;7007;797318;538274;55.5;37.5
44;2021-07-11;731;2262;798049;540536;55.5;37.6
44;2021-07-12;4395;14049;802444;554585;55.8;38.6
44;2021-07-13;5767;14846;808211;569431;56.2;39.6
44;2021-07-14;3688;5809;811899;575240;56.5;40.0
44;2021-07-15;7228;14280;819127;589520;57.0;41.0
44;2021-07-16;8233;14989;827360;604509;57.6;42.1
44;2021-07-17;3371;7576;830731;612085;57.8;42.6
44;2021-07-18;1433;2548;832164;614633;57.9;42.8
44;2021-07-19;4869;14695;837033;629328;58.2;43.8
44;2021-07-20;6034;15668;843067;644996;58.7;44.9
44;2021-07-21;5843;13986;848910;658982;59.1;45.9
44;2021-07-22;6723;13746;855633;672728;59.5;46.8
44;2021-07-23;6160;15625;861793;688353;60.0;47.9
44;2021-07-24;2856;8716;864649;697069;60.2;48.5
44;2021-07-25;945;3088;865594;700157;60.2;48.7
44;2021-07-26;6081;12679;871675;712836;60.7;49.6
44;2021-07-27;9712;12190;881387;725026;61.3;50.4
44;2021-07-28;9263;10843;890650;735869;62.0;51.2
44;2021-07-29;10287;10839;900937;746708;62.7;52.0
44;2021-07-30;9183;10924;910120;757632;63.3;52.7
44;2021-07-31;4791;5651;914911;763283;63.7;53.1
44;2021-08-01;2573;1409;917484;764692;63.8;53.2
44;2021-08-02;6630;9472;924114;774164;64.3;53.9
44;2021-08-03;8466;8536;932580;782700;64.9;54.5
44;2021-08-04;9127;6986;941707;789686;65.5;54.9
44;2021-08-05;11570;7521;953277;797207;66.3;55.5
44;2021-08-06;9697;8201;962974;805408;67.0;56.0
44;2021-08-07;4609;3702;967583;809110;67.3;56.3
44;2021-08-08;2540;1727;970123;810837;67.5;56.4
44;2021-08-09;8908;7979;979031;818816;68.1;57.0
44;2021-08-10;10273;7622;989304;826438;68.8;57.5
44;2021-08-11;10420;6788;999724;833226;69.6;58.0
44;2021-08-12;10419;7345;1010143;840571;70.3;58.5
44;2021-08-13;8458;6166;1018601;846737;70.9;58.9
44;2021-08-14;3233;3221;1021834;849958;71.1;59.1
44;2021-08-15;716;933;1022550;850891;71.2;59.2
44;2021-08-16;5851;8306;1028401;859197;71.6;59.8
44;2021-08-17;5606;8180;1034007;867377;71.9;60.4
44;2021-08-18;4819;7620;1038826;874997;72.3;60.9
44;2021-08-19;4974;8351;1043800;883348;72.6;61.5
44;2021-08-20;4499;8922;1048299;892270;72.9;62.1
44;2021-08-21;1960;4612;1050259;896882;73.1;62.4
44;2021-08-22;711;2441;1050970;899323;73.1;62.6
44;2021-08-23;3675;9432;1054645;908755;73.4;63.2
44;2021-08-24;3644;8697;1058289;917452;73.6;63.8
44;2021-08-25;3144;8586;1061433;926038;73.9;64.4
44;2021-08-26;2966;10340;1064399;936378;74.1;65.2
44;2021-08-27;3082;10452;1067481;946830;74.3;65.9
44;2021-08-28;1385;5848;1068866;952678;74.4;66.3
44;2021-08-29;565;2706;1069431;955384;74.4;66.5
44;2021-08-30;2666;10966;1072097;966350;74.6;67.2
44;2021-08-31;2824;11227;1074921;977577;74.8;68.0
44;2021-09-01;2705;9936;1077626;987513;75.0;68.7
44;2021-09-02;2260;8741;1079886;996254;75.1;69.3
44;2021-09-03;2136;10204;1082022;1006458;75.3;70.0
44;2021-09-04;1449;6025;1083471;1012483;75.4;70.5
44;2021-09-05;442;1434;1083913;1013917;75.4;70.6
44;2021-09-06;1629;6624;1085542;1020541;75.5;71.0
44;2021-09-07;1480;5776;1087022;1026317;75.6;71.4
44;2021-09-08;1897;6520;1088919;1032837;75.8;71.9
44;2021-09-09;1506;5152;1090425;1037989;75.9;72.2
44;2021-09-10;1832;6492;1092257;1044481;76.0;72.7
44;2021-09-11;1089;4165;1093346;1048646;76.1;73.0
44;2021-09-12;231;850;1093577;1049496;76.1;73.0
44;2021-09-13;1166;4388;1094743;1053884;76.2;73.3
44;2021-09-14;1116;4389;1095859;1058273;76.3;73.6
44;2021-09-15;1446;4489;1097305;1062762;76.4;73.9
44;2021-09-16;989;2380;1098294;1065142;76.4;74.1
44;2021-09-17;1257;3847;1099551;1068989;76.5;74.4
44;2021-09-18;776;3131;1100327;1072120;76.6;74.6
44;2021-09-19;215;703;1100542;1072823;76.6;74.7
44;2021-09-20;915;2206;1101457;1075029;76.6;74.8
44;2021-09-21;748;1869;1102205;1076898;76.7;74.9
44;2021-09-22;941;3546;1103146;1080444;76.8;75.2
44;2021-09-23;832;1932;1103978;1082376;76.8;75.3
44;2021-09-24;1106;2999;1105084;1085375;76.9;75.5
44;2021-09-25;499;2292;1105583;1087667;76.9;75.7
44;2021-09-26;185;486;1105768;1088153;76.9;75.7
44;2021-09-27;768;1785;1106536;1089938;77.0;75.8
44;2021-09-28;658;1675;1107194;1091613;77.0;76.0
44;2021-09-29;963;2506;1108157;1094119;77.1;76.1
44;2021-09-30;718;1514;1108875;1095633;77.2;76.2
44;2021-10-01;910;2267;1109785;1097900;77.2;76.4
44;2021-10-02;474;1318;1110259;1099218;77.3;76.5
44;2021-10-03;219;362;1110478;1099580;77.3;76.5
45;2020-12-27;0;0;0;0;0.0;0.0
45;2020-12-28;1;0;1;0;0.0;0.0
45;2020-12-29;0;0;1;0;0.0;0.0
45;2020-12-30;0;0;1;0;0.0;0.0
45;2020-12-31;1;0;2;0;0.0;0.0
45;2021-01-01;0;0;2;0;0.0;0.0
45;2021-01-02;0;0;2;0;0.0;0.0
45;2021-01-03;0;0;2;0;0.0;0.0
45;2021-01-04;0;0;2;0;0.0;0.0
45;2021-01-05;76;0;78;0;0.0;0.0
45;2021-01-06;68;0;146;0;0.0;0.0
45;2021-01-07;213;0;359;0;0.1;0.0
45;2021-01-08;199;1;558;1;0.1;0.0
45;2021-01-09;42;0;600;1;0.1;0.0
45;2021-01-10;23;0;623;1;0.1;0.0
45;2021-01-11;254;0;877;1;0.1;0.0
45;2021-01-12;680;3;1557;4;0.2;0.0
45;2021-01-13;496;1;2053;5;0.3;0.0
45;2021-01-14;493;39;2546;44;0.4;0.0
45;2021-01-15;391;3;2937;47;0.4;0.0
45;2021-01-16;39;1;2976;48;0.4;0.0
45;2021-01-17;24;0;3000;48;0.4;0.0
45;2021-01-18;816;1;3816;49;0.6;0.0
45;2021-01-19;1197;5;5013;54;0.7;0.0
45;2021-01-20;2119;12;7132;66;1.0;0.0
45;2021-01-21;2521;6;9653;72;1.4;0.0
45;2021-01-22;1409;6;11062;78;1.6;0.0
45;2021-01-23;124;0;11186;78;1.6;0.0
45;2021-01-24;39;0;11225;78;1.6;0.0
45;2021-01-25;557;3;11782;81;1.7;0.0
45;2021-01-26;870;16;12652;97;1.9;0.0
45;2021-01-27;650;42;13302;139;1.9;0.0
45;2021-01-28;881;197;14183;336;2.1;0.0
45;2021-01-29;578;109;14761;445;2.2;0.1
45;2021-01-30;40;35;14801;480;2.2;0.1
45;2021-01-31;37;22;14838;502;2.2;0.1
45;2021-02-01;461;192;15299;694;2.2;0.1
45;2021-02-02;761;436;16060;1130;2.4;0.2
45;2021-02-03;773;443;16833;1573;2.5;0.2
45;2021-02-04;715;257;17548;1830;2.6;0.3
45;2021-02-05;418;149;17966;1979;2.6;0.3
45;2021-02-06;39;25;18005;2004;2.6;0.3
45;2021-02-07;7;24;18012;2028;2.6;0.3
45;2021-02-08;455;175;18467;2203;2.7;0.3
45;2021-02-09;1006;356;19473;2559;2.9;0.4
45;2021-02-10;1279;765;20752;3324;3.0;0.5
45;2021-02-11;1385;1441;22137;4765;3.2;0.7
45;2021-02-12;1052;1069;23189;5834;3.4;0.9
45;2021-02-13;85;148;23274;5982;3.4;0.9
45;2021-02-14;40;11;23314;5993;3.4;0.9
45;2021-02-15;524;451;23838;6444;3.5;0.9
45;2021-02-16;757;721;24595;7165;3.6;1.0
45;2021-02-17;642;803;25237;7968;3.7;1.2
45;2021-02-18;841;649;26078;8617;3.8;1.3
45;2021-02-19;827;635;26905;9252;3.9;1.4
45;2021-02-20;59;75;26964;9327;3.9;1.4
45;2021-02-21;17;33;26981;9360;4.0;1.4
45;2021-02-22;409;466;27390;9826;4.0;1.4
45;2021-02-23;816;574;28206;10400;4.1;1.5
45;2021-02-24;654;694;28860;11094;4.2;1.6
45;2021-02-25;963;587;29823;11681;4.4;1.7
45;2021-02-26;1043;519;30866;12200;4.5;1.8
45;2021-02-27;290;33;31156;12233;4.6;1.8
45;2021-02-28;28;2;31184;12235;4.6;1.8
45;2021-03-01;534;249;31718;12484;4.6;1.8
45;2021-03-02;668;569;32386;13053;4.7;1.9
45;2021-03-03;981;742;33367;13795;4.9;2.0
45;2021-03-04;1108;912;34475;14707;5.0;2.2
45;2021-03-05;1445;774;35920;15481;5.3;2.3
45;2021-03-06;2021;125;37941;15606;5.6;2.3
45;2021-03-07;143;53;38084;15659;5.6;2.3
45;2021-03-08;754;766;38838;16425;5.7;2.4
45;2021-03-09;1256;591;40094;17016;5.9;2.5
45;2021-03-10;1591;808;41685;17824;6.1;2.6
45;2021-03-11;1722;685;43407;18509;6.4;2.7
45;2021-03-12;2072;566;45479;19075;6.7;2.8
45;2021-03-13;988;44;46467;19119;6.8;2.8
45;2021-03-14;24;39;46491;19158;6.8;2.8
45;2021-03-15;810;572;47301;19730;6.9;2.9
45;2021-03-16;942;811;48243;20541;7.1;3.0
45;2021-03-17;1054;652;49297;21193;7.2;3.1
45;2021-03-18;997;572;50294;21765;7.4;3.2
45;2021-03-19;1619;418;51913;22183;7.6;3.2
45;2021-03-20;498;80;52411;22263;7.7;3.3
45;2021-03-21;20;35;52431;22298;7.7;3.3
45;2021-03-22;915;519;53346;22817;7.8;3.3
45;2021-03-23;1985;710;55331;23527;8.1;3.4
45;2021-03-24;1897;541;57228;24068;8.4;3.5
45;2021-03-25;2983;452;60211;24520;8.8;3.6
45;2021-03-26;3390;483;63601;25003;9.3;3.7
45;2021-03-27;1796;123;65397;25126;9.6;3.7
45;2021-03-28;89;40;65486;25166;9.6;3.7
45;2021-03-29;1531;538;67017;25704;9.8;3.8
45;2021-03-30;2785;779;69802;26483;10.2;3.9
45;2021-03-31;2135;578;71937;27061;10.5;4.0
45;2021-04-01;2968;565;74905;27626;11.0;4.0
45;2021-04-02;2827;513;77732;28139;11.4;4.1
45;2021-04-03;810;71;78542;28210;11.5;4.1
45;2021-04-04;113;33;78655;28243;11.5;4.1
45;2021-04-05;15;2;78670;28245;11.5;4.1
45;2021-04-06;1735;792;80405;29037;11.8;4.3
45;2021-04-07;1774;1112;82179;30149;12.0;4.4
45;2021-04-08;2772;1020;84951;31169;12.4;4.6
45;2021-04-09;3675;647;88626;31816;13.0;4.7
45;2021-04-10;2323;117;90949;31933;13.3;4.7
45;2021-04-11;153;24;91102;31957;13.3;4.7
45;2021-04-12;2606;670;93708;32627;13.7;4.8
45;2021-04-13;3848;1091;97556;33718;14.3;4.9
45;2021-04-14;2930;1219;100486;34937;14.7;5.1
45;2021-04-15;3518;1040;104004;35977;15.2;5.3
45;2021-04-16;3775;691;107779;36668;15.8;5.4
45;2021-04-17;1614;112;109393;36780;16.0;5.4
45;2021-04-18;200;42;109593;36822;16.0;5.4
45;2021-04-19;1938;941;111531;37763;16.3;5.5
45;2021-04-20;3074;1694;114605;39457;16.8;5.8
45;2021-04-21;2724;1304;117329;40761;17.2;6.0
45;2021-04-22;3420;1844;120749;42605;17.7;6.2
45;2021-04-23;3278;1784;124027;44389;18.2;6.5
45;2021-04-24;2023;867;126050;45256;18.5;6.6
45;2021-04-25;291;86;126341;45342;18.5;6.6
45;2021-04-26;2228;1163;128569;46505;18.8;6.8
45;2021-04-27;3351;2350;131920;48855;19.3;7.2
45;2021-04-28;2802;1937;134722;50792;19.7;7.4
45;2021-04-29;3854;2320;138576;53112;20.3;7.8
45;2021-04-30;4391;1801;142967;54913;20.9;8.0
45;2021-05-01;451;61;143418;54974;21.0;8.1
45;2021-05-02;627;122;144045;55096;21.1;8.1
45;2021-05-03;2821;992;146866;56088;21.5;8.2
45;2021-05-04;3157;2349;150023;58437;22.0;8.6
45;2021-05-05;2715;2161;152738;60598;22.4;8.9
45;2021-05-06;3330;2539;156068;63137;22.9;9.2
45;2021-05-07;2871;3183;158939;66320;23.3;9.7
45;2021-05-08;613;244;159552;66564;23.4;9.7
45;2021-05-09;1498;132;161050;66696;23.6;9.8
45;2021-05-10;4139;2968;165189;69664;24.2;10.2
45;2021-05-11;5030;2968;170219;72632;24.9;10.6
45;2021-05-12;6078;2772;176297;75404;25.8;11.0
45;2021-05-13;2449;598;178746;76002;26.2;11.1
45;2021-05-14;4965;1629;183711;77631;26.9;11.4
45;2021-05-15;4064;615;187775;78246;27.5;11.5
45;2021-05-16;289;33;188064;78279;27.5;11.5
45;2021-05-17;3359;1528;191423;79807;28.0;11.7
45;2021-05-18;5117;1681;196540;81488;28.8;11.9
45;2021-05-19;4494;2064;201034;83552;29.4;12.2
45;2021-05-20;5268;2137;206302;85689;30.2;12.5
45;2021-05-21;5141;2224;211443;87913;31.0;12.9
45;2021-05-22;3042;632;214485;88545;31.4;13.0
45;2021-05-23;15;94;214500;88639;31.4;13.0
45;2021-05-24;2826;215;217326;88854;31.8;13.0
45;2021-05-25;4961;3030;222287;91884;32.6;13.5
45;2021-05-26;5108;2337;227395;94221;33.3;13.8
45;2021-05-27;5306;3229;232701;97450;34.1;14.3
45;2021-05-28;5665;3590;238366;101040;34.9;14.8
45;2021-05-29;3671;1288;242037;102328;35.4;15.0
45;2021-05-30;33;182;242070;102510;35.4;15.0
45;2021-05-31;4331;2513;246401;105023;36.1;15.4
45;2021-06-01;6090;3003;252491;108026;37.0;15.8
45;2021-06-02;4937;3107;257428;111133;37.7;16.3
45;2021-06-03;5616;3199;263044;114332;38.5;16.7
45;2021-06-04;5895;3178;268939;117510;39.4;17.2
45;2021-06-05;2035;1332;270974;118842;39.7;17.4
45;2021-06-06;88;198;271062;119040;39.7;17.4
45;2021-06-07;4081;2722;275143;121762;40.3;17.8
45;2021-06-08;4646;4071;279789;125833;41.0;18.4
45;2021-06-09;4356;3343;284145;129176;41.6;18.9
45;2021-06-10;4647;2687;288792;131863;42.3;19.3
45;2021-06-11;4121;3661;292913;135524;42.9;19.8
45;2021-06-12;2440;1504;295353;137028;43.3;20.1
45;2021-06-13;21;424;295374;137452;43.3;20.1
45;2021-06-14;3142;4151;298516;141603;43.7;20.7
45;2021-06-15;3388;4324;301904;145927;44.2;21.4
45;2021-06-16;3904;3452;305808;149379;44.8;21.9
45;2021-06-17;3523;3538;309331;152917;45.3;22.4
45;2021-06-18;3799;5028;313130;157945;45.9;23.1
45;2021-06-19;2393;1761;315523;159706;46.2;23.4
45;2021-06-20;48;142;315571;159848;46.2;23.4
45;2021-06-21;2164;5851;317735;165699;46.5;24.3
45;2021-06-22;2417;6529;320152;172228;46.9;25.2
45;2021-06-23;2282;5598;322434;177826;47.2;26.0
45;2021-06-24;2136;3531;324570;181357;47.5;26.6
45;2021-06-25;2444;6446;327014;187803;47.9;27.5
45;2021-06-26;1948;3094;328962;190897;48.2;28.0
45;2021-06-27;53;138;329015;191035;48.2;28.0
45;2021-06-28;2081;4828;331096;195863;48.5;28.7
45;2021-06-29;2847;6816;333943;202679;48.9;29.7
45;2021-06-30;2888;5852;336831;208531;49.3;30.5
45;2021-07-01;2398;5038;339229;213569;49.7;31.3
45;2021-07-02;2372;6282;341601;219851;50.0;32.2
45;2021-07-03;754;2540;342355;222391;50.1;32.6
45;2021-07-04;6;12;342361;222403;50.1;32.6
45;2021-07-05;2143;4991;344504;227394;50.4;33.3
45;2021-07-06;2806;6777;347310;234171;50.9;34.3
45;2021-07-07;2447;6061;349757;240232;51.2;35.2
45;2021-07-08;2826;5376;352583;245608;51.6;36.0
45;2021-07-09;2146;6984;354729;252592;51.9;37.0
45;2021-07-10;1553;3862;356282;256454;52.2;37.6
45;2021-07-11;24;31;356306;256485;52.2;37.6
45;2021-07-12;1591;5996;357897;262481;52.4;38.4
45;2021-07-13;3042;8236;360939;270717;52.9;39.6
45;2021-07-14;1475;1519;362414;272236;53.1;39.9
45;2021-07-15;3734;7289;366148;279525;53.6;40.9
45;2021-07-16;3253;7446;369401;286971;54.1;42.0
45;2021-07-17;1285;2332;370686;289303;54.3;42.4
45;2021-07-18;15;19;370701;289322;54.3;42.4
45;2021-07-19;1870;5935;372571;295257;54.6;43.2
45;2021-07-20;4757;6900;377328;302157;55.3;44.2
45;2021-07-21;5175;5478;382503;307635;56.0;45.0
45;2021-07-22;6178;4904;388681;312539;56.9;45.8
45;2021-07-23;4260;5479;392941;318018;57.5;46.6
45;2021-07-24;1863;2824;394804;320842;57.8;47.0
45;2021-07-25;5;14;394809;320856;57.8;47.0
45;2021-07-26;2913;4983;397722;325839;58.2;47.7
45;2021-07-27;5464;5084;403186;330923;59.0;48.5
45;2021-07-28;4989;4180;408175;335103;59.8;49.1
45;2021-07-29;5279;3255;413454;338358;60.5;49.5
45;2021-07-30;4761;4708;418215;343066;61.2;50.2
45;2021-07-31;849;1950;419064;345016;61.4;50.5
45;2021-08-01;2;4;419066;345020;61.4;50.5
45;2021-08-02;3635;3245;422701;348265;61.9;51.0
45;2021-08-03;4878;3011;427579;351276;62.6;51.4
45;2021-08-04;3742;2235;431321;353511;63.2;51.8
45;2021-08-05;3327;2637;434648;356148;63.6;52.2
45;2021-08-06;3747;3270;438395;359418;64.2;52.6
45;2021-08-07;1679;1049;440074;360467;64.4;52.8
45;2021-08-08;9;18;440083;360485;64.4;52.8
45;2021-08-09;2627;3014;442710;363499;64.8;53.2
45;2021-08-10;3516;3806;446226;367305;65.3;53.8
45;2021-08-11;2702;3719;448928;371024;65.7;54.3
45;2021-08-12;2093;3431;451021;374455;66.0;54.8
45;2021-08-13;1745;4224;452766;378679;66.3;55.5
45;2021-08-14;682;956;453448;379635;66.4;55.6
45;2021-08-15;62;31;453510;379666;66.4;55.6
45;2021-08-16;1159;2319;454669;381985;66.6;55.9
45;2021-08-17;1858;3448;456527;385433;66.9;56.4
45;2021-08-18;1782;4050;458309;389483;67.1;57.0
45;2021-08-19;1445;4268;459754;393751;67.3;57.7
45;2021-08-20;1424;3681;461178;397432;67.5;58.2
45;2021-08-21;905;1154;462083;398586;67.7;58.4
45;2021-08-22;4;8;462087;398594;67.7;58.4
45;2021-08-23;1332;4245;463419;402839;67.9;59.0
45;2021-08-24;1736;4522;465155;407361;68.1;59.7
45;2021-08-25;1585;3725;466740;411086;68.3;60.2
45;2021-08-26;1010;3450;467750;414536;68.5;60.7
45;2021-08-27;1432;4981;469182;419517;68.7;61.4
45;2021-08-28;878;2030;470060;421547;68.8;61.7
45;2021-08-29;100;38;470160;421585;68.8;61.7
45;2021-08-30;1221;4117;471381;425702;69.0;62.3
45;2021-08-31;1076;4514;472457;430216;69.2;63.0
45;2021-09-01;1104;3549;473561;433765;69.3;63.5
45;2021-09-02;923;3355;474484;437120;69.5;64.0
45;2021-09-03;1089;3845;475573;440965;69.6;64.6
45;2021-09-04;495;1317;476068;442282;69.7;64.8
45;2021-09-05;1;16;476069;442298;69.7;64.8
45;2021-09-06;885;2823;476954;445121;69.8;65.2
45;2021-09-07;708;2231;477662;447352;69.9;65.5
45;2021-09-08;855;2620;478517;449972;70.1;65.9
45;2021-09-09;798;1680;479315;451652;70.2;66.1
45;2021-09-10;785;1881;480100;453533;70.3;66.4
45;2021-09-11;442;1607;480542;455140;70.4;66.6
45;2021-09-12;372;369;480914;455509;70.4;66.7
45;2021-09-13;434;1296;481348;456805;70.5;66.9
45;2021-09-14;755;2079;482103;458884;70.6;67.2
45;2021-09-15;797;1823;482900;460707;70.7;67.5
45;2021-09-16;802;960;483702;461667;70.8;67.6
45;2021-09-17;765;1655;484467;463322;70.9;67.8
45;2021-09-18;481;992;484948;464314;71.0;68.0
45;2021-09-19;2;29;484950;464343;71.0;68.0
45;2021-09-20;412;980;485362;465323;71.1;68.1
45;2021-09-21;447;749;485809;466072;71.1;68.2
45;2021-09-22;437;1701;486246;467773;71.2;68.5
45;2021-09-23;528;837;486774;468610;71.3;68.6
45;2021-09-24;578;1375;487352;469985;71.4;68.8
45;2021-09-25;351;781;487703;470766;71.4;68.9
45;2021-09-26;2;11;487705;470777;71.4;68.9
45;2021-09-27;435;757;488140;471534;71.5;69.0
45;2021-09-28;448;752;488588;472286;71.5;69.2
45;2021-09-29;477;967;489065;473253;71.6;69.3
45;2021-09-30;353;821;489418;474074;71.7;69.4
45;2021-10-01;293;766;489711;474840;71.7;69.5
45;2021-10-02;292;544;490003;475384;71.8;69.6
45;2021-10-03;98;368;490101;475752;71.8;69.7
46;2020-12-27;4;0;4;0;0.0;0.0
46;2020-12-28;0;0;4;0;0.0;0.0
46;2020-12-29;0;0;4;0;0.0;0.0
46;2020-12-30;0;0;4;0;0.0;0.0
46;2020-12-31;0;0;4;0;0.0;0.0
46;2021-01-01;0;0;4;0;0.0;0.0
46;2021-01-02;0;0;4;0;0.0;0.0
46;2021-01-03;1;0;5;0;0.0;0.0
46;2021-01-04;0;0;5;0;0.0;0.0
46;2021-01-05;0;0;5;0;0.0;0.0
46;2021-01-06;3;0;8;0;0.0;0.0
46;2021-01-07;136;0;144;0;0.1;0.0
46;2021-01-08;181;0;325;0;0.2;0.0
46;2021-01-09;1;0;326;0;0.2;0.0
46;2021-01-10;2;0;328;0;0.2;0.0
46;2021-01-11;118;0;446;0;0.3;0.0
46;2021-01-12;140;0;586;0;0.3;0.0
46;2021-01-13;235;0;821;0;0.5;0.0
46;2021-01-14;243;2;1064;2;0.6;0.0
46;2021-01-15;306;2;1370;4;0.8;0.0
46;2021-01-16;18;0;1388;4;0.8;0.0
46;2021-01-17;0;0;1388;4;0.8;0.0
46;2021-01-18;276;2;1664;6;1.0;0.0
46;2021-01-19;390;0;2054;6;1.2;0.0
46;2021-01-20;939;2;2993;8;1.7;0.0
46;2021-01-21;997;0;3990;8;2.3;0.0
46;2021-01-22;391;2;4381;10;2.5;0.0
46;2021-01-23;0;0;4381;10;2.5;0.0
46;2021-01-24;0;0;4381;10;2.5;0.0
46;2021-01-25;204;1;4585;11;2.6;0.0
46;2021-01-26;264;1;4849;12;2.8;0.0
46;2021-01-27;276;0;5125;12;3.0;0.0
46;2021-01-28;278;43;5403;55;3.1;0.0
46;2021-01-29;233;61;5636;116;3.3;0.1
46;2021-01-30;1;0;5637;116;3.3;0.1
46;2021-01-31;1;0;5638;116;3.3;0.1
46;2021-02-01;234;141;5872;257;3.4;0.1
46;2021-02-02;210;201;6082;458;3.5;0.3
46;2021-02-03;227;90;6309;548;3.6;0.3
46;2021-02-04;372;73;6681;621;3.9;0.4
46;2021-02-05;226;153;6907;774;4.0;0.4
46;2021-02-06;9;0;6916;774;4.0;0.4
46;2021-02-07;43;0;6959;774;4.0;0.4
46;2021-02-08;197;125;7156;899;4.1;0.5
46;2021-02-09;271;202;7427;1101;4.3;0.6
46;2021-02-10;280;481;7707;1582;4.5;0.9
46;2021-02-11;655;509;8362;2091;4.8;1.2
46;2021-02-12;323;313;8685;2404;5.0;1.4
46;2021-02-13;2;0;8687;2404;5.0;1.4
46;2021-02-14;0;62;8687;2466;5.0;1.4
46;2021-02-15;195;223;8882;2689;5.1;1.6
46;2021-02-16;217;214;9099;2903;5.3;1.7
46;2021-02-17;201;276;9300;3179;5.4;1.8
46;2021-02-18;337;227;9637;3406;5.6;2.0
46;2021-02-19;277;199;9914;3605;5.7;2.1
46;2021-02-20;0;0;9914;3605;5.7;2.1
46;2021-02-21;1;0;9915;3605;5.7;2.1
46;2021-02-22;131;156;10046;3761;5.8;2.2
46;2021-02-23;225;130;10271;3891;5.9;2.2
46;2021-02-24;179;262;10450;4153;6.0;2.4
46;2021-02-25;247;288;10697;4441;6.2;2.6
46;2021-02-26;403;313;11100;4754;6.4;2.7
46;2021-02-27;120;1;11220;4755;6.5;2.7
46;2021-02-28;0;3;11220;4758;6.5;2.7
46;2021-03-01;169;157;11389;4915;6.6;2.8
46;2021-03-02;406;198;11795;5113;6.8;3.0
46;2021-03-03;460;309;12255;5422;7.1;3.1
46;2021-03-04;607;413;12862;5835;7.4;3.4
46;2021-03-05;808;335;13670;6170;7.9;3.6
46;2021-03-06;476;15;14146;6185;8.2;3.6
46;2021-03-07;101;19;14247;6204;8.2;3.6
46;2021-03-08;348;223;14595;6427;8.4;3.7
46;2021-03-09;746;255;15341;6682;8.9;3.9
46;2021-03-10;686;234;16027;6916;9.3;4.0
46;2021-03-11;851;247;16878;7163;9.7;4.1
46;2021-03-12;927;205;17805;7368;10.3;4.3
46;2021-03-13;512;4;18317;7372;10.6;4.3
46;2021-03-14;0;0;18317;7372;10.6;4.3
46;2021-03-15;505;153;18822;7525;10.9;4.3
46;2021-03-16;752;165;19574;7690;11.3;4.4
46;2021-03-17;674;188;20248;7878;11.7;4.5
46;2021-03-18;758;204;21006;8082;12.1;4.7
46;2021-03-19;811;147;21817;8229;12.6;4.8
46;2021-03-20;294;4;22111;8233;12.8;4.8
46;2021-03-21;2;0;22113;8233;12.8;4.8
46;2021-03-22;555;238;22668;8471;13.1;4.9
46;2021-03-23;702;209;23370;8680;13.5;5.0
46;2021-03-24;673;237;24043;8917;13.9;5.1
46;2021-03-25;1135;177;25178;9094;14.5;5.3
46;2021-03-26;1024;338;26202;9432;15.1;5.4
46;2021-03-27;420;50;26622;9482;15.4;5.5
46;2021-03-28;127;1;26749;9483;15.4;5.5
46;2021-03-29;733;251;27482;9734;15.9;5.6
46;2021-03-30;767;364;28249;10098;16.3;5.8
46;2021-03-31;865;415;29114;10513;16.8;6.1
46;2021-04-01;1172;345;30286;10858;17.5;6.3
46;2021-04-02;922;393;31208;11251;18.0;6.5
46;2021-04-03;167;165;31375;11416;18.1;6.6
46;2021-04-04;0;71;31375;11487;18.1;6.6
46;2021-04-05;3;0;31378;11487;18.1;6.6
46;2021-04-06;544;517;31922;12004;18.4;6.9
46;2021-04-07;784;644;32706;12648;18.9;7.3
46;2021-04-08;960;540;33666;13188;19.4;7.6
46;2021-04-09;1018;506;34684;13694;20.0;7.9
46;2021-04-10;506;208;35190;13902;20.3;8.0
46;2021-04-11;232;1;35422;13903;20.5;8.0
46;2021-04-12;845;546;36267;14449;20.9;8.3
46;2021-04-13;1187;718;37454;15167;21.6;8.8
46;2021-04-14;1533;612;38987;15779;22.5;9.1
46;2021-04-15;1504;661;40491;16440;23.4;9.5
46;2021-04-16;1584;567;42075;17007;24.3;9.8
46;2021-04-17;995;136;43070;17143;24.9;9.9
46;2021-04-18;517;9;43587;17152;25.2;9.9
46;2021-04-19;1070;570;44657;17722;25.8;10.2
46;2021-04-20;1229;729;45886;18451;26.5;10.7
46;2021-04-21;1230;711;47116;19162;27.2;11.1
46;2021-04-22;1391;726;48507;19888;28.0;11.5
46;2021-04-23;1132;732;49639;20620;28.7;11.9
46;2021-04-24;472;19;50111;20639;28.9;11.9
46;2021-04-25;351;11;50462;20650;29.1;11.9
46;2021-04-26;852;730;51314;21380;29.6;12.3
46;2021-04-27;1221;665;52535;22045;30.3;12.7
46;2021-04-28;1289;668;53824;22713;31.1;13.1
46;2021-04-29;1417;522;55241;23235;31.9;13.4
46;2021-04-30;1438;566;56679;23801;32.7;13.7
46;2021-05-01;697;73;57376;23874;33.1;13.8
46;2021-05-02;346;4;57722;23878;33.3;13.8
46;2021-05-03;853;568;58575;24446;33.8;14.1
46;2021-05-04;1037;1061;59612;25507;34.4;14.7
46;2021-05-05;1374;787;60986;26294;35.2;15.2
46;2021-05-06;1377;741;62363;27035;36.0;15.6
46;2021-05-07;1396;792;63759;27827;36.8;16.1
46;2021-05-08;280;410;64039;28237;37.0;16.3
46;2021-05-09;23;225;64062;28462;37.0;16.4
46;2021-05-10;516;1136;64578;29598;37.3;17.1
46;2021-05-11;1031;1254;65609;30852;37.9;17.8
46;2021-05-12;993;1556;66602;32408;38.5;18.7
46;2021-05-13;599;144;67201;32552;38.8;18.8
46;2021-05-14;958;1097;68159;33649;39.4;19.4
46;2021-05-15;254;654;68413;34303;39.5;19.8
46;2021-05-16;77;297;68490;34600;39.6;20.0
46;2021-05-17;652;960;69142;35560;39.9;20.5
46;2021-05-18;1402;1024;70544;36584;40.7;21.1
46;2021-05-19;1305;904;71849;37488;41.5;21.6
46;2021-05-20;1453;810;73302;38298;42.3;22.1
46;2021-05-21;997;1158;74299;39456;42.9;22.8
46;2021-05-22;146;367;74445;39823;43.0;23.0
46;2021-05-23;451;25;74896;39848;43.3;23.0
46;2021-05-24;411;113;75307;39961;43.5;23.1
46;2021-05-25;960;1333;76267;41294;44.0;23.8
46;2021-05-26;1237;1149;77504;42443;44.8;24.5
46;2021-05-27;1432;1192;78936;43635;45.6;25.2
46;2021-05-28;1428;1208;80364;44843;46.4;25.9
46;2021-05-29;1049;397;81413;45240;47.0;26.1
46;2021-05-30;409;39;81822;45279;47.3;26.1
46;2021-05-31;968;976;82790;46255;47.8;26.7
46;2021-06-01;1277;996;84067;47251;48.5;27.3
46;2021-06-02;1320;1116;85387;48367;49.3;27.9
46;2021-06-03;1415;1011;86802;49378;50.1;28.5
46;2021-06-04;1329;977;88131;50355;50.9;29.1
46;2021-06-05;381;414;88512;50769;51.1;29.3
46;2021-06-06;209;96;88721;50865;51.2;29.4
46;2021-06-07;814;616;89535;51481;51.7;29.7
46;2021-06-08;1020;895;90555;52376;52.3;30.2
46;2021-06-09;1503;974;92058;53350;53.2;30.8
46;2021-06-10;981;850;93039;54200;53.7;31.3
46;2021-06-11;969;1321;94008;55521;54.3;32.1
46;2021-06-12;459;545;94467;56066;54.6;32.4
46;2021-06-13;27;86;94494;56152;54.6;32.4
46;2021-06-14;593;1138;95087;57290;54.9;33.1
46;2021-06-15;751;1245;95838;58535;55.3;33.8
46;2021-06-16;1001;1113;96839;59648;55.9;34.4
46;2021-06-17;527;895;97366;60543;56.2;35.0
46;2021-06-18;656;1253;98022;61796;56.6;35.7
46;2021-06-19;457;313;98479;62109;56.9;35.9
46;2021-06-20;39;161;98518;62270;56.9;36.0
46;2021-06-21;429;946;98947;63216;57.1;36.5
46;2021-06-22;350;1177;99297;64393;57.3;37.2
46;2021-06-23;519;1074;99816;65467;57.6;37.8
46;2021-06-24;251;820;100067;66287;57.8;38.3
46;2021-06-25;491;1118;100558;67405;58.1;38.9
46;2021-06-26;398;553;100956;67958;58.3;39.2
46;2021-06-27;3;4;100959;67962;58.3;39.2
46;2021-06-28;315;1340;101274;69302;58.5;40.0
46;2021-06-29;375;1680;101649;70982;58.7;41.0
46;2021-06-30;510;1577;102159;72559;59.0;41.9
46;2021-07-01;487;1153;102646;73712;59.3;42.6
46;2021-07-02;455;1087;103101;74799;59.5;43.2
46;2021-07-03;120;454;103221;75253;59.6;43.5
46;2021-07-04;57;127;103278;75380;59.6;43.5
46;2021-07-05;347;1186;103625;76566;59.8;44.2
46;2021-07-06;449;1457;104074;78023;60.1;45.1
46;2021-07-07;583;1726;104657;79749;60.4;46.1
46;2021-07-08;340;1164;104997;80913;60.6;46.7
46;2021-07-09;395;1706;105392;82619;60.9;47.7
46;2021-07-10;285;1039;105677;83658;61.0;48.3
46;2021-07-11;15;375;105692;84033;61.0;48.5
46;2021-07-12;248;1259;105940;85292;61.2;49.3
46;2021-07-13;626;1671;106566;86963;61.5;50.2
46;2021-07-14;73;144;106639;87107;61.6;50.3
46;2021-07-15;917;1464;107556;88571;62.1;51.1
46;2021-07-16;766;1394;108322;89965;62.6;52.0
46;2021-07-17;364;539;108686;90504;62.8;52.3
46;2021-07-18;2;0;108688;90504;62.8;52.3
46;2021-07-19;729;1188;109417;91692;63.2;53.0
46;2021-07-20;983;1438;110400;93130;63.8;53.8
46;2021-07-21;1001;1378;111401;94508;64.3;54.6
46;2021-07-22;1404;1118;112805;95626;65.1;55.2
46;2021-07-23;768;1322;113573;96948;65.6;56.0
46;2021-07-24;956;662;114529;97610;66.1;56.4
46;2021-07-25;136;17;114665;97627;66.2;56.4
46;2021-07-26;881;879;115546;98506;66.7;56.9
46;2021-07-27;1220;978;116766;99484;67.4;57.5
46;2021-07-28;1284;1114;118050;100598;68.2;58.1
46;2021-07-29;1580;849;119630;101447;69.1;58.6
46;2021-07-30;1933;956;121563;102403;70.2;59.1
46;2021-07-31;958;661;122521;103064;70.8;59.5
46;2021-08-01;12;3;122533;103067;70.8;59.5
46;2021-08-02;974;591;123507;103658;71.3;59.9
46;2021-08-03;1365;679;124872;104337;72.1;60.3
46;2021-08-04;1735;586;126607;104923;73.1;60.6
46;2021-08-05;1382;842;127989;105765;73.9;61.1
46;2021-08-06;1422;848;129411;106613;74.7;61.6
46;2021-08-07;707;543;130118;107156;75.1;61.9
46;2021-08-08;152;66;130270;107222;75.2;61.9
46;2021-08-09;1016;694;131286;107916;75.8;62.3
46;2021-08-10;1206;892;132492;108808;76.5;62.8
46;2021-08-11;1260;1064;133752;109872;77.2;63.4
46;2021-08-12;990;800;134742;110672;77.8;63.9
46;2021-08-13;953;1005;135695;111677;78.4;64.5
46;2021-08-14;588;774;136283;112451;78.7;64.9
46;2021-08-15;8;27;136291;112478;78.7;65.0
46;2021-08-16;795;810;137086;113288;79.2;65.4
46;2021-08-17;889;1288;137975;114576;79.7;66.2
46;2021-08-18;769;1051;138744;115627;80.1;66.8
46;2021-08-19;672;1363;139416;116990;80.5;67.6
46;2021-08-20;518;1557;139934;118547;80.8;68.5
46;2021-08-21;378;649;140312;119196;81.0;68.8
46;2021-08-22;2;31;140314;119227;81.0;68.9
46;2021-08-23;424;1204;140738;120431;81.3;69.5
46;2021-08-24;554;1338;141292;121769;81.6;70.3
46;2021-08-25;530;1398;141822;123167;81.9;71.1
46;2021-08-26;392;1095;142214;124262;82.1;71.8
46;2021-08-27;435;1912;142649;126174;82.4;72.9
46;2021-08-28;272;652;142921;126826;82.5;73.2
46;2021-08-29;5;11;142926;126837;82.5;73.2
46;2021-08-30;294;1133;143220;127970;82.7;73.9
46;2021-08-31;340;1278;143560;129248;82.9;74.6
46;2021-09-01;393;1147;143953;130395;83.1;75.3
46;2021-09-02;271;1024;144224;131419;83.3;75.9
46;2021-09-03;322;1293;144546;132712;83.5;76.6
46;2021-09-04;188;664;144734;133376;83.6;77.0
46;2021-09-05;8;16;144742;133392;83.6;77.0
46;2021-09-06;218;756;144960;134148;83.7;77.5
46;2021-09-07;252;817;145212;134965;83.9;77.9
46;2021-09-08;277;892;145489;135857;84.0;78.5
46;2021-09-09;199;640;145688;136497;84.1;78.8
46;2021-09-10;277;1025;145965;137522;84.3;79.4
46;2021-09-11;150;389;146115;137911;84.4;79.6
46;2021-09-12;8;23;146123;137934;84.4;79.7
46;2021-09-13;178;694;146301;138628;84.5;80.1
46;2021-09-14;264;735;146565;139363;84.6;80.5
46;2021-09-15;257;676;146822;140039;84.8;80.9
46;2021-09-16;132;265;146954;140304;84.9;81.0
46;2021-09-17;232;555;147186;140859;85.0;81.3
46;2021-09-18;101;364;147287;141223;85.1;81.6
46;2021-09-19;3;9;147290;141232;85.1;81.6
46;2021-09-20;69;350;147359;141582;85.1;81.8
46;2021-09-21;70;237;147429;141819;85.1;81.9
46;2021-09-22;128;482;147557;142301;85.2;82.2
46;2021-09-23;83;225;147640;142526;85.3;82.3
46;2021-09-24;76;400;147716;142926;85.3;82.5
46;2021-09-25;69;221;147785;143147;85.3;82.7
46;2021-09-26;3;8;147788;143155;85.3;82.7
46;2021-09-27;76;229;147864;143384;85.4;82.8
46;2021-09-28;48;225;147912;143609;85.4;82.9
46;2021-09-29;81;290;147993;143899;85.5;83.1
46;2021-09-30;63;146;148056;144045;85.5;83.2
46;2021-10-01;97;295;148153;144340;85.6;83.4
46;2021-10-02;80;191;148233;144531;85.6;83.5
46;2021-10-03;0;0;148233;144531;85.6;83.5
47;2020-12-27;0;0;0;0;0.0;0.0
47;2020-12-28;0;0;0;0;0.0;0.0
47;2020-12-29;0;0;0;0;0.0;0.0
47;2020-12-30;0;0;0;0;0.0;0.0
47;2020-12-31;0;0;0;0;0.0;0.0
47;2021-01-01;4;0;4;0;0.0;0.0
47;2021-01-02;0;0;4;0;0.0;0.0
47;2021-01-03;0;0;4;0;0.0;0.0
47;2021-01-04;0;0;4;0;0.0;0.0
47;2021-01-05;1;0;5;0;0.0;0.0
47;2021-01-06;0;0;5;0;0.0;0.0
47;2021-01-07;71;0;76;0;0.0;0.0
47;2021-01-08;314;0;390;0;0.1;0.0
47;2021-01-09;113;0;503;0;0.2;0.0
47;2021-01-10;0;0;503;0;0.2;0.0
47;2021-01-11;249;1;752;1;0.2;0.0
47;2021-01-12;327;0;1079;1;0.3;0.0
47;2021-01-13;349;0;1428;1;0.4;0.0
47;2021-01-14;363;4;1791;5;0.5;0.0
47;2021-01-15;287;1;2078;6;0.6;0.0
47;2021-01-16;176;3;2254;9;0.7;0.0
47;2021-01-17;0;0;2254;9;0.7;0.0
47;2021-01-18;486;1;2740;10;0.8;0.0
47;2021-01-19;469;2;3209;12;1.0;0.0
47;2021-01-20;516;0;3725;12;1.1;0.0
47;2021-01-21;585;1;4310;13;1.3;0.0
47;2021-01-22;470;0;4780;13;1.4;0.0
47;2021-01-23;390;0;5170;13;1.6;0.0
47;2021-01-24;0;0;5170;13;1.6;0.0
47;2021-01-25;434;0;5604;13;1.7;0.0
47;2021-01-26;792;4;6396;17;1.9;0.0
47;2021-01-27;731;0;7127;17;2.2;0.0
47;2021-01-28;574;60;7701;77;2.3;0.0
47;2021-01-29;461;161;8162;238;2.5;0.1
47;2021-01-30;301;37;8463;275;2.6;0.1
47;2021-01-31;0;0;8463;275;2.6;0.1
47;2021-02-01;372;113;8835;388;2.7;0.1
47;2021-02-02;759;308;9594;696;2.9;0.2
47;2021-02-03;426;149;10020;845;3.0;0.3
47;2021-02-04;370;303;10390;1148;3.1;0.3
47;2021-02-05;300;302;10690;1450;3.2;0.4
47;2021-02-06;297;84;10987;1534;3.3;0.5
47;2021-02-07;0;0;10987;1534;3.3;0.5
47;2021-02-08;184;201;11171;1735;3.4;0.5
47;2021-02-09;231;199;11402;1934;3.5;0.6
47;2021-02-10;254;199;11656;2133;3.5;0.6
47;2021-02-11;356;319;12012;2452;3.6;0.7
47;2021-02-12;243;373;12255;2825;3.7;0.9
47;2021-02-13;226;89;12481;2914;3.8;0.9
47;2021-02-14;0;0;12481;2914;3.8;0.9
47;2021-02-15;194;312;12675;3226;3.8;1.0
47;2021-02-16;303;524;12978;3750;3.9;1.1
47;2021-02-17;326;385;13304;4135;4.0;1.3
47;2021-02-18;201;483;13505;4618;4.1;1.4
47;2021-02-19;193;307;13698;4925;4.1;1.5
47;2021-02-20;117;216;13815;5141;4.2;1.6
47;2021-02-21;0;0;13815;5141;4.2;1.6
47;2021-02-22;75;323;13890;5464;4.2;1.7
47;2021-02-23;149;541;14039;6005;4.2;1.8
47;2021-02-24;261;492;14300;6497;4.3;2.0
47;2021-02-25;304;361;14604;6858;4.4;2.1
47;2021-02-26;467;288;15071;7146;4.6;2.2
47;2021-02-27;324;175;15395;7321;4.7;2.2
47;2021-02-28;0;0;15395;7321;4.7;2.2
47;2021-03-01;124;364;15519;7685;4.7;2.3
47;2021-03-02;199;322;15718;8007;4.8;2.4
47;2021-03-03;244;303;15962;8310;4.8;2.5
47;2021-03-04;592;297;16554;8607;5.0;2.6
47;2021-03-05;844;255;17398;8862;5.3;2.7
47;2021-03-06;505;168;17903;9030;5.4;2.7
47;2021-03-07;331;6;18234;9036;5.5;2.7
47;2021-03-08;458;200;18692;9236;5.7;2.8
47;2021-03-09;508;454;19200;9690;5.8;2.9
47;2021-03-10;666;281;19866;9971;6.0;3.0
47;2021-03-11;940;359;20806;10330;6.3;3.1
47;2021-03-12;1373;267;22179;10597;6.7;3.2
47;2021-03-13;950;108;23129;10705;7.0;3.2
47;2021-03-14;51;0;23180;10705;7.0;3.2
47;2021-03-15;593;151;23773;10856;7.2;3.3
47;2021-03-16;750;158;24523;11014;7.4;3.3
47;2021-03-17;861;203;25384;11217;7.7;3.4
47;2021-03-18;917;174;26301;11391;8.0;3.4
47;2021-03-19;1272;128;27573;11519;8.3;3.5
47;2021-03-20;1088;59;28661;11578;8.7;3.5
47;2021-03-21;344;1;29005;11579;8.8;3.5
47;2021-03-22;1010;94;30015;11673;9.1;3.5
47;2021-03-23;1146;144;31161;11817;9.4;3.6
47;2021-03-24;1214;128;32375;11945;9.8;3.6
47;2021-03-25;1567;150;33942;12095;10.3;3.7
47;2021-03-26;1882;198;35824;12293;10.8;3.7
47;2021-03-27;980;130;36804;12423;11.1;3.8
47;2021-03-28;699;5;37503;12428;11.4;3.8
47;2021-03-29;1511;79;39014;12507;11.8;3.8
47;2021-03-30;1645;127;40659;12634;12.3;3.8
47;2021-03-31;1605;152;42264;12786;12.8;3.9
47;2021-04-01;1682;269;43946;13055;13.3;4.0
47;2021-04-02;1932;452;45878;13507;13.9;4.1
47;2021-04-03;1202;182;47080;13689;14.3;4.1
47;2021-04-04;475;13;47555;13702;14.4;4.1
47;2021-04-05;1297;59;48852;13761;14.8;4.2
47;2021-04-06;1386;388;50238;14149;15.2;4.3
47;2021-04-07;1697;592;51935;14741;15.7;4.5
47;2021-04-08;1834;469;53769;15210;16.3;4.6
47;2021-04-09;2085;542;55854;15752;16.9;4.8
47;2021-04-10;1565;324;57419;16076;17.4;4.9
47;2021-04-11;530;9;57949;16085;17.5;4.9
47;2021-04-12;1438;614;59387;16699;18.0;5.1
47;2021-04-13;1813;763;61200;17462;18.5;5.3
47;2021-04-14;1749;720;62949;18182;19.1;5.5
47;2021-04-15;2012;844;64961;19026;19.7;5.8
47;2021-04-16;1768;890;66729;19916;20.2;6.0
47;2021-04-17;1471;969;68200;20885;20.6;6.3
47;2021-04-18;23;0;68223;20885;20.7;6.3
47;2021-04-19;1331;931;69554;21816;21.1;6.6
47;2021-04-20;1626;910;71180;22726;21.5;6.9
47;2021-04-21;1623;774;72803;23500;22.0;7.1
47;2021-04-22;1869;1056;74672;24556;22.6;7.4
47;2021-04-23;1729;1075;76401;25631;23.1;7.8
47;2021-04-24;1549;803;77950;26434;23.6;8.0
47;2021-04-25;242;344;78192;26778;23.7;8.1
47;2021-04-26;1490;1359;79682;28137;24.1;8.5
47;2021-04-27;1921;1466;81603;29603;24.7;9.0
47;2021-04-28;2090;1589;83693;31192;25.3;9.4
47;2021-04-29;2532;1503;86225;32695;26.1;9.9
47;2021-04-30;2044;1778;88269;34473;26.7;10.4
47;2021-05-01;2263;984;90532;35457;27.4;10.7
47;2021-05-02;21;358;90553;35815;27.4;10.8
47;2021-05-03;1596;1418;92149;37233;27.9;11.3
47;2021-05-04;1645;1729;93794;38962;28.4;11.8
47;2021-05-05;1926;1639;95720;40601;29.0;12.3
47;2021-05-06;2105;1507;97825;42108;29.6;12.7
47;2021-05-07;2001;1621;99826;43729;30.2;13.2
47;2021-05-08;2097;464;101923;44193;30.9;13.4
47;2021-05-09;24;359;101947;44552;30.9;13.5
47;2021-05-10;1202;1669;103149;46221;31.2;14.0
47;2021-05-11;2172;1982;105321;48203;31.9;14.6
47;2021-05-12;2624;1445;107945;49648;32.7;15.0
47;2021-05-13;2380;656;110325;50304;33.4;15.2
47;2021-05-14;2061;859;112386;51163;34.0;15.5
47;2021-05-15;1934;865;114320;52028;34.6;15.8
47;2021-05-16;367;9;114687;52037;34.7;15.8
47;2021-05-17;1884;1124;116571;53161;35.3;16.1
47;2021-05-18;2358;1139;118929;54300;36.0;16.4
47;2021-05-19;2344;759;121273;55059;36.7;16.7
47;2021-05-20;2589;967;123862;56026;37.5;17.0
47;2021-05-21;1538;1133;125400;57159;38.0;17.3
47;2021-05-22;2369;839;127769;57998;38.7;17.6
47;2021-05-23;25;186;127794;58184;38.7;17.6
47;2021-05-24;1549;237;129343;58421;39.2;17.7
47;2021-05-25;1481;1318;130824;59739;39.6;18.1
47;2021-05-26;1599;1089;132423;60828;40.1;18.4
47;2021-05-27;1944;1269;134367;62097;40.7;18.8
47;2021-05-28;1458;1534;135825;63631;41.1;19.3
47;2021-05-29;1153;1120;136978;64751;41.5;19.6
47;2021-05-30;12;45;136990;64796;41.5;19.6
47;2021-05-31;1868;1416;138858;66212;42.0;20.0
47;2021-06-01;1921;1342;140779;67554;42.6;20.5
47;2021-06-02;2100;1332;142879;68886;43.3;20.9
47;2021-06-03;2486;1610;145365;70496;44.0;21.3
47;2021-06-04;1965;2117;147330;72613;44.6;22.0
47;2021-06-05;1640;1470;148970;74083;45.1;22.4
47;2021-06-06;211;70;149181;74153;45.2;22.4
47;2021-06-07;1659;2238;150840;76391;45.7;23.1
47;2021-06-08;1629;1903;152469;78294;46.2;23.7
47;2021-06-09;1824;2122;154293;80416;46.7;24.3
47;2021-06-10;2377;1618;156670;82034;47.4;24.8
47;2021-06-11;1826;2099;158496;84133;48.0;25.5
47;2021-06-12;1351;2102;159847;86235;48.4;26.1
47;2021-06-13;4;10;159851;86245;48.4;26.1
47;2021-06-14;1281;2440;161132;88685;48.8;26.8
47;2021-06-15;1464;2033;162596;90718;49.2;27.5
47;2021-06-16;1203;2183;163799;92901;49.6;28.1
47;2021-06-17;1655;1522;165454;94423;50.1;28.6
47;2021-06-18;1439;2496;166893;96919;50.5;29.3
47;2021-06-19;1541;2452;168434;99371;51.0;30.1
47;2021-06-20;5;33;168439;99404;51.0;30.1
47;2021-06-21;1136;2513;169575;101917;51.3;30.9
47;2021-06-22;762;2506;170337;104423;51.6;31.6
47;2021-06-23;999;2015;171336;106438;51.9;32.2
47;2021-06-24;1211;1936;172547;108374;52.2;32.8
47;2021-06-25;1006;2608;173553;110982;52.5;33.6
47;2021-06-26;987;2789;174540;113771;52.8;34.4
47;2021-06-27;16;349;174556;114120;52.8;34.5
47;2021-06-28;875;2407;175431;116527;53.1;35.3
47;2021-06-29;797;2314;176228;118841;53.3;36.0
47;2021-06-30;730;2303;176958;121144;53.6;36.7
47;2021-07-01;922;2105;177880;123249;53.8;37.3
47;2021-07-02;885;2274;178765;125523;54.1;38.0
47;2021-07-03;726;3042;179491;128565;54.3;38.9
47;2021-07-04;34;12;179525;128577;54.3;38.9
47;2021-07-05;978;2147;180503;130724;54.6;39.6
47;2021-07-06;1007;1957;181510;132681;54.9;40.2
47;2021-07-07;1298;2064;182808;134745;55.3;40.8
47;2021-07-08;1142;2192;183950;136937;55.7;41.5
47;2021-07-09;1047;2404;184997;139341;56.0;42.2
47;2021-07-10;952;2131;185949;141472;56.3;42.8
47;2021-07-11;1;6;185950;141478;56.3;42.8
47;2021-07-12;556;2580;186506;144058;56.5;43.6
47;2021-07-13;1094;2585;187600;146643;56.8;44.4
47;2021-07-14;1165;1577;188765;148220;57.1;44.9
47;2021-07-15;1717;3135;190482;151355;57.7;45.8
47;2021-07-16;1722;2676;192204;154031;58.2;46.6
47;2021-07-17;1201;2458;193405;156489;58.5;47.4
47;2021-07-18;36;188;193441;156677;58.6;47.4
47;2021-07-19;1113;2557;194554;159234;58.9;48.2
47;2021-07-20;1638;2341;196192;161575;59.4;48.9
47;2021-07-21;2193;2240;198385;163815;60.1;49.6
47;2021-07-22;2157;2298;200542;166113;60.7;50.3
47;2021-07-23;2124;2250;202666;168363;61.4;51.0
47;2021-07-24;1114;1915;203780;170278;61.7;51.5
47;2021-07-25;20;1;203800;170279;61.7;51.5
47;2021-07-26;1236;1945;205036;172224;62.1;52.1
47;2021-07-27;2123;1633;207159;173857;62.7;52.6
47;2021-07-28;1880;1605;209039;175462;63.3;53.1
47;2021-07-29;2339;1602;211378;177064;64.0;53.6
47;2021-07-30;1865;1625;213243;178689;64.6;54.1
47;2021-07-31;1485;1668;214728;180357;65.0;54.6
47;2021-08-01;18;8;214746;180365;65.0;54.6
47;2021-08-02;2053;1219;216799;181584;65.6;55.0
47;2021-08-03;2159;1106;218958;182690;66.3;55.3
47;2021-08-04;2192;1527;221150;184217;66.9;55.8
47;2021-08-05;2407;1447;223557;185664;67.7;56.2
47;2021-08-06;1999;1841;225556;187505;68.3;56.8
47;2021-08-07;1628;1418;227184;188923;68.8;57.2
47;2021-08-08;24;22;227208;188945;68.8;57.2
47;2021-08-09;1883;1214;229091;190159;69.4;57.6
47;2021-08-10;1920;1298;231011;191457;69.9;58.0
47;2021-08-11;1804;1400;232815;192857;70.5;58.4
47;2021-08-12;2060;1339;234875;194196;71.1;58.8
47;2021-08-13;1424;1668;236299;195864;71.5;59.3
47;2021-08-14;1349;1443;237648;197307;71.9;59.7
47;2021-08-15;11;18;237659;197325;71.9;59.7
47;2021-08-16;1436;1445;239095;198770;72.4;60.2
47;2021-08-17;1124;1684;240219;200454;72.7;60.7
47;2021-08-18;1181;1714;241400;202168;73.1;61.2
47;2021-08-19;1038;1812;242438;203980;73.4;61.7
47;2021-08-20;972;1708;243410;205688;73.7;62.3
47;2021-08-21;828;1276;244238;206964;73.9;62.7
47;2021-08-22;19;31;244257;206995;73.9;62.7
47;2021-08-23;615;1826;244872;208821;74.1;63.2
47;2021-08-24;811;1622;245683;210443;74.4;63.7
47;2021-08-25;811;1787;246494;212230;74.6;64.2
47;2021-08-26;736;2080;247230;214310;74.8;64.9
47;2021-08-27;700;1978;247930;216288;75.1;65.5
47;2021-08-28;567;1670;248497;217958;75.2;66.0
47;2021-08-29;2;16;248499;217974;75.2;66.0
47;2021-08-30;459;1926;248958;219900;75.4;66.6
47;2021-08-31;584;1816;249542;221716;75.5;67.1
47;2021-09-01;421;2019;249963;223735;75.7;67.7
47;2021-09-02;436;2018;250399;225753;75.8;68.3
47;2021-09-03;504;1954;250903;227707;76.0;68.9
47;2021-09-04;478;1822;251381;229529;76.1;69.5
47;2021-09-05;12;37;251393;229566;76.1;69.5
47;2021-09-06;339;1407;251732;230973;76.2;69.9
47;2021-09-07;476;1268;252208;232241;76.3;70.3
47;2021-09-08;417;1621;252625;233862;76.5;70.8
47;2021-09-09;408;1347;253033;235209;76.6;71.2
47;2021-09-10;472;1331;253505;236540;76.7;71.6
47;2021-09-11;435;1429;253940;237969;76.9;72.0
47;2021-09-12;3;7;253943;237976;76.9;72.0
47;2021-09-13;253;955;254196;238931;77.0;72.3
47;2021-09-14;397;1046;254593;239977;77.1;72.6
47;2021-09-15;342;939;254935;240916;77.2;72.9
47;2021-09-16;323;558;255258;241474;77.3;73.1
47;2021-09-17;391;645;255649;242119;77.4;73.3
47;2021-09-18;263;956;255912;243075;77.5;73.6
47;2021-09-19;4;4;255916;243079;77.5;73.6
47;2021-09-20;164;470;256080;243549;77.5;73.7
47;2021-09-21;285;454;256365;244003;77.6;73.9
47;2021-09-22;212;617;256577;244620;77.7;74.1
47;2021-09-23;210;378;256787;244998;77.7;74.2
47;2021-09-24;283;613;257070;245611;77.8;74.4
47;2021-09-25;215;628;257285;246239;77.9;74.5
47;2021-09-26;6;6;257291;246245;77.9;74.5
47;2021-09-27;111;376;257402;246621;77.9;74.7
47;2021-09-28;127;374;257529;246995;78.0;74.8
47;2021-09-29;148;473;257677;247468;78.0;74.9
47;2021-09-30;158;355;257835;247823;78.1;75.0
47;2021-10-01;182;518;258017;248341;78.1;75.2
47;2021-10-02;194;482;258211;248823;78.2;75.3
47;2021-10-03;0;5;258211;248828;78.2;75.3
48;2020-12-27;0;0;0;0;0.0;0.0
48;2020-12-28;0;0;0;0;0.0;0.0
48;2020-12-29;0;0;0;0;0.0;0.0
48;2020-12-30;0;0;0;0;0.0;0.0
48;2020-12-31;0;0;0;0;0.0;0.0
48;2021-01-01;0;0;0;0;0.0;0.0
48;2021-01-02;0;0;0;0;0.0;0.0
48;2021-01-03;0;0;0;0;0.0;0.0
48;2021-01-04;0;0;0;0;0.0;0.0
48;2021-01-05;0;0;0;0;0.0;0.0
48;2021-01-06;0;0;0;0;0.0;0.0
48;2021-01-07;56;0;56;0;0.1;0.0
48;2021-01-08;88;0;144;0;0.2;0.0
48;2021-01-09;1;0;145;0;0.2;0.0
48;2021-01-10;0;0;145;0;0.2;0.0
48;2021-01-11;13;0;158;0;0.2;0.0
48;2021-01-12;19;1;177;1;0.2;0.0
48;2021-01-13;104;0;281;1;0.4;0.0
48;2021-01-14;90;1;371;2;0.5;0.0
48;2021-01-15;63;0;434;2;0.6;0.0
48;2021-01-16;0;0;434;2;0.6;0.0
48;2021-01-17;0;0;434;2;0.6;0.0
48;2021-01-18;117;0;551;2;0.7;0.0
48;2021-01-19;345;2;896;4;1.2;0.0
48;2021-01-20;364;0;1260;4;1.7;0.0
48;2021-01-21;466;1;1726;5;2.3;0.0
48;2021-01-22;269;0;1995;5;2.6;0.0
48;2021-01-23;36;0;2031;5;2.7;0.0
48;2021-01-24;0;0;2031;5;2.7;0.0
48;2021-01-25;109;2;2140;7;2.8;0.0
48;2021-01-26;261;0;2401;7;3.1;0.0
48;2021-01-27;257;1;2658;8;3.5;0.0
48;2021-01-28;273;10;2931;18;3.8;0.0
48;2021-01-29;175;59;3106;77;4.1;0.1
48;2021-01-30;1;7;3107;84;4.1;0.1
48;2021-01-31;0;6;3107;90;4.1;0.1
48;2021-02-01;100;45;3207;135;4.2;0.2
48;2021-02-02;194;32;3401;167;4.5;0.2
48;2021-02-03;177;81;3578;248;4.7;0.3
48;2021-02-04;234;12;3812;260;5.0;0.3
48;2021-02-05;145;33;3957;293;5.2;0.4
48;2021-02-06;34;1;3991;294;5.2;0.4
48;2021-02-07;0;0;3991;294;5.2;0.4
48;2021-02-08;50;57;4041;351;5.3;0.5
48;2021-02-09;66;151;4107;502;5.4;0.7
48;2021-02-10;64;297;4171;799;5.5;1.0
48;2021-02-11;165;379;4336;1178;5.7;1.5
48;2021-02-12;120;143;4456;1321;5.8;1.7
48;2021-02-13;8;54;4464;1375;5.9;1.8
48;2021-02-14;0;0;4464;1375;5.9;1.8
48;2021-02-15;51;84;4515;1459;5.9;1.9
48;2021-02-16;43;132;4558;1591;6.0;2.1
48;2021-02-17;35;267;4593;1858;6.0;2.4
48;2021-02-18;252;91;4845;1949;6.4;2.6
48;2021-02-19;60;149;4905;2098;6.4;2.8
48;2021-02-20;0;1;4905;2099;6.4;2.8
48;2021-02-21;0;14;4905;2113;6.4;2.8
48;2021-02-22;24;85;4929;2198;6.5;2.9
48;2021-02-23;74;199;5003;2397;6.6;3.1
48;2021-02-24;68;238;5071;2635;6.6;3.5
48;2021-02-25;148;212;5219;2847;6.8;3.7
48;2021-02-26;51;185;5270;3032;6.9;4.0
48;2021-02-27;28;1;5298;3033;6.9;4.0
48;2021-02-28;3;14;5301;3047;6.9;4.0
48;2021-03-01;102;77;5403;3124;7.1;4.1
48;2021-03-02;199;71;5602;3195;7.3;4.2
48;2021-03-03;153;94;5755;3289;7.5;4.3
48;2021-03-04;194;171;5949;3460;7.8;4.5
48;2021-03-05;136;122;6085;3582;8.0;4.7
48;2021-03-06;180;52;6265;3634;8.2;4.8
48;2021-03-07;75;2;6340;3636;8.3;4.8
48;2021-03-08;352;120;6692;3756;8.8;4.9
48;2021-03-09;377;92;7069;3848;9.3;5.0
48;2021-03-10;263;57;7332;3905;9.6;5.1
48;2021-03-11;334;82;7666;3987;10.0;5.2
48;2021-03-12;256;138;7922;4125;10.4;5.4
48;2021-03-13;301;5;8223;4130;10.8;5.4
48;2021-03-14;8;0;8231;4130;10.8;5.4
48;2021-03-15;174;55;8405;4185;11.0;5.5
48;2021-03-16;167;65;8572;4250;11.2;5.6
48;2021-03-17;156;110;8728;4360;11.4;5.7
48;2021-03-18;191;104;8919;4464;11.7;5.9
48;2021-03-19;116;95;9035;4559;11.8;6.0
48;2021-03-20;101;0;9136;4559;12.0;6.0
48;2021-03-21;0;0;9136;4559;12.0;6.0
48;2021-03-22;160;18;9296;4577;12.2;6.0
48;2021-03-23;329;100;9625;4677;12.6;6.1
48;2021-03-24;284;100;9909;4777;13.0;6.3
48;2021-03-25;757;117;10666;4894;14.0;6.4
48;2021-03-26;269;59;10935;4953;14.3;6.5
48;2021-03-27;104;1;11039;4954;14.5;6.5
48;2021-03-28;80;20;11119;4974;14.6;6.5
48;2021-03-29;305;78;11424;5052;15.0;6.6
48;2021-03-30;364;131;11788;5183;15.5;6.8
48;2021-03-31;448;85;12236;5268;16.0;6.9
48;2021-04-01;730;73;12966;5341;17.0;7.0
48;2021-04-02;487;134;13453;5475;17.6;7.2
48;2021-04-03;140;83;13593;5558;17.8;7.3
48;2021-04-04;0;0;13593;5558;17.8;7.3
48;2021-04-05;43;1;13636;5559;17.9;7.3
48;2021-04-06;465;160;14101;5719;18.5;7.5
48;2021-04-07;465;141;14566;5860;19.1;7.7
48;2021-04-08;620;188;15186;6048;19.9;7.9
48;2021-04-09;446;122;15632;6170;20.5;8.1
48;2021-04-10;95;60;15727;6230;20.6;8.2
48;2021-04-11;2;0;15729;6230;20.6;8.2
48;2021-04-12;364;71;16093;6301;21.1;8.3
48;2021-04-13;361;92;16454;6393;21.6;8.4
48;2021-04-14;623;187;17077;6580;22.4;8.6
48;2021-04-15;701;358;17778;6938;23.3;9.1
48;2021-04-16;538;225;18316;7163;24.0;9.4
48;2021-04-17;89;71;18405;7234;24.1;9.5
48;2021-04-18;0;0;18405;7234;24.1;9.5
48;2021-04-19;196;105;18601;7339;24.4;9.6
48;2021-04-20;216;180;18817;7519;24.7;9.9
48;2021-04-21;284;207;19101;7726;25.0;10.1
48;2021-04-22;306;480;19407;8206;25.4;10.8
48;2021-04-23;255;242;19662;8448;25.8;11.1
48;2021-04-24;97;95;19759;8543;25.9;11.2
48;2021-04-25;1;9;19760;8552;25.9;11.2
48;2021-04-26;87;210;19847;8762;26.0;11.5
48;2021-04-27;172;292;20019;9054;26.2;11.9
48;2021-04-28;149;415;20168;9469;26.4;12.4
48;2021-04-29;204;488;20372;9957;26.7;13.1
48;2021-04-30;172;223;20544;10180;26.9;13.3
48;2021-05-01;0;0;20544;10180;26.9;13.3
48;2021-05-02;0;0;20544;10180;26.9;13.3
48;2021-05-03;106;386;20650;10566;27.1;13.9
48;2021-05-04;227;420;20877;10986;27.4;14.4
48;2021-05-05;84;486;20961;11472;27.5;15.0
48;2021-05-06;775;640;21736;12112;28.5;15.9
48;2021-05-07;96;503;21832;12615;28.6;16.5
48;2021-05-08;309;43;22141;12658;29.0;16.6
48;2021-05-09;285;9;22426;12667;29.4;16.6
48;2021-05-10;55;325;22481;12992;29.5;17.0
48;2021-05-11;221;289;22702;13281;29.8;17.4
48;2021-05-12;249;313;22951;13594;30.1;17.8
48;2021-05-13;472;157;23423;13751;30.7;18.0
48;2021-05-14;244;222;23667;13973;31.0;18.3
48;2021-05-15;84;46;23751;14019;31.1;18.4
48;2021-05-16;1;6;23752;14025;31.1;18.4
48;2021-05-17;474;267;24226;14292;31.8;18.7
48;2021-05-18;263;229;24489;14521;32.1;19.0
48;2021-05-19;207;277;24696;14798;32.4;19.4
48;2021-05-20;318;256;25014;15054;32.8;19.7
48;2021-05-21;174;267;25188;15321;33.0;20.1
48;2021-05-22;25;50;25213;15371;33.1;20.1
48;2021-05-23;0;6;25213;15377;33.1;20.2
48;2021-05-24;0;14;25213;15391;33.1;20.2
48;2021-05-25;181;265;25394;15656;33.3;20.5
48;2021-05-26;416;298;25810;15954;33.8;20.9
48;2021-05-27;1178;380;26988;16334;35.4;21.4
48;2021-05-28;315;350;27303;16684;35.8;21.9
48;2021-05-29;79;50;27382;16734;35.9;21.9
48;2021-05-30;0;1;27382;16735;35.9;21.9
48;2021-05-31;624;263;28006;16998;36.7;22.3
48;2021-06-01;272;305;28278;17303;37.1;22.7
48;2021-06-02;407;424;28685;17727;37.6;23.2
48;2021-06-03;629;431;29314;18158;38.4;23.8
48;2021-06-04;291;283;29605;18441;38.8;24.2
48;2021-06-05;121;77;29726;18518;39.0;24.3
48;2021-06-06;1;1;29727;18519;39.0;24.3
48;2021-06-07;440;161;30167;18680;39.5;24.5
48;2021-06-08;615;309;30782;18989;40.4;24.9
48;2021-06-09;379;190;31161;19179;40.8;25.1
48;2021-06-10;1003;242;32164;19421;42.2;25.5
48;2021-06-11;371;161;32535;19582;42.6;25.7
48;2021-06-12;74;57;32609;19639;42.7;25.7
48;2021-06-13;0;2;32609;19641;42.7;25.7
48;2021-06-14;124;115;32733;19756;42.9;25.9
48;2021-06-15;407;386;33140;20142;43.4;26.4
48;2021-06-16;260;144;33400;20286;43.8;26.6
48;2021-06-17;486;575;33886;20861;44.4;27.3
48;2021-06-18;254;314;34140;21175;44.8;27.8
48;2021-06-19;35;291;34175;21466;44.8;28.1
48;2021-06-20;123;224;34298;21690;45.0;28.4
48;2021-06-21;125;134;34423;21824;45.1;28.6
48;2021-06-22;258;335;34681;22159;45.5;29.0
48;2021-06-23;111;545;34792;22704;45.6;29.8
48;2021-06-24;364;610;35156;23314;46.1;30.6
48;2021-06-25;154;276;35310;23590;46.3;30.9
48;2021-06-26;15;45;35325;23635;46.3;31.0
48;2021-06-27;1;1;35326;23636;46.3;31.0
48;2021-06-28;81;177;35407;23813;46.4;31.2
48;2021-06-29;297;415;35704;24228;46.8;31.8
48;2021-06-30;98;465;35802;24693;46.9;32.4
48;2021-07-01;194;669;35996;25362;47.2;33.2
48;2021-07-02;148;369;36144;25731;47.4;33.7
48;2021-07-03;42;89;36186;25820;47.4;33.8
48;2021-07-04;7;0;36193;25820;47.4;33.8
48;2021-07-05;40;117;36233;25937;47.5;34.0
48;2021-07-06;277;598;36510;26535;47.9;34.8
48;2021-07-07;201;489;36711;27024;48.1;35.4
48;2021-07-08;223;1189;36934;28213;48.4;37.0
48;2021-07-09;159;553;37093;28766;48.6;37.7
48;2021-07-10;95;147;37188;28913;48.7;37.9
48;2021-07-11;0;4;37188;28917;48.7;37.9
48;2021-07-12;139;672;37327;29589;48.9;38.8
48;2021-07-13;211;430;37538;30019;49.2;39.4
48;2021-07-14;179;145;37717;30164;49.4;39.5
48;2021-07-15;187;459;37904;30623;49.7;40.1
48;2021-07-16;234;314;38138;30937;50.0;40.6
48;2021-07-17;129;118;38267;31055;50.2;40.7
48;2021-07-18;4;5;38271;31060;50.2;40.7
48;2021-07-19;105;306;38376;31366;50.3;41.1
48;2021-07-20;678;993;39054;32359;51.2;42.4
48;2021-07-21;69;371;39123;32730;51.3;42.9
48;2021-07-22;777;1125;39900;33855;52.3;44.4
48;2021-07-23;367;437;40267;34292;52.8;45.0
48;2021-07-24;509;170;40776;34462;53.5;45.2
48;2021-07-25;138;46;40914;34508;53.6;45.2
48;2021-07-26;101;199;41015;34707;53.8;45.5
48;2021-07-27;1195;644;42210;35351;55.3;46.3
48;2021-07-28;177;316;42387;35667;55.6;46.8
48;2021-07-29;716;646;43103;36313;56.5;47.6
48;2021-07-30;200;292;43303;36605;56.8;48.0
48;2021-07-31;339;178;43642;36783;57.2;48.2
48;2021-08-01;18;55;43660;36838;57.2;48.3
48;2021-08-02;228;164;43888;37002;57.5;48.5
48;2021-08-03;925;575;44813;37577;58.7;49.3
48;2021-08-04;328;220;45141;37797;59.2;49.5
48;2021-08-05;674;475;45815;38272;60.1;50.2
48;2021-08-06;442;275;46257;38547;60.6;50.5
48;2021-08-07;249;125;46506;38672;61.0;50.7
48;2021-08-08;2;5;46508;38677;61.0;50.7
48;2021-08-09;170;141;46678;38818;61.2;50.9
48;2021-08-10;726;555;47404;39373;62.1;51.6
48;2021-08-11;295;238;47699;39611;62.5;51.9
48;2021-08-12;419;414;48118;40025;63.1;52.5
48;2021-08-13;229;212;48347;40237;63.4;52.7
48;2021-08-14;137;165;48484;40402;63.6;53.0
48;2021-08-15;131;81;48615;40483;63.7;53.1
48;2021-08-16;121;192;48736;40675;63.9;53.3
48;2021-08-17;364;1188;49100;41863;64.4;54.9
48;2021-08-18;211;201;49311;42064;64.6;55.1
48;2021-08-19;240;325;49551;42389;65.0;55.6
48;2021-08-20;215;284;49766;42673;65.2;55.9
48;2021-08-21;85;232;49851;42905;65.3;56.2
48;2021-08-22;0;0;49851;42905;65.3;56.2
48;2021-08-23;65;153;49916;43058;65.4;56.4
48;2021-08-24;308;952;50224;44010;65.8;57.7
48;2021-08-25;156;351;50380;44361;66.0;58.2
48;2021-08-26;180;499;50560;44860;66.3;58.8
48;2021-08-27;153;337;50713;45197;66.5;59.2
48;2021-08-28;127;303;50840;45500;66.6;59.6
48;2021-08-29;0;1;50840;45501;66.6;59.6
48;2021-08-30;54;146;50894;45647;66.7;59.8
48;2021-08-31;257;1071;51151;46718;67.1;61.2
48;2021-09-01;125;347;51276;47065;67.2;61.7
48;2021-09-02;131;405;51407;47470;67.4;62.2
48;2021-09-03;138;328;51545;47798;67.6;62.7
48;2021-09-04;121;244;51666;48042;67.7;63.0
48;2021-09-05;3;26;51669;48068;67.7;63.0
48;2021-09-06;34;190;51703;48258;67.8;63.3
48;2021-09-07;159;392;51862;48650;68.0;63.8
48;2021-09-08;96;225;51958;48875;68.1;64.1
48;2021-09-09;96;303;52054;49178;68.2;64.5
48;2021-09-10;128;401;52182;49579;68.4;65.0
48;2021-09-11;89;220;52271;49799;68.5;65.3
48;2021-09-12;1;3;52272;49802;68.5;65.3
48;2021-09-13;78;153;52350;49955;68.6;65.5
48;2021-09-14;202;384;52552;50339;68.9;66.0
48;2021-09-15;68;164;52620;50503;69.0;66.2
48;2021-09-16;121;219;52741;50722;69.1;66.5
48;2021-09-17;101;182;52842;50904;69.3;66.7
48;2021-09-18;31;90;52873;50994;69.3;66.8
48;2021-09-19;0;0;52873;50994;69.3;66.8
48;2021-09-20;28;87;52901;51081;69.3;67.0
48;2021-09-21;63;183;52964;51264;69.4;67.2
48;2021-09-22;49;151;53013;51415;69.5;67.4
48;2021-09-23;28;100;53041;51515;69.5;67.5
48;2021-09-24;43;118;53084;51633;69.6;67.7
48;2021-09-25;27;78;53111;51711;69.6;67.8
48;2021-09-26;1;0;53112;51711;69.6;67.8
48;2021-09-27;10;43;53122;51754;69.6;67.8
48;2021-09-28;65;155;53187;51909;69.7;68.0
48;2021-09-29;51;133;53238;52042;69.8;68.2
48;2021-09-30;40;87;53278;52129;69.8;68.3
48;2021-10-01;55;140;53333;52269;69.9;68.5
48;2021-10-02;33;51;53366;52320;70.0;68.6
48;2021-10-03;0;1;53366;52321;70.0;68.6
49;2020-12-27;0;0;0;0;0.0;0.0
49;2020-12-28;2;0;2;0;0.0;0.0
49;2020-12-29;0;0;2;0;0.0;0.0
49;2020-12-30;0;0;2;0;0.0;0.0
49;2020-12-31;0;0;2;0;0.0;0.0
49;2021-01-01;2;0;4;0;0.0;0.0
49;2021-01-02;1;1;5;1;0.0;0.0
49;2021-01-03;0;0;5;1;0.0;0.0
49;2021-01-04;10;0;15;1;0.0;0.0
49;2021-01-05;92;0;107;1;0.0;0.0
49;2021-01-06;232;0;339;1;0.0;0.0
49;2021-01-07;367;0;706;1;0.1;0.0
49;2021-01-08;328;1;1034;2;0.1;0.0
49;2021-01-09;118;0;1152;2;0.1;0.0
49;2021-01-10;114;0;1266;2;0.2;0.0
49;2021-01-11;287;0;1553;2;0.2;0.0
49;2021-01-12;623;0;2176;2;0.3;0.0
49;2021-01-13;602;2;2778;4;0.3;0.0
49;2021-01-14;590;5;3368;9;0.4;0.0
49;2021-01-15;775;1;4143;10;0.5;0.0
49;2021-01-16;148;0;4291;10;0.5;0.0
49;2021-01-17;111;2;4402;12;0.5;0.0
49;2021-01-18;691;0;5093;12;0.6;0.0
49;2021-01-19;1203;2;6296;14;0.8;0.0
49;2021-01-20;1512;3;7808;17;1.0;0.0
49;2021-01-21;1943;4;9751;21;1.2;0.0
49;2021-01-22;1321;5;11072;26;1.4;0.0
49;2021-01-23;263;0;11335;26;1.4;0.0
49;2021-01-24;1;0;11336;26;1.4;0.0
49;2021-01-25;552;3;11888;29;1.5;0.0
49;2021-01-26;988;74;12876;103;1.6;0.0
49;2021-01-27;1860;35;14736;138;1.8;0.0
49;2021-01-28;2877;75;17613;213;2.2;0.0
49;2021-01-29;1589;83;19202;296;2.4;0.0
49;2021-01-30;300;41;19502;337;2.4;0.0
49;2021-01-31;62;45;19564;382;2.4;0.0
49;2021-02-01;661;148;20225;530;2.5;0.1
49;2021-02-02;743;360;20968;890;2.6;0.1
49;2021-02-03;677;310;21645;1200;2.7;0.1
49;2021-02-04;758;408;22403;1608;2.7;0.2
49;2021-02-05;708;533;23111;2141;2.8;0.3
49;2021-02-06;228;101;23339;2242;2.9;0.3
49;2021-02-07;59;68;23398;2310;2.9;0.3
49;2021-02-08;549;414;23947;2724;2.9;0.3
49;2021-02-09;716;543;24663;3267;3.0;0.4
49;2021-02-10;807;793;25470;4060;3.1;0.5
49;2021-02-11;1028;1311;26498;5371;3.2;0.7
49;2021-02-12;870;895;27368;6266;3.4;0.8
49;2021-02-13;266;99;27634;6365;3.4;0.8
49;2021-02-14;9;90;27643;6455;3.4;0.8
49;2021-02-15;730;590;28373;7045;3.5;0.9
49;2021-02-16;1106;1040;29479;8085;3.6;1.0
49;2021-02-17;1160;1723;30639;9808;3.8;1.2
49;2021-02-18;1811;2343;32450;12151;4.0;1.5
49;2021-02-19;1397;1043;33847;13194;4.1;1.6
49;2021-02-20;232;330;34079;13524;4.2;1.7
49;2021-02-21;0;64;34079;13588;4.2;1.7
49;2021-02-22;647;468;34726;14056;4.3;1.7
49;2021-02-23;734;736;35460;14792;4.3;1.8
49;2021-02-24;824;525;36284;15317;4.4;1.9
49;2021-02-25;1208;674;37492;15991;4.6;2.0
49;2021-02-26;1678;723;39170;16714;4.8;2.0
49;2021-02-27;435;223;39605;16937;4.9;2.1
49;2021-02-28;49;30;39654;16967;4.9;2.1
49;2021-03-01;768;494;40422;17461;5.0;2.1
49;2021-03-02;1082;603;41504;18064;5.1;2.2
49;2021-03-03;1559;598;43063;18662;5.3;2.3
49;2021-03-04;1769;838;44832;19500;5.5;2.4
49;2021-03-05;2214;620;47046;20120;5.8;2.5
49;2021-03-06;717;161;47763;20281;5.9;2.5
49;2021-03-07;627;13;48390;20294;5.9;2.5
49;2021-03-08;1397;657;49787;20951;6.1;2.6
49;2021-03-09;2052;685;51839;21636;6.4;2.7
49;2021-03-10;2530;837;54369;22473;6.7;2.8
49;2021-03-11;3195;1431;57564;23904;7.1;2.9
49;2021-03-12;3766;978;61330;24882;7.5;3.0
49;2021-03-13;1501;198;62831;25080;7.7;3.1
49;2021-03-14;6;0;62837;25080;7.7;3.1
49;2021-03-15;2084;525;64921;25605;8.0;3.1
49;2021-03-16;1732;955;66653;26560;8.2;3.3
49;2021-03-17;1811;674;68464;27234;8.4;3.3
49;2021-03-18;2205;720;70669;27954;8.7;3.4
49;2021-03-19;3333;558;74002;28512;9.1;3.5
49;2021-03-20;1743;204;75745;28716;9.3;3.5
49;2021-03-21;499;22;76244;28738;9.3;3.5
49;2021-03-22;2248;544;78492;29282;9.6;3.6
49;2021-03-23;3406;675;81898;29957;10.0;3.7
49;2021-03-24;3603;497;85501;30454;10.5;3.7
49;2021-03-25;4225;651;89726;31105;11.0;3.8
49;2021-03-26;4886;502;94612;31607;11.6;3.9
49;2021-03-27;1675;99;96287;31706;11.8;3.9
49;2021-03-28;400;28;96687;31734;11.9;3.9
49;2021-03-29;2371;607;99058;32341;12.1;4.0
49;2021-03-30;3267;938;102325;33279;12.5;4.1
49;2021-03-31;2980;748;105305;34027;12.9;4.2
49;2021-04-01;4118;870;109423;34897;13.4;4.3
49;2021-04-02;4297;954;113720;35851;13.9;4.4
49;2021-04-03;971;193;114691;36044;14.1;4.4
49;2021-04-04;315;3;115006;36047;14.1;4.4
49;2021-04-05;944;22;115950;36069;14.2;4.4
49;2021-04-06;2330;1318;118280;37387;14.5;4.6
49;2021-04-07;3308;1365;121588;38752;14.9;4.7
49;2021-04-08;5184;1424;126772;40176;15.5;4.9
49;2021-04-09;6207;1440;132979;41616;16.3;5.1
49;2021-04-10;2065;500;135044;42116;16.6;5.2
49;2021-04-11;390;9;135434;42125;16.6;5.2
49;2021-04-12;4073;1575;139507;43700;17.1;5.4
49;2021-04-13;5380;1913;144887;45613;17.8;5.6
49;2021-04-14;4542;1877;149429;47490;18.3;5.8
49;2021-04-15;5381;1880;154810;49370;19.0;6.1
49;2021-04-16;5761;2137;160571;51507;19.7;6.3
49;2021-04-17;3335;852;163906;52359;20.1;6.4
49;2021-04-18;381;476;164287;52835;20.1;6.5
49;2021-04-19;3710;2058;167997;54893;20.6;6.7
49;2021-04-20;4371;2111;172368;57004;21.1;7.0
49;2021-04-21;3955;2203;176323;59207;21.6;7.3
49;2021-04-22;4836;2111;181159;61318;22.2;7.5
49;2021-04-23;4814;2335;185973;63653;22.8;7.8
49;2021-04-24;2938;1154;188911;64807;23.2;7.9
49;2021-04-25;40;282;188951;65089;23.2;8.0
49;2021-04-26;3744;2109;192695;67198;23.6;8.2
49;2021-04-27;4472;2496;197167;69694;24.2;8.5
49;2021-04-28;4616;2498;201783;72192;24.7;8.8
49;2021-04-29;5206;3014;206989;75206;25.4;9.2
49;2021-04-30;5558;3196;212547;78402;26.1;9.6
49;2021-05-01;2364;665;214911;79067;26.3;9.7
49;2021-05-02;5;40;214916;79107;26.3;9.7
49;2021-05-03;5012;2407;219928;81514;27.0;10.0
49;2021-05-04;4972;3036;224900;84550;27.6;10.4
49;2021-05-05;4789;3005;229689;87555;28.2;10.7
49;2021-05-06;5328;3094;235017;90649;28.8;11.1
49;2021-05-07;4281;5008;239298;95657;29.3;11.7
49;2021-05-08;3577;438;242875;96095;29.8;11.8
49;2021-05-09;10;41;242885;96136;29.8;11.8
49;2021-05-10;4829;4270;247714;100406;30.4;12.3
49;2021-05-11;5397;5083;253111;105489;31.0;12.9
49;2021-05-12;4800;4590;257911;110079;31.6;13.5
49;2021-05-13;4778;691;262689;110770;32.2;13.6
49;2021-05-14;5170;3268;267859;114038;32.8;14.0
49;2021-05-15;4157;1806;272016;115844;33.3;14.2
49;2021-05-16;2786;117;274802;115961;33.7;14.2
49;2021-05-17;4835;3683;279637;119644;34.3;14.7
49;2021-05-18;5472;3767;285109;123411;34.9;15.1
49;2021-05-19;5916;3229;291025;126640;35.7;15.5
49;2021-05-20;6807;2965;297832;129605;36.5;15.9
49;2021-05-21;6450;3744;304282;133349;37.3;16.3
49;2021-05-22;5183;1193;309465;134542;37.9;16.5
49;2021-05-23;1;12;309466;134554;37.9;16.5
49;2021-05-24;4212;448;313678;135002;38.4;16.5
49;2021-05-25;6326;3294;320004;138296;39.2;17.0
49;2021-05-26;6273;2664;326277;140960;40.0;17.3
49;2021-05-27;7113;2724;333390;143684;40.9;17.6
49;2021-05-28;6875;4005;340265;147689;41.7;18.1
49;2021-05-29;5023;1895;345288;149584;42.3;18.3
49;2021-05-30;21;14;345309;149598;42.3;18.3
49;2021-05-31;6036;3216;351345;152814;43.1;18.7
49;2021-06-01;6592;3979;357937;156793;43.9;19.2
49;2021-06-02;5794;3738;363731;160531;44.6;19.7
49;2021-06-03;6603;3416;370334;163947;45.4;20.1
49;2021-06-04;6470;4861;376804;168808;46.2;20.7
49;2021-06-05;4384;2694;381188;171502;46.7;21.0
49;2021-06-06;38;48;381226;171550;46.7;21.0
49;2021-06-07;4634;4759;385860;176309;47.3;21.6
49;2021-06-08;5185;5103;391045;181412;47.9;22.2
49;2021-06-09;5325;4504;396370;185916;48.6;22.8
49;2021-06-10;6005;3781;402375;189697;49.3;23.3
49;2021-06-11;4873;6030;407248;195727;49.9;24.0
49;2021-06-12;4097;3200;411345;198927;50.4;24.4
49;2021-06-13;20;989;411365;199916;50.4;24.5
49;2021-06-14;3411;6015;414776;205931;50.8;25.2
49;2021-06-15;4241;6392;419017;212323;51.4;26.0
49;2021-06-16;4150;5677;423167;218000;51.9;26.7
49;2021-06-17;5069;5076;428236;223076;52.5;27.3
49;2021-06-18;4134;6885;432370;229961;53.0;28.2
49;2021-06-19;3525;3971;435895;233932;53.4;28.7
49;2021-06-20;33;25;435928;233957;53.4;28.7
49;2021-06-21;2828;6509;438756;240466;53.8;29.5
49;2021-06-22;3208;7004;441964;247470;54.2;30.3
49;2021-06-23;3253;6311;445217;253781;54.6;31.1
49;2021-06-24;4316;4975;449533;258756;55.1;31.7
49;2021-06-25;3325;7447;452858;266203;55.5;32.6
49;2021-06-26;2570;4625;455428;270828;55.8;33.2
49;2021-06-27;15;1544;455443;272372;55.8;33.4
49;2021-06-28;2234;7181;457677;279553;56.1;34.3
49;2021-06-29;3028;7270;460705;286823;56.5;35.2
49;2021-06-30;2824;6803;463529;293626;56.8;36.0
49;2021-07-01;3393;6273;466922;299899;57.2;36.8
49;2021-07-02;3063;8066;469985;307965;57.6;37.7
49;2021-07-03;2007;5486;471992;313451;57.9;38.4
49;2021-07-04;7;53;471999;313504;57.9;38.4
49;2021-07-05;1738;7079;473737;320583;58.1;39.3
49;2021-07-06;1894;7550;475631;328133;58.3;40.2
49;2021-07-07;2099;6622;477730;334755;58.6;41.0
49;2021-07-08;2689;6357;480419;341112;58.9;41.8
49;2021-07-09;2361;8246;482780;349358;59.2;42.8
49;2021-07-10;1802;5344;484582;354702;59.4;43.5
49;2021-07-11;12;35;484594;354737;59.4;43.5
49;2021-07-12;1947;7713;486541;362450;59.6;44.4
49;2021-07-13;2572;8301;489113;370751;59.9;45.4
49;2021-07-14;2893;3373;492006;374124;60.3;45.9
49;2021-07-15;3165;7552;495171;381676;60.7;46.8
49;2021-07-16;3396;8293;498567;389969;61.1;47.8
49;2021-07-17;2103;5479;500670;395448;61.4;48.5
49;2021-07-18;3751;583;504421;396031;61.8;48.5
49;2021-07-19;2666;7450;507087;403481;62.2;49.5
49;2021-07-20;3588;7481;510675;410962;62.6;50.4
49;2021-07-21;4228;6463;514903;417425;63.1;51.2
49;2021-07-22;4815;5865;519718;423290;63.7;51.9
49;2021-07-23;5111;6624;524829;429914;64.3;52.7
49;2021-07-24;3690;5002;528519;434916;64.8;53.3
49;2021-07-25;67;33;528586;434949;64.8;53.3
49;2021-07-26;4517;5901;533103;440850;65.3;54.0
49;2021-07-27;5753;5443;538856;446293;66.0;54.7
49;2021-07-28;6019;4360;544875;450653;66.8;55.2
49;2021-07-29;6702;4154;551577;454807;67.6;55.7
49;2021-07-30;6173;4788;557750;459595;68.4;56.3
49;2021-07-31;3958;3421;561708;463016;68.8;56.8
49;2021-08-01;21;22;561729;463038;68.8;56.8
49;2021-08-02;4271;4657;566000;467695;69.4;57.3
49;2021-08-03;5434;3801;571434;471496;70.0;57.8
49;2021-08-04;5276;3718;576710;475214;70.7;58.2
49;2021-08-05;5307;3289;582017;478503;71.3;58.6
49;2021-08-06;5718;4283;587735;482786;72.0;59.2
49;2021-08-07;3925;3044;591660;485830;72.5;59.5
49;2021-08-08;24;36;591684;485866;72.5;59.6
49;2021-08-09;3501;4682;595185;490548;72.9;60.1
49;2021-08-10;4250;3900;599435;494448;73.5;60.6
49;2021-08-11;4007;3652;603442;498100;74.0;61.1
49;2021-08-12;2665;3055;606107;501155;74.3;61.4
49;2021-08-13;3926;4271;610033;505426;74.8;61.9
49;2021-08-14;2279;3149;612312;508575;75.0;62.3
49;2021-08-15;30;26;612342;508601;75.1;62.3
49;2021-08-16;2831;5061;615173;513662;75.4;63.0
49;2021-08-17;3281;4911;618454;518573;75.8;63.6
49;2021-08-18;2977;4114;621431;522687;76.2;64.1
49;2021-08-19;1549;3663;622980;526350;76.4;64.5
49;2021-08-20;2731;5771;625711;532121;76.7;65.2
49;2021-08-21;1399;4150;627110;536271;76.9;65.7
49;2021-08-22;6;41;627116;536312;76.9;65.7
49;2021-08-23;2257;5627;629373;541939;77.1;66.4
49;2021-08-24;2747;5787;632120;547726;77.5;67.1
49;2021-08-25;2330;5430;634450;553156;77.8;67.8
49;2021-08-26;1716;4827;636166;557983;78.0;68.4
49;2021-08-27;2456;6813;638622;564796;78.3;69.2
49;2021-08-28;906;4302;639528;569098;78.4;69.8
49;2021-08-29;5;94;639533;569192;78.4;69.8
49;2021-08-30;1155;4295;640688;573487;78.5;70.3
49;2021-08-31;2248;6002;642936;579489;78.8;71.0
49;2021-09-01;1683;4454;644619;583943;79.0;71.6
49;2021-09-02;1063;2807;645682;586750;79.1;71.9
49;2021-09-03;1460;4186;647142;590936;79.3;72.4
49;2021-09-04;1208;3574;648350;594510;79.5;72.9
49;2021-09-05;4;9;648354;594519;79.5;72.9
49;2021-09-06;1098;2945;649452;597464;79.6;73.2
49;2021-09-07;1189;2887;650641;600351;79.7;73.6
49;2021-09-08;984;3323;651625;603674;79.9;74.0
49;2021-09-09;770;1777;652395;605451;80.0;74.2
49;2021-09-10;972;3069;653367;608520;80.1;74.6
49;2021-09-11;726;2643;654093;611163;80.2;74.9
49;2021-09-12;11;8;654104;611171;80.2;74.9
49;2021-09-13;741;2542;654845;613713;80.3;75.2
49;2021-09-14;638;2303;655483;616016;80.3;75.5
49;2021-09-15;618;2227;656101;618243;80.4;75.8
49;2021-09-16;522;1288;656623;619531;80.5;75.9
49;2021-09-17;929;2516;657552;622047;80.6;76.2
49;2021-09-18;541;2005;658093;624052;80.7;76.5
49;2021-09-19;2;8;658095;624060;80.7;76.5
49;2021-09-20;512;1245;658607;625305;80.7;76.6
49;2021-09-21;432;1598;659039;626903;80.8;76.8
49;2021-09-22;336;1996;659375;628899;80.8;77.1
49;2021-09-23;324;1161;659699;630060;80.9;77.2
49;2021-09-24;566;2242;660265;632302;80.9;77.5
49;2021-09-25;197;1014;660462;633316;81.0;77.6
49;2021-09-26;0;0;660462;633316;81.0;77.6
49;2021-09-27;384;1374;660846;634690;81.0;77.8
49;2021-09-28;413;1062;661259;635752;81.0;77.9
49;2021-09-29;376;1240;661635;636992;81.1;78.1
49;2021-09-30;318;706;661953;637698;81.1;78.2
49;2021-10-01;543;1503;662496;639201;81.2;78.3
49;2021-10-02;350;1128;662846;640329;81.2;78.5
49;2021-10-03;4;13;662850;640342;81.2;78.5
50;2020-12-27;0;0;0;0;0.0;0.0
50;2020-12-28;0;0;0;0;0.0;0.0
50;2020-12-29;1;0;1;0;0.0;0.0
50;2020-12-30;0;0;1;0;0.0;0.0
50;2020-12-31;0;0;1;0;0.0;0.0
50;2021-01-01;0;0;1;0;0.0;0.0
50;2021-01-02;0;0;1;0;0.0;0.0
50;2021-01-03;0;0;1;0;0.0;0.0
50;2021-01-04;1;0;2;0;0.0;0.0
50;2021-01-05;0;0;2;0;0.0;0.0
50;2021-01-06;126;0;128;0;0.0;0.0
50;2021-01-07;324;0;452;0;0.1;0.0
50;2021-01-08;436;2;888;2;0.2;0.0
50;2021-01-09;236;0;1124;2;0.2;0.0
50;2021-01-10;23;0;1147;2;0.2;0.0
50;2021-01-11;391;1;1538;3;0.3;0.0
50;2021-01-12;599;0;2137;3;0.4;0.0
50;2021-01-13;695;5;2832;8;0.6;0.0
50;2021-01-14;1051;11;3883;19;0.8;0.0
50;2021-01-15;710;3;4593;22;0.9;0.0
50;2021-01-16;215;3;4808;25;1.0;0.0
50;2021-01-17;1;0;4809;25;1.0;0.0
50;2021-01-18;620;1;5429;26;1.1;0.0
50;2021-01-19;902;3;6331;29;1.3;0.0
50;2021-01-20;964;0;7295;29;1.5;0.0
50;2021-01-21;917;4;8212;33;1.7;0.0
50;2021-01-22;716;2;8928;35;1.8;0.0
50;2021-01-23;668;4;9596;39;2.0;0.0
50;2021-01-24;881;3;10477;42;2.1;0.0
50;2021-01-25;2709;8;13186;50;2.7;0.0
50;2021-01-26;1336;14;14522;64;3.0;0.0
50;2021-01-27;768;56;15290;120;3.1;0.0
50;2021-01-28;716;161;16006;281;3.3;0.1
50;2021-01-29;581;290;16587;571;3.4;0.1
50;2021-01-30;381;137;16968;708;3.5;0.1
50;2021-01-31;0;0;16968;708;3.5;0.1
50;2021-02-01;451;209;17419;917;3.6;0.2
50;2021-02-02;417;224;17836;1141;3.6;0.2
50;2021-02-03;391;366;18227;1507;3.7;0.3
50;2021-02-04;486;421;18713;1928;3.8;0.4
50;2021-02-05;425;425;19138;2353;3.9;0.5
50;2021-02-06;179;104;19317;2457;3.9;0.5
50;2021-02-07;0;0;19317;2457;3.9;0.5
50;2021-02-08;254;432;19571;2889;4.0;0.6
50;2021-02-09;246;548;19817;3437;4.0;0.7
50;2021-02-10;571;469;20388;3906;4.2;0.8
50;2021-02-11;436;830;20824;4736;4.2;1.0
50;2021-02-12;329;576;21153;5312;4.3;1.1
50;2021-02-13;306;413;21459;5725;4.4;1.2
50;2021-02-14;185;732;21644;6457;4.4;1.3
50;2021-02-15;664;1774;22308;8231;4.5;1.7
50;2021-02-16;746;1452;23054;9683;4.7;2.0
50;2021-02-17;632;673;23686;10356;4.8;2.1
50;2021-02-18;569;685;24255;11041;4.9;2.3
50;2021-02-19;630;393;24885;11434;5.1;2.3
50;2021-02-20;423;128;25308;11562;5.2;2.4
50;2021-02-21;85;21;25393;11583;5.2;2.4
50;2021-02-22;291;569;25684;12152;5.2;2.5
50;2021-02-23;503;431;26187;12583;5.3;2.6
50;2021-02-24;624;489;26811;13072;5.5;2.7
50;2021-02-25;780;478;27591;13550;5.6;2.8
50;2021-02-26;998;318;28589;13868;5.8;2.8
50;2021-02-27;887;97;29476;13965;6.0;2.8
50;2021-02-28;111;0;29587;13965;6.0;2.8
50;2021-03-01;488;447;30075;14412;6.1;2.9
50;2021-03-02;651;431;30726;14843;6.3;3.0
50;2021-03-03;798;381;31524;15224;6.4;3.1
50;2021-03-04;1247;289;32771;15513;6.7;3.2
50;2021-03-05;1553;296;34324;15809;7.0;3.2
50;2021-03-06;1319;137;35643;15946;7.3;3.2
50;2021-03-07;550;39;36193;15985;7.4;3.3
50;2021-03-08;1025;572;37218;16557;7.6;3.4
50;2021-03-09;1555;544;38773;17101;7.9;3.5
50;2021-03-10;1607;293;40380;17394;8.2;3.5
50;2021-03-11;2352;338;42732;17732;8.7;3.6
50;2021-03-12;2866;239;45598;17971;9.3;3.7
50;2021-03-13;1995;125;47593;18096;9.7;3.7
50;2021-03-14;280;41;47873;18137;9.8;3.7
50;2021-03-15;1378;291;49251;18428;10.0;3.8
50;2021-03-16;1341;275;50592;18703;10.3;3.8
50;2021-03-17;1296;404;51888;19107;10.6;3.9
50;2021-03-18;1162;427;53050;19534;10.8;4.0
50;2021-03-19;1733;576;54783;20110;11.2;4.1
50;2021-03-20;1688;230;56471;20340;11.5;4.1
50;2021-03-21;794;12;57265;20352;11.7;4.1
50;2021-03-22;1508;334;58773;20686;12.0;4.2
50;2021-03-23;2078;399;60851;21085;12.4;4.3
50;2021-03-24;2281;551;63132;21636;12.9;4.4
50;2021-03-25;2813;472;65945;22108;13.4;4.5
50;2021-03-26;3205;470;69150;22578;14.1;4.6
50;2021-03-27;1823;373;70973;22951;14.5;4.7
50;2021-03-28;403;20;71376;22971;14.5;4.7
50;2021-03-29;2139;717;73515;23688;15.0;4.8
50;2021-03-30;2283;641;75798;24329;15.4;5.0
50;2021-03-31;2479;570;78277;24899;16.0;5.1
50;2021-04-01;3104;866;81381;25765;16.6;5.3
50;2021-04-02;2960;928;84341;26693;17.2;5.4
50;2021-04-03;1245;674;85586;27367;17.4;5.6
50;2021-04-04;321;134;85907;27501;17.5;5.6
50;2021-04-05;400;27;86307;27528;17.6;5.6
50;2021-04-06;2127;1222;88434;28750;18.0;5.9
50;2021-04-07;2556;1175;90990;29925;18.5;6.1
50;2021-04-08;3595;1207;94585;31132;19.3;6.3
50;2021-04-09;3936;1300;98521;32432;20.1;6.6
50;2021-04-10;2534;873;101055;33305;20.6;6.8
50;2021-04-11;411;144;101466;33449;20.7;6.8
50;2021-04-12;2438;1377;103904;34826;21.2;7.1
50;2021-04-13;2678;1511;106582;36337;21.7;7.4
50;2021-04-14;2608;1355;109190;37692;22.3;7.7
50;2021-04-15;3161;1115;112351;38807;22.9;7.9
50;2021-04-16;3363;1103;115714;39910;23.6;8.1
50;2021-04-17;2397;1185;118111;41095;24.1;8.4
50;2021-04-18;425;665;118536;41760;24.2;8.5
50;2021-04-19;1996;1469;120532;43229;24.6;8.8
50;2021-04-20;2273;1589;122805;44818;25.0;9.1
50;2021-04-21;2548;1758;125353;46576;25.5;9.5
50;2021-04-22;3078;1825;128431;48401;26.2;9.9
50;2021-04-23;2757;1917;131188;50318;26.7;10.3
50;2021-04-24;1900;1429;133088;51747;27.1;10.5
50;2021-04-25;470;272;133558;52019;27.2;10.6
50;2021-04-26;2119;1878;135677;53897;27.7;11.0
50;2021-04-27;2412;1996;138089;55893;28.1;11.4
50;2021-04-28;2708;1972;140797;57865;28.7;11.8
50;2021-04-29;3286;2041;144083;59906;29.4;12.2
50;2021-04-30;2999;1923;147082;61829;30.0;12.6
50;2021-05-01;1015;596;148097;62425;30.2;12.7
50;2021-05-02;523;448;148620;62873;30.3;12.8
50;2021-05-03;1771;1805;150391;64678;30.7;13.2
50;2021-05-04;1771;2330;152162;67008;31.0;13.7
50;2021-05-05;1659;2952;153821;69960;31.3;14.3
50;2021-05-06;2530;2579;156351;72539;31.9;14.8
50;2021-05-07;2150;2850;158501;75389;32.3;15.4
50;2021-05-08;1170;792;159671;76181;32.5;15.5
50;2021-05-09;624;361;160295;76542;32.7;15.6
50;2021-05-10;1705;2603;162000;79145;33.0;16.1
50;2021-05-11;2542;2836;164542;81981;33.5;16.7
50;2021-05-12;3179;2438;167721;84419;34.2;17.2
50;2021-05-13;3382;613;171103;85032;34.9;17.3
50;2021-05-14;3568;2274;174671;87306;35.6;17.8
50;2021-05-15;4001;1870;178672;89176;36.4;18.2
50;2021-05-16;947;267;179619;89443;36.6;18.2
50;2021-05-17;2140;1878;181759;91321;37.0;18.6
50;2021-05-18;2523;1614;184282;92935;37.6;18.9
50;2021-05-19;2503;1447;186785;94382;38.1;19.2
50;2021-05-20;3261;1624;190046;96006;38.7;19.6
50;2021-05-21;3156;1908;193202;97914;39.4;20.0
50;2021-05-22;2651;1323;195853;99237;39.9;20.2
50;2021-05-23;603;284;196456;99521;40.0;20.3
50;2021-05-24;1527;490;197983;100011;40.3;20.4
50;2021-05-25;2450;1668;200433;101679;40.8;20.7
50;2021-05-26;3003;1458;203436;103137;41.5;21.0
50;2021-05-27;3035;1969;206471;105106;42.1;21.4
50;2021-05-28;2941;2111;209412;107217;42.7;21.9
50;2021-05-29;2760;1402;212172;108619;43.2;22.1
50;2021-05-30;812;327;212984;108946;43.4;22.2
50;2021-05-31;2652;1815;215636;110761;43.9;22.6
50;2021-06-01;3333;2066;218969;112827;44.6;23.0
50;2021-06-02;3259;1782;222228;114609;45.3;23.4
50;2021-06-03;3914;2059;226142;116668;46.1;23.8
50;2021-06-04;3822;2874;229964;119542;46.9;24.4
50;2021-06-05;2958;1837;232922;121379;47.5;24.7
50;2021-06-06;813;442;233735;121821;47.6;24.8
50;2021-06-07;3512;2078;237247;123899;48.4;25.3
50;2021-06-08;4072;2228;241319;126127;49.2;25.7
50;2021-06-09;4253;1987;245572;128114;50.0;26.1
50;2021-06-10;4193;2113;249765;130227;50.9;26.5
50;2021-06-11;4224;2712;253989;132939;51.8;27.1
50;2021-06-12;3738;1613;257727;134552;52.5;27.4
50;2021-06-13;1143;451;258870;135003;52.8;27.5
50;2021-06-14;2693;2967;261563;137970;53.3;28.1
50;2021-06-15;3016;2599;264579;140569;53.9;28.6
50;2021-06-16;3096;1970;267675;142539;54.6;29.0
50;2021-06-17;2798;2484;270473;145023;55.1;29.6
50;2021-06-18;3239;3051;273712;148074;55.8;30.2
50;2021-06-19;3176;1925;276888;149999;56.4;30.6
50;2021-06-20;731;710;277619;150709;56.6;30.7
50;2021-06-21;1819;3129;279438;153838;57.0;31.4
50;2021-06-22;2064;3389;281502;157227;57.4;32.0
50;2021-06-23;1872;3875;283374;161102;57.8;32.8
50;2021-06-24;1711;4007;285085;165109;58.1;33.6
50;2021-06-25;2134;4007;287219;169116;58.5;34.5
50;2021-06-26;2147;3692;289366;172808;59.0;35.2
50;2021-06-27;615;895;289981;173703;59.1;35.4
50;2021-06-28;1927;3349;291908;177052;59.5;36.1
50;2021-06-29;1881;3406;293789;180458;59.9;36.8
50;2021-06-30;2180;3408;295969;183866;60.3;37.5
50;2021-07-01;1944;3283;297913;187149;60.7;38.1
50;2021-07-02;1898;3934;299811;191083;61.1;38.9
50;2021-07-03;1448;3445;301259;194528;61.4;39.6
50;2021-07-04;445;1066;301704;195594;61.5;39.9
50;2021-07-05;1262;3412;302966;199006;61.7;40.6
50;2021-07-06;1573;3896;304539;202902;62.1;41.4
50;2021-07-07;1804;3617;306343;206519;62.4;42.1
50;2021-07-08;1375;4101;307718;210620;62.7;42.9
50;2021-07-09;1394;4570;309112;215190;63.0;43.9
50;2021-07-10;1023;3599;310135;218789;63.2;44.6
50;2021-07-11;373;1018;310508;219807;63.3;44.8
50;2021-07-12;1317;4623;311825;224430;63.6;45.7
50;2021-07-13;1624;4856;313449;229286;63.9;46.7
50;2021-07-14;1476;2358;314925;231644;64.2;47.2
50;2021-07-15;1687;5048;316612;236692;64.5;48.2
50;2021-07-16;2992;5241;319604;241933;65.1;49.3
50;2021-07-17;2149;3732;321753;245665;65.6;50.1
50;2021-07-18;402;1089;322155;246754;65.7;50.3
50;2021-07-19;1571;5185;323726;251939;66.0;51.3
50;2021-07-20;1924;5405;325650;257344;66.4;52.4
50;2021-07-21;1802;5256;327452;262600;66.7;53.5
50;2021-07-22;1947;5002;329399;267602;67.1;54.5
50;2021-07-23;2072;5372;331471;272974;67.6;55.6
50;2021-07-24;1311;3836;332782;276810;67.8;56.4
50;2021-07-25;274;1037;333056;277847;67.9;56.6
50;2021-07-26;2290;3487;335346;281334;68.3;57.3
50;2021-07-27;2899;3346;338245;284680;68.9;58.0
50;2021-07-28;2998;3687;341243;288367;69.5;58.8
50;2021-07-29;3581;3220;344824;291587;70.3;59.4
50;2021-07-30;3075;3005;347899;294592;70.9;60.0
50;2021-07-31;2406;2672;350305;297264;71.4;60.6
50;2021-08-01;484;685;350789;297949;71.5;60.7
50;2021-08-02;2474;2739;353263;300688;72.0;61.3
50;2021-08-03;3404;2470;356667;303158;72.7;61.8
50;2021-08-04;3601;2322;360268;305480;73.4;62.3
50;2021-08-05;3189;2159;363457;307639;74.1;62.7
50;2021-08-06;3657;2800;367114;310439;74.8;63.3
50;2021-08-07;2462;2156;369576;312595;75.3;63.7
50;2021-08-08;511;712;370087;313307;75.4;63.9
50;2021-08-09;2493;2134;372580;315441;75.9;64.3
50;2021-08-10;2987;1989;375567;317430;76.5;64.7
50;2021-08-11;2851;2018;378418;319448;77.1;65.1
50;2021-08-12;2595;2438;381013;321886;77.7;65.6
50;2021-08-13;2506;1979;383519;323865;78.2;66.0
50;2021-08-14;1810;1748;385329;325613;78.5;66.4
50;2021-08-15;399;334;385728;325947;78.6;66.4
50;2021-08-16;1719;2227;387447;328174;79.0;66.9
50;2021-08-17;1973;2703;389420;330877;79.4;67.4
50;2021-08-18;1842;2389;391262;333266;79.7;67.9
50;2021-08-19;1708;2577;392970;335843;80.1;68.4
50;2021-08-20;1619;2738;394589;338581;80.4;69.0
50;2021-08-21;1016;2727;395605;341308;80.6;69.6
50;2021-08-22;384;519;395989;341827;80.7;69.7
50;2021-08-23;1137;2905;397126;344732;80.9;70.3
50;2021-08-24;1246;3222;398372;347954;81.2;70.9
50;2021-08-25;1091;2649;399463;350603;81.4;71.5
50;2021-08-26;865;3156;400328;353759;81.6;72.1
50;2021-08-27;936;3181;401264;356940;81.8;72.7
50;2021-08-28;792;2887;402056;359827;81.9;73.3
50;2021-08-29;283;575;402339;360402;82.0;73.5
50;2021-08-30;775;2948;403114;363350;82.2;74.1
50;2021-08-31;821;3034;403935;366384;82.3;74.7
50;2021-09-01;683;2889;404618;369273;82.5;75.3
50;2021-09-02;528;2541;405146;371814;82.6;75.8
50;2021-09-03;691;2878;405837;374692;82.7;76.4
50;2021-09-04;621;2992;406458;377684;82.8;77.0
50;2021-09-05;194;741;406652;378425;82.9;77.1
50;2021-09-06;379;2192;407031;380617;83.0;77.6
50;2021-09-07;296;1753;407327;382370;83.0;77.9
50;2021-09-08;466;2131;407793;384501;83.1;78.4
50;2021-09-09;384;1493;408177;385994;83.2;78.7
50;2021-09-10;496;2019;408673;388013;83.3;79.1
50;2021-09-11;365;2427;409038;390440;83.4;79.6
50;2021-09-12;71;387;409109;390827;83.4;79.7
50;2021-09-13;409;1386;409518;392213;83.5;79.9
50;2021-09-14;411;1383;409929;393596;83.5;80.2
50;2021-09-15;414;1087;410343;394683;83.6;80.4
50;2021-09-16;461;747;410804;395430;83.7;80.6
50;2021-09-17;456;1030;411260;396460;83.8;80.8
50;2021-09-18;313;1467;411573;397927;83.9;81.1
50;2021-09-19;46;276;411619;398203;83.9;81.2
50;2021-09-20;381;588;412000;398791;84.0;81.3
50;2021-09-21;431;623;412431;399414;84.1;81.4
50;2021-09-22;216;867;412647;400281;84.1;81.6
50;2021-09-23;267;450;412914;400731;84.2;81.7
50;2021-09-24;252;819;413166;401550;84.2;81.8
50;2021-09-25;213;934;413379;402484;84.2;82.0
50;2021-09-26;20;181;413399;402665;84.3;82.1
50;2021-09-27;103;385;413502;403050;84.3;82.1
50;2021-09-28;158;384;413660;403434;84.3;82.2
50;2021-09-29;152;520;413812;403954;84.3;82.3
50;2021-09-30;163;422;413975;404376;84.4;82.4
50;2021-10-01;205;592;414180;404968;84.4;82.5
50;2021-10-02;223;540;414403;405508;84.5;82.6
50;2021-10-03;2;5;414405;405513;84.5;82.6
51;2020-12-27;0;0;0;0;0.0;0.0
51;2020-12-28;0;0;0;0;0.0;0.0
51;2020-12-29;0;0;0;0;0.0;0.0
51;2020-12-30;0;0;0;0;0.0;0.0
51;2020-12-31;1;0;1;0;0.0;0.0
51;2021-01-01;0;0;1;0;0.0;0.0
51;2021-01-02;0;0;1;0;0.0;0.0
51;2021-01-03;0;0;1;0;0.0;0.0
51;2021-01-04;1;0;2;0;0.0;0.0
51;2021-01-05;1;0;3;0;0.0;0.0
51;2021-01-06;6;0;9;0;0.0;0.0
51;2021-01-07;262;1;271;1;0.0;0.0
51;2021-01-08;508;1;779;2;0.1;0.0
51;2021-01-09;91;0;870;2;0.2;0.0
51;2021-01-10;0;0;870;2;0.2;0.0
51;2021-01-11;545;2;1415;4;0.3;0.0
51;2021-01-12;1542;4;2957;8;0.5;0.0
51;2021-01-13;1289;5;4246;13;0.8;0.0
51;2021-01-14;1475;6;5721;19;1.0;0.0
51;2021-01-15;607;3;6328;22;1.1;0.0
51;2021-01-16;177;1;6505;23;1.2;0.0
51;2021-01-17;102;0;6607;23;1.2;0.0
51;2021-01-18;845;3;7452;26;1.3;0.0
51;2021-01-19;997;2;8449;28;1.5;0.0
51;2021-01-20;955;7;9404;35;1.7;0.0
51;2021-01-21;790;2;10194;37;1.8;0.0
51;2021-01-22;393;2;10587;39;1.9;0.0
51;2021-01-23;294;0;10881;39;1.9;0.0
51;2021-01-24;130;1;11011;40;2.0;0.0
51;2021-01-25;712;3;11723;43;2.1;0.0
51;2021-01-26;779;5;12502;48;2.2;0.0
51;2021-01-27;656;2;13158;50;2.3;0.0
51;2021-01-28;646;54;13804;104;2.4;0.0
51;2021-01-29;474;141;14278;245;2.5;0.0
51;2021-01-30;126;5;14404;250;2.6;0.0
51;2021-01-31;83;0;14487;250;2.6;0.0
51;2021-02-01;275;58;14762;308;2.6;0.1
51;2021-02-02;738;622;15500;930;2.7;0.2
51;2021-02-03;642;454;16142;1384;2.9;0.2
51;2021-02-04;968;733;17110;2117;3.0;0.4
51;2021-02-05;973;473;18083;2590;3.2;0.5
51;2021-02-06;30;136;18113;2726;3.2;0.5
51;2021-02-07;0;18;18113;2744;3.2;0.5
51;2021-02-08;115;392;18228;3136;3.2;0.6
51;2021-02-09;222;454;18450;3590;3.3;0.6
51;2021-02-10;220;599;18670;4189;3.3;0.7
51;2021-02-11;302;491;18972;4680;3.4;0.8
51;2021-02-12;341;489;19313;5169;3.4;0.9
51;2021-02-13;8;94;19321;5263;3.4;0.9
51;2021-02-14;8;119;19329;5382;3.4;1.0
51;2021-02-15;265;592;19594;5974;3.5;1.1
51;2021-02-16;402;762;19996;6736;3.5;1.2
51;2021-02-17;367;694;20363;7430;3.6;1.3
51;2021-02-18;437;469;20800;7899;3.7;1.4
51;2021-02-19;529;380;21329;8279;3.8;1.5
51;2021-02-20;205;264;21534;8543;3.8;1.5
51;2021-02-21;10;93;21544;8636;3.8;1.5
51;2021-02-22;195;544;21739;9180;3.9;1.6
51;2021-02-23;262;915;22001;10095;3.9;1.8
51;2021-02-24;414;554;22415;10649;4.0;1.9
51;2021-02-25;1049;780;23464;11429;4.2;2.0
51;2021-02-26;1228;601;24692;12030;4.4;2.1
51;2021-02-27;590;96;25282;12126;4.5;2.2
51;2021-02-28;7;52;25289;12178;4.5;2.2
51;2021-03-01;768;280;26057;12458;4.6;2.2
51;2021-03-02;1128;415;27185;12873;4.8;2.3
51;2021-03-03;1194;388;28379;13261;5.0;2.4
51;2021-03-04;1061;630;29440;13891;5.2;2.5
51;2021-03-05;1560;567;31000;14458;5.5;2.6
51;2021-03-06;1433;56;32433;14514;5.8;2.6
51;2021-03-07;251;5;32684;14519;5.8;2.6
51;2021-03-08;992;98;33676;14617;6.0;2.6
51;2021-03-09;1666;180;35342;14797;6.3;2.6
51;2021-03-10;1996;103;37338;14900;6.6;2.6
51;2021-03-11;2371;168;39709;15068;7.0;2.7
51;2021-03-12;3255;148;42964;15216;7.6;2.7
51;2021-03-13;2550;49;45514;15265;8.1;2.7
51;2021-03-14;190;5;45704;15270;8.1;2.7
51;2021-03-15;1580;150;47284;15420;8.4;2.7
51;2021-03-16;1478;182;48762;15602;8.6;2.8
51;2021-03-17;1497;206;50259;15808;8.9;2.8
51;2021-03-18;1615;287;51874;16095;9.2;2.9
51;2021-03-19;2311;296;54185;16391;9.6;2.9
51;2021-03-20;1661;216;55846;16607;9.9;2.9
51;2021-03-21;133;4;55979;16611;9.9;2.9
51;2021-03-22;1416;125;57395;16736;10.2;3.0
51;2021-03-23;2469;160;59864;16896;10.6;3.0
51;2021-03-24;2846;131;62710;17027;11.1;3.0
51;2021-03-25;3254;331;65964;17358;11.7;3.1
51;2021-03-26;3411;501;69375;17859;12.3;3.2
51;2021-03-27;1842;249;71217;18108;12.6;3.2
51;2021-03-28;213;3;71430;18111;12.7;3.2
51;2021-03-29;991;629;72421;18740;12.8;3.3
51;2021-03-30;1748;851;74169;19591;13.2;3.5
51;2021-03-31;1738;748;75907;20339;13.5;3.6
51;2021-04-01;2282;449;78189;20788;13.9;3.7
51;2021-04-02;2425;641;80614;21429;14.3;3.8
51;2021-04-03;1301;411;81915;21840;14.5;3.9
51;2021-04-04;106;2;82021;21842;14.5;3.9
51;2021-04-05;72;138;82093;21980;14.6;3.9
51;2021-04-06;763;1230;82856;23210;14.7;4.1
51;2021-04-07;1312;1407;84168;24617;14.9;4.4
51;2021-04-08;2204;1771;86372;26388;15.3;4.7
51;2021-04-09;2862;1724;89234;28112;15.8;5.0
51;2021-04-10;2219;496;91453;28608;16.2;5.1
51;2021-04-11;105;85;91558;28693;16.2;5.1
51;2021-04-12;1450;1338;93008;30031;16.5;5.3
51;2021-04-13;1936;1670;94944;31701;16.8;5.6
51;2021-04-14;2460;1549;97404;33250;17.3;5.9
51;2021-04-15;2856;1672;100260;34922;17.8;6.2
51;2021-04-16;3214;1600;103474;36522;18.4;6.5
51;2021-04-17;1966;775;105440;37297;18.7;6.6
51;2021-04-18;296;114;105736;37411;18.8;6.6
51;2021-04-19;1561;1157;107297;38568;19.0;6.8
51;2021-04-20;1791;1661;109088;40229;19.3;7.1
51;2021-04-21;2002;1741;111090;41970;19.7;7.4
51;2021-04-22;2407;1661;113497;43631;20.1;7.7
51;2021-04-23;2982;1823;116479;45454;20.7;8.1
51;2021-04-24;1749;952;118228;46406;21.0;8.2
51;2021-04-25;123;160;118351;46566;21.0;8.3
51;2021-04-26;1851;761;120202;47327;21.3;8.4
51;2021-04-27;2442;1214;122644;48541;21.8;8.6
51;2021-04-28;2552;1290;125196;49831;22.2;8.8
51;2021-04-29;2676;1460;127872;51291;22.7;9.1
51;2021-04-30;2975;1658;130847;52949;23.2;9.4
51;2021-05-01;1453;411;132300;53360;23.5;9.5
51;2021-05-02;107;99;132407;53459;23.5;9.5
51;2021-05-03;2484;754;134891;54213;23.9;9.6
51;2021-05-04;2788;1351;137679;55564;24.4;9.9
51;2021-05-05;2860;1638;140539;57202;24.9;10.1
51;2021-05-06;5344;1950;145883;59152;25.9;10.5
51;2021-05-07;3705;1902;149588;61054;26.5;10.8
51;2021-05-08;2862;815;152450;61869;27.0;11.0
51;2021-05-09;212;92;152662;61961;27.1;11.0
51;2021-05-10;3214;1859;155876;63820;27.6;11.3
51;2021-05-11;3643;2032;159519;65852;28.3;11.7
51;2021-05-12;4182;2233;163701;68085;29.0;12.1
51;2021-05-13;1777;505;165478;68590;29.3;12.2
51;2021-05-14;5401;1740;170879;70330;30.3;12.5
51;2021-05-15;4227;1351;175106;71681;31.1;12.7
51;2021-05-16;284;45;175390;71726;31.1;12.7
51;2021-05-17;3131;1520;178521;73246;31.7;13.0
51;2021-05-18;3918;1760;182439;75006;32.4;13.3
51;2021-05-19;4031;1722;186470;76728;33.1;13.6
51;2021-05-20;4649;1966;191119;78694;33.9;14.0
51;2021-05-21;3597;2463;194716;81157;34.5;14.4
51;2021-05-22;2075;1548;196791;82705;34.9;14.7
51;2021-05-23;308;210;197099;82915;35.0;14.7
51;2021-05-24;2018;720;199117;83635;35.3;14.8
51;2021-05-25;3130;1828;202247;85463;35.9;15.2
51;2021-05-26;3296;1710;205543;87173;36.5;15.5
51;2021-05-27;3267;2056;208810;89229;37.0;15.8
51;2021-05-28;3606;2796;212416;92025;37.7;16.3
51;2021-05-29;2401;1990;214817;94015;38.1;16.7
51;2021-05-30;401;133;215218;94148;38.2;16.7
51;2021-05-31;3348;1767;218566;95915;38.8;17.0
51;2021-06-01;3854;2322;222420;98237;39.4;17.4
51;2021-06-02;6096;2328;228516;100565;40.5;17.8
51;2021-06-03;3580;2424;232096;102989;41.2;18.3
51;2021-06-04;6345;2935;238441;105924;42.3;18.8
51;2021-06-05;2596;1814;241037;107738;42.8;19.1
51;2021-06-06;172;157;241209;107895;42.8;19.1
51;2021-06-07;4302;2164;245511;110059;43.5;19.5
51;2021-06-08;3925;2529;249436;112588;44.2;20.0
51;2021-06-09;4016;2748;253452;115336;45.0;20.5
51;2021-06-10;3208;2485;256660;117821;45.5;20.9
51;2021-06-11;3358;3425;260018;121246;46.1;21.5
51;2021-06-12;2165;2170;262183;123416;46.5;21.9
51;2021-06-13;191;149;262374;123565;46.5;21.9
51;2021-06-14;1627;3327;264001;126892;46.8;22.5
51;2021-06-15;3189;3577;267190;130469;47.4;23.1
51;2021-06-16;2208;3683;269398;134152;47.8;23.8
51;2021-06-17;2609;5399;272007;139551;48.2;24.8
51;2021-06-18;2355;5211;274362;144762;48.7;25.7
51;2021-06-19;1683;4425;276045;149187;49.0;26.5
51;2021-06-20;184;228;276229;149415;49.0;26.5
51;2021-06-21;1231;4435;277460;153850;49.2;27.3
51;2021-06-22;1558;4043;279018;157893;49.5;28.0
51;2021-06-23;3670;4236;282688;162129;50.1;28.8
51;2021-06-24;2246;3224;284934;165353;50.5;29.3
51;2021-06-25;1905;6526;286839;171879;50.9;30.5
51;2021-06-26;1203;5063;288042;176942;51.1;31.4
51;2021-06-27;103;336;288145;177278;51.1;31.4
51;2021-06-28;1401;4413;289546;181691;51.4;32.2
51;2021-06-29;1174;4463;290720;186154;51.6;33.0
51;2021-06-30;1687;6044;292407;192198;51.9;34.1
51;2021-07-01;1978;3765;294385;195963;52.2;34.8
51;2021-07-02;1838;6885;296223;202848;52.5;36.0
51;2021-07-03;1003;3196;297226;206044;52.7;36.5
51;2021-07-04;171;254;297397;206298;52.7;36.6
51;2021-07-05;770;5529;298167;211827;52.9;37.6
51;2021-07-06;1247;4778;299414;216605;53.1;38.4
51;2021-07-07;1617;4934;301031;221539;53.4;39.3
51;2021-07-08;2067;3430;303098;224969;53.8;39.9
51;2021-07-09;1854;5055;304952;230024;54.1;40.8
51;2021-07-10;1238;3205;306190;233229;54.3;41.4
51;2021-07-11;190;281;306380;233510;54.3;41.4
51;2021-07-12;996;4379;307376;237889;54.5;42.2
51;2021-07-13;1480;4770;308856;242659;54.8;43.0
51;2021-07-14;1071;1691;309927;244350;55.0;43.3
51;2021-07-15;2938;4910;312865;249260;55.5;44.2
51;2021-07-16;2365;5273;315230;254533;55.9;45.1
51;2021-07-17;1820;3476;317050;258009;56.2;45.8
51;2021-07-18;163;330;317213;258339;56.3;45.8
51;2021-07-19;1892;3973;319105;262312;56.6;46.5
51;2021-07-20;2585;5143;321690;267455;57.1;47.4
51;2021-07-21;3611;4067;325301;271522;57.7;48.2
51;2021-07-22;4412;3758;329713;275280;58.5;48.8
51;2021-07-23;3640;4377;333353;279657;59.1;49.6
51;2021-07-24;2086;2724;335439;282381;59.5;50.1
51;2021-07-25;356;258;335795;282639;59.6;50.1
51;2021-07-26;3113;2808;338908;285447;60.1;50.6
51;2021-07-27;5863;3273;344771;288720;61.1;51.2
51;2021-07-28;4138;4320;348909;293040;61.9;52.0
51;2021-07-29;4700;2717;353609;295757;62.7;52.5
51;2021-07-30;3628;3155;357237;298912;63.4;53.0
51;2021-07-31;2526;2131;359763;301043;63.8;53.4
51;2021-08-01;375;236;360138;301279;63.9;53.4
51;2021-08-02;3287;2310;363425;303589;64.5;53.8
51;2021-08-03;3775;1912;367200;305501;65.1;54.2
51;2021-08-04;4451;2124;371651;307625;65.9;54.6
51;2021-08-05;2656;1534;374307;309159;66.4;54.8
51;2021-08-06;3044;2550;377351;311709;66.9;55.3
51;2021-08-07;2161;1698;379512;313407;67.3;55.6
51;2021-08-08;368;208;379880;313615;67.4;55.6
51;2021-08-09;2604;1851;382484;315466;67.8;56.0
51;2021-08-10;2372;1983;384856;317449;68.3;56.3
51;2021-08-11;2917;2341;387773;319790;68.8;56.7
51;2021-08-12;1753;1958;389526;321748;69.1;57.1
51;2021-08-13;2066;2670;391592;324418;69.5;57.5
51;2021-08-14;1581;2027;393173;326445;69.7;57.9
51;2021-08-15;149;150;393322;326595;69.8;57.9
51;2021-08-16;1356;3016;394678;329611;70.0;58.5
51;2021-08-17;1560;3283;396238;332894;70.3;59.0
51;2021-08-18;1899;3693;398137;336587;70.6;59.7
51;2021-08-19;1408;2548;399545;339135;70.9;60.1
51;2021-08-20;1707;3974;401252;343109;71.2;60.9
51;2021-08-21;988;2497;402240;345606;71.3;61.3
51;2021-08-22;101;343;402341;345949;71.4;61.4
51;2021-08-23;1111;3607;403452;349556;71.6;62.0
51;2021-08-24;1173;3643;404625;353199;71.8;62.6
51;2021-08-25;1319;4488;405944;357687;72.0;63.4
51;2021-08-26;1057;2548;407001;360235;72.2;63.9
51;2021-08-27;1215;4178;408216;364413;72.4;64.6
51;2021-08-28;655;2632;408871;367045;72.5;65.1
51;2021-08-29;84;360;408955;367405;72.5;65.2
51;2021-08-30;1332;4829;410287;372234;72.8;66.0
51;2021-08-31;778;3011;411065;375245;72.9;66.6
51;2021-09-01;738;3374;411803;378619;73.0;67.2
51;2021-09-02;799;2216;412602;380835;73.2;67.5
51;2021-09-03;904;2911;413506;383746;73.3;68.1
51;2021-09-04;619;2807;414125;386553;73.4;68.6
51;2021-09-05;122;225;414247;386778;73.5;68.6
51;2021-09-06;433;1791;414680;388569;73.5;68.9
51;2021-09-07;519;1670;415199;390239;73.6;69.2
51;2021-09-08;627;2175;415826;392414;73.8;69.6
51;2021-09-09;465;1348;416291;393762;73.8;69.8
51;2021-09-10;669;2087;416960;395849;74.0;70.2
51;2021-09-11;558;1934;417518;397783;74.1;70.6
51;2021-09-12;19;82;417537;397865;74.1;70.6
51;2021-09-13;424;1092;417961;398957;74.1;70.8
51;2021-09-14;593;1331;418554;400288;74.2;71.0
51;2021-09-15;490;1422;419044;401710;74.3;71.2
51;2021-09-16;306;658;419350;402368;74.4;71.4
51;2021-09-17;540;1127;419890;403495;74.5;71.6
51;2021-09-18;470;1418;420360;404913;74.6;71.8
51;2021-09-19;13;64;420373;404977;74.6;71.8
51;2021-09-20;280;534;420653;405511;74.6;71.9
51;2021-09-21;255;489;420908;406000;74.7;72.0
51;2021-09-22;318;1351;421226;407351;74.7;72.2
51;2021-09-23;195;602;421421;407953;74.7;72.4
51;2021-09-24;365;977;421786;408930;74.8;72.5
51;2021-09-25;284;983;422070;409913;74.9;72.7
51;2021-09-26;7;129;422077;410042;74.9;72.7
51;2021-09-27;259;445;422336;410487;74.9;72.8
51;2021-09-28;298;362;422634;410849;75.0;72.9
51;2021-09-29;348;775;422982;411624;75.0;73.0
51;2021-09-30;262;415;423244;412039;75.1;73.1
51;2021-10-01;353;717;423597;412756;75.1;73.2
51;2021-10-02;372;761;423969;413517;75.2;73.3
51;2021-10-03;0;1;423969;413518;75.2;73.3
52;2020-12-27;0;0;0;0;0.0;0.0
52;2020-12-28;1;0;1;0;0.0;0.0
52;2020-12-29;0;0;1;0;0.0;0.0
52;2020-12-30;0;0;1;0;0.0;0.0
52;2020-12-31;0;0;1;0;0.0;0.0
52;2021-01-01;0;0;1;0;0.0;0.0
52;2021-01-02;1;0;2;0;0.0;0.0
52;2021-01-03;0;0;2;0;0.0;0.0
52;2021-01-04;0;0;2;0;0.0;0.0
52;2021-01-05;0;0;2;0;0.0;0.0
52;2021-01-06;2;0;4;0;0.0;0.0
52;2021-01-07;0;0;4;0;0.0;0.0
52;2021-01-08;200;1;204;1;0.1;0.0
52;2021-01-09;93;0;297;1;0.2;0.0
52;2021-01-10;0;0;297;1;0.2;0.0
52;2021-01-11;207;0;504;1;0.3;0.0
52;2021-01-12;171;0;675;1;0.4;0.0
52;2021-01-13;563;2;1238;3;0.7;0.0
52;2021-01-14;677;10;1915;13;1.1;0.0
52;2021-01-15;411;1;2326;14;1.4;0.0
52;2021-01-16;16;0;2342;14;1.4;0.0
52;2021-01-17;0;0;2342;14;1.4;0.0
52;2021-01-18;427;0;2769;14;1.6;0.0
52;2021-01-19;440;0;3209;14;1.9;0.0
52;2021-01-20;422;0;3631;14;2.1;0.0
52;2021-01-21;423;1;4054;15;2.4;0.0
52;2021-01-22;321;2;4375;17;2.6;0.0
52;2021-01-23;73;1;4448;18;2.6;0.0
52;2021-01-24;0;0;4448;18;2.6;0.0
52;2021-01-25;236;0;4684;18;2.8;0.0
52;2021-01-26;308;0;4992;18;2.9;0.0
52;2021-01-27;238;1;5230;19;3.1;0.0
52;2021-01-28;174;4;5404;23;3.2;0.0
52;2021-01-29;74;114;5478;137;3.2;0.1
52;2021-01-30;91;92;5569;229;3.3;0.1
52;2021-01-31;0;0;5569;229;3.3;0.1
52;2021-02-01;117;178;5686;407;3.4;0.2
52;2021-02-02;61;167;5747;574;3.4;0.3
52;2021-02-03;89;387;5836;961;3.4;0.6
52;2021-02-04;231;534;6067;1495;3.6;0.9
52;2021-02-05;113;421;6180;1916;3.7;1.1
52;2021-02-06;22;0;6202;1916;3.7;1.1
52;2021-02-07;0;1;6202;1917;3.7;1.1
52;2021-02-08;34;163;6236;2080;3.7;1.2
52;2021-02-09;47;174;6283;2254;3.7;1.3
52;2021-02-10;88;162;6371;2416;3.8;1.4
52;2021-02-11;129;123;6500;2539;3.8;1.5
52;2021-02-12;187;106;6687;2645;4.0;1.6
52;2021-02-13;5;1;6692;2646;4.0;1.6
52;2021-02-14;0;16;6692;2662;4.0;1.6
52;2021-02-15;79;226;6771;2888;4.0;1.7
52;2021-02-16;50;282;6821;3170;4.0;1.9
52;2021-02-17;38;254;6859;3424;4.1;2.0
52;2021-02-18;82;238;6941;3662;4.1;2.2
52;2021-02-19;51;151;6992;3813;4.1;2.3
52;2021-02-20;14;89;7006;3902;4.1;2.3
52;2021-02-21;0;0;7006;3902;4.1;2.3
52;2021-02-22;42;322;7048;4224;4.2;2.5
52;2021-02-23;56;224;7104;4448;4.2;2.6
52;2021-02-24;81;212;7185;4660;4.2;2.8
52;2021-02-25;161;224;7346;4884;4.3;2.9
52;2021-02-26;296;174;7642;5058;4.5;3.0
52;2021-02-27;149;49;7791;5107;4.6;3.0
52;2021-02-28;0;0;7791;5107;4.6;3.0
52;2021-03-01;162;13;7953;5120;4.7;3.0
52;2021-03-02;222;45;8175;5165;4.8;3.1
52;2021-03-03;356;35;8531;5200;5.0;3.1
52;2021-03-04;381;58;8912;5258;5.3;3.1
52;2021-03-05;531;52;9443;5310;5.6;3.1
52;2021-03-06;409;35;9852;5345;5.8;3.2
52;2021-03-07;0;0;9852;5345;5.8;3.2
52;2021-03-08;398;102;10250;5447;6.1;3.2
52;2021-03-09;549;103;10799;5550;6.4;3.3
52;2021-03-10;308;102;11107;5652;6.6;3.3
52;2021-03-11;587;34;11694;5686;6.9;3.4
52;2021-03-12;585;68;12279;5754;7.3;3.4
52;2021-03-13;494;10;12773;5764;7.5;3.4
52;2021-03-14;15;3;12788;5767;7.6;3.4
52;2021-03-15;318;27;13106;5794;7.7;3.4
52;2021-03-16;203;15;13309;5809;7.9;3.4
52;2021-03-17;369;13;13678;5822;8.1;3.4
52;2021-03-18;442;10;14120;5832;8.3;3.4
52;2021-03-19;453;53;14573;5885;8.6;3.5
52;2021-03-20;259;12;14832;5897;8.8;3.5
52;2021-03-21;15;1;14847;5898;8.8;3.5
52;2021-03-22;375;49;15222;5947;9.0;3.5
52;2021-03-23;686;119;15908;6066;9.4;3.6
52;2021-03-24;771;71;16679;6137;9.9;3.6
52;2021-03-25;1143;88;17822;6225;10.5;3.7
52;2021-03-26;1036;135;18858;6360;11.1;3.8
52;2021-03-27;477;75;19335;6435;11.4;3.8
52;2021-03-28;53;0;19388;6435;11.5;3.8
52;2021-03-29;507;182;19895;6617;11.8;3.9
52;2021-03-30;868;314;20763;6931;12.3;4.1
52;2021-03-31;956;291;21719;7222;12.8;4.3
52;2021-04-01;1145;183;22864;7405;13.5;4.4
52;2021-04-02;958;109;23822;7514;14.1;4.4
52;2021-04-03;462;2;24284;7516;14.3;4.4
52;2021-04-04;1;1;24285;7517;14.3;4.4
52;2021-04-05;1;0;24286;7517;14.3;4.4
52;2021-04-06;434;293;24720;7810;14.6;4.6
52;2021-04-07;506;450;25226;8260;14.9;4.9
52;2021-04-08;860;208;26086;8468;15.4;5.0
52;2021-04-09;1058;131;27144;8599;16.0;5.1
52;2021-04-10;850;102;27994;8701;16.5;5.1
52;2021-04-11;96;1;28090;8702;16.6;5.1
52;2021-04-12;933;277;29023;8979;17.1;5.3
52;2021-04-13;1251;380;30274;9359;17.9;5.5
52;2021-04-14;1345;455;31619;9814;18.7;5.8
52;2021-04-15;1505;440;33124;10254;19.6;6.1
52;2021-04-16;1569;359;34693;10613;20.5;6.3
52;2021-04-17;1312;135;36005;10748;21.3;6.4
52;2021-04-18;510;29;36515;10777;21.6;6.4
52;2021-04-19;697;611;37212;11388;22.0;6.7
52;2021-04-20;1079;679;38291;12067;22.6;7.1
52;2021-04-21;1058;673;39349;12740;23.2;7.5
52;2021-04-22;1468;733;40817;13473;24.1;8.0
52;2021-04-23;1250;669;42067;14142;24.9;8.4
52;2021-04-24;477;293;42544;14435;25.1;8.5
52;2021-04-25;3;77;42547;14512;25.1;8.6
52;2021-04-26;631;560;43178;15072;25.5;8.9
52;2021-04-27;932;668;44110;15740;26.1;9.3
52;2021-04-28;1443;568;45553;16308;26.9;9.6
52;2021-04-29;1452;583;47005;16891;27.8;10.0
52;2021-04-30;1316;611;48321;17502;28.6;10.3
52;2021-05-01;8;230;48329;17732;28.6;10.5
52;2021-05-02;0;1;48329;17733;28.6;10.5
52;2021-05-03;1159;628;49488;18361;29.2;10.8
52;2021-05-04;1445;719;50933;19080;30.1;11.3
52;2021-05-05;1768;647;52701;19727;31.1;11.7
52;2021-05-06;1963;537;54664;20264;32.3;12.0
52;2021-05-07;1441;1168;56105;21432;33.1;12.7
52;2021-05-08;587;317;56692;21749;33.5;12.9
52;2021-05-09;1;47;56693;21796;33.5;12.9
52;2021-05-10;792;1100;57485;22896;34.0;13.5
52;2021-05-11;868;1389;58353;24285;34.5;14.3
52;2021-05-12;1206;1382;59559;25667;35.2;15.2
52;2021-05-13;67;184;59626;25851;35.2;15.3
52;2021-05-14;1185;1365;60811;27216;35.9;16.1
52;2021-05-15;491;929;61302;28145;36.2;16.6
52;2021-05-16;8;43;61310;28188;36.2;16.7
52;2021-05-17;1141;705;62451;28893;36.9;17.1
52;2021-05-18;1218;677;63669;29570;37.6;17.5
52;2021-05-19;1541;415;65210;29985;38.5;17.7
52;2021-05-20;1546;418;66756;30403;39.4;18.0
52;2021-05-21;1625;611;68381;31014;40.4;18.3
52;2021-05-22;1089;210;69470;31224;41.0;18.4
52;2021-05-23;1;0;69471;31224;41.0;18.4
52;2021-05-24;405;33;69876;31257;41.3;18.5
52;2021-05-25;1351;385;71227;31642;42.1;18.7
52;2021-05-26;1477;672;72704;32314;43.0;19.1
52;2021-05-27;1564;786;74268;33100;43.9;19.6
52;2021-05-28;1493;668;75761;33768;44.8;20.0
52;2021-05-29;695;834;76456;34602;45.2;20.4
52;2021-05-30;16;551;76472;35153;45.2;20.8
52;2021-05-31;825;829;77297;35982;45.7;21.3
52;2021-06-01;956;816;78253;36798;46.2;21.7
52;2021-06-02;896;754;79149;37552;46.8;22.2
52;2021-06-03;825;825;79974;38377;47.3;22.7
52;2021-06-04;883;1340;80857;39717;47.8;23.5
52;2021-06-05;581;637;81438;40354;48.1;23.8
52;2021-06-06;27;55;81465;40409;48.1;23.9
52;2021-06-07;359;931;81824;41340;48.3;24.4
52;2021-06-08;556;1470;82380;42810;48.7;25.3
52;2021-06-09;611;1474;82991;44284;49.0;26.2
52;2021-06-10;794;1159;83785;45443;49.5;26.8
52;2021-06-11;830;1347;84615;46790;50.0;27.6
52;2021-06-12;423;586;85038;47376;50.2;28.0
52;2021-06-13;2;6;85040;47382;50.2;28.0
52;2021-06-14;171;1413;85211;48795;50.3;28.8
52;2021-06-15;221;1807;85432;50602;50.5;29.9
52;2021-06-16;351;1996;85783;52598;50.7;31.1
52;2021-06-17;265;1156;86048;53754;50.8;31.8
52;2021-06-18;308;1553;86356;55307;51.0;32.7
52;2021-06-19;502;684;86858;55991;51.3;33.1
52;2021-06-20;1;17;86859;56008;51.3;33.1
52;2021-06-21;523;898;87382;56906;51.6;33.6
52;2021-06-22;503;1047;87885;57953;51.9;34.2
52;2021-06-23;563;1041;88448;58994;52.3;34.9
52;2021-06-24;610;715;89058;59709;52.6;35.3
52;2021-06-25;661;1314;89719;61023;53.0;36.1
52;2021-06-26;264;722;89983;61745;53.2;36.5
52;2021-06-27;1;8;89984;61753;53.2;36.5
52;2021-06-28;184;1442;90168;63195;53.3;37.3
52;2021-06-29;163;1414;90331;64609;53.4;38.2
52;2021-06-30;221;1467;90552;66076;53.5;39.0
52;2021-07-01;320;1020;90872;67096;53.7;39.6
52;2021-07-02;430;1454;91302;68550;53.9;40.5
52;2021-07-03;302;1148;91604;69698;54.1;41.2
52;2021-07-04;0;11;91604;69709;54.1;41.2
52;2021-07-05;173;1446;91777;71155;54.2;42.0
52;2021-07-06;284;1449;92061;72604;54.4;42.9
52;2021-07-07;309;1163;92370;73767;54.6;43.6
52;2021-07-08;473;1166;92843;74933;54.9;44.3
52;2021-07-09;288;1620;93131;76553;55.0;45.2
52;2021-07-10;155;822;93286;77375;55.1;45.7
52;2021-07-11;13;12;93299;77387;55.1;45.7
52;2021-07-12;299;1467;93598;78854;55.3;46.6
52;2021-07-13;590;1367;94188;80221;55.7;47.4
52;2021-07-14;437;153;94625;80374;55.9;47.5
52;2021-07-15;614;1428;95239;81802;56.3;48.3
52;2021-07-16;899;1337;96138;83139;56.8;49.1
52;2021-07-17;530;343;96668;83482;57.1;49.3
52;2021-07-18;3;12;96671;83494;57.1;49.3
52;2021-07-19;691;987;97362;84481;57.5;49.9
52;2021-07-20;1110;831;98472;85312;58.2;50.4
52;2021-07-21;1161;737;99633;86049;58.9;50.8
52;2021-07-22;1447;865;101080;86914;59.7;51.4
52;2021-07-23;1399;956;102479;87870;60.5;51.9
52;2021-07-24;873;487;103352;88357;61.1;52.2
52;2021-07-25;22;21;103374;88378;61.1;52.2
52;2021-07-26;1010;613;104384;88991;61.7;52.6
52;2021-07-27;1342;657;105726;89648;62.5;53.0
52;2021-07-28;1382;643;107108;90291;63.3;53.3
52;2021-07-29;1263;622;108371;90913;64.0;53.7
52;2021-07-30;1365;712;109736;91625;64.8;54.1
52;2021-07-31;873;549;110609;92174;65.4;54.5
52;2021-08-01;1;14;110610;92188;65.4;54.5
52;2021-08-02;1185;562;111795;92750;66.1;54.8
52;2021-08-03;1363;540;113158;93290;66.9;55.1
52;2021-08-04;1157;579;114315;93869;67.5;55.5
52;2021-08-05;1026;574;115341;94443;68.1;55.8
52;2021-08-06;1057;697;116398;95140;68.8;56.2
52;2021-08-07;519;422;116917;95562;69.1;56.5
52;2021-08-08;0;6;116917;95568;69.1;56.5
52;2021-08-09;469;871;117386;96439;69.4;57.0
52;2021-08-10;717;748;118103;97187;69.8;57.4
52;2021-08-11;535;837;118638;98024;70.1;57.9
52;2021-08-12;623;750;119261;98774;70.5;58.4
52;2021-08-13;420;1029;119681;99803;70.7;59.0
52;2021-08-14;421;360;120102;100163;71.0;59.2
52;2021-08-15;13;13;120115;100176;71.0;59.2
52;2021-08-16;327;934;120442;101110;71.2;59.7
52;2021-08-17;415;911;120857;102021;71.4;60.3
52;2021-08-18;489;944;121346;102965;71.7;60.8
52;2021-08-19;461;836;121807;103801;72.0;61.3
52;2021-08-20;384;1210;122191;105011;72.2;62.0
52;2021-08-21;394;605;122585;105616;72.4;62.4
52;2021-08-22;5;11;122590;105627;72.4;62.4
52;2021-08-23;431;1058;123021;106685;72.7;63.0
52;2021-08-24;307;1077;123328;107762;72.9;63.7
52;2021-08-25;254;1061;123582;108823;73.0;64.3
52;2021-08-26;301;914;123883;109737;73.2;64.8
52;2021-08-27;429;1276;124312;111013;73.4;65.6
52;2021-08-28;243;495;124555;111508;73.6;65.9
52;2021-08-29;3;25;124558;111533;73.6;65.9
52;2021-08-30;204;998;124762;112531;73.7;66.5
52;2021-08-31;205;1054;124967;113585;73.8;67.1
52;2021-09-01;183;1066;125150;114651;73.9;67.7
52;2021-09-02;194;762;125344;115413;74.1;68.2
52;2021-09-03;243;936;125587;116349;74.2;68.7
52;2021-09-04;189;556;125776;116905;74.3;69.1
52;2021-09-05;2;14;125778;116919;74.3;69.1
52;2021-09-06;126;543;125904;117462;74.4;69.4
52;2021-09-07;161;520;126065;117982;74.5;69.7
52;2021-09-08;142;616;126207;118598;74.6;70.1
52;2021-09-09;139;432;126346;119030;74.7;70.3
52;2021-09-10;256;741;126602;119771;74.8;70.8
52;2021-09-11;151;321;126753;120092;74.9;71.0
52;2021-09-12;2;12;126755;120104;74.9;71.0
52;2021-09-13;174;621;126929;120725;75.0;71.3
52;2021-09-14;141;463;127070;121188;75.1;71.6
52;2021-09-15;148;447;127218;121635;75.2;71.9
52;2021-09-16;136;309;127354;121944;75.2;72.0
52;2021-09-17;232;543;127586;122487;75.4;72.4
52;2021-09-18;134;242;127720;122729;75.5;72.5
52;2021-09-19;4;18;127724;122747;75.5;72.5
52;2021-09-20;106;353;127830;123100;75.5;72.7
52;2021-09-21;94;208;127924;123308;75.6;72.9
52;2021-09-22;107;319;128031;123627;75.6;73.0
52;2021-09-23;138;207;128169;123834;75.7;73.2
52;2021-09-24;127;284;128296;124118;75.8;73.3
52;2021-09-25;93;250;128389;124368;75.9;73.5
52;2021-09-26;0;0;128389;124368;75.9;73.5
52;2021-09-27;116;181;128505;124549;75.9;73.6
52;2021-09-28;120;144;128625;124693;76.0;73.7
52;2021-09-29;92;207;128717;124900;76.1;73.8
52;2021-09-30;117;124;128834;125024;76.1;73.9
52;2021-10-01;117;226;128951;125250;76.2;74.0
52;2021-10-02;63;150;129014;125400;76.2;74.1
52;2021-10-03;0;6;129014;125406;76.2;74.1
53;2020-12-27;0;0;0;0;0.0;0.0
53;2020-12-28;0;0;0;0;0.0;0.0
53;2020-12-29;0;0;0;0;0.0;0.0
53;2020-12-30;0;0;0;0;0.0;0.0
53;2020-12-31;0;0;0;0;0.0;0.0
53;2021-01-01;0;0;0;0;0.0;0.0
53;2021-01-02;1;0;1;0;0.0;0.0
53;2021-01-03;0;0;1;0;0.0;0.0
53;2021-01-04;1;0;2;0;0.0;0.0
53;2021-01-05;0;0;2;0;0.0;0.0
53;2021-01-06;0;0;2;0;0.0;0.0
53;2021-01-07;102;0;104;0;0.0;0.0
53;2021-01-08;284;1;388;1;0.1;0.0
53;2021-01-09;134;1;522;2;0.2;0.0
53;2021-01-10;15;0;537;2;0.2;0.0
53;2021-01-11;176;0;713;2;0.2;0.0
53;2021-01-12;456;0;1169;2;0.4;0.0
53;2021-01-13;254;0;1423;2;0.5;0.0
53;2021-01-14;290;7;1713;9;0.6;0.0
53;2021-01-15;343;4;2056;13;0.7;0.0
53;2021-01-16;60;0;2116;13;0.7;0.0
53;2021-01-17;25;0;2141;13;0.7;0.0
53;2021-01-18;364;0;2505;13;0.8;0.0
53;2021-01-19;594;0;3099;13;1.0;0.0
53;2021-01-20;742;0;3841;13;1.3;0.0
53;2021-01-21;773;2;4614;15;1.5;0.0
53;2021-01-22;705;5;5319;20;1.7;0.0
53;2021-01-23;160;0;5479;20;1.8;0.0
53;2021-01-24;6;0;5485;20;1.8;0.0
53;2021-01-25;550;0;6035;20;2.0;0.0
53;2021-01-26;1199;7;7234;27;2.4;0.0
53;2021-01-27;696;4;7930;31;2.6;0.0
53;2021-01-28;737;94;8667;125;2.8;0.0
53;2021-01-29;422;177;9089;302;3.0;0.1
53;2021-01-30;130;0;9219;302;3.0;0.1
53;2021-01-31;0;0;9219;302;3.0;0.1
53;2021-02-01;298;143;9517;445;3.1;0.1
53;2021-02-02;309;226;9826;671;3.2;0.2
53;2021-02-03;227;358;10053;1029;3.3;0.3
53;2021-02-04;184;303;10237;1332;3.4;0.4
53;2021-02-05;234;289;10471;1621;3.4;0.5
53;2021-02-06;153;23;10624;1644;3.5;0.5
53;2021-02-07;0;0;10624;1644;3.5;0.5
53;2021-02-08;168;89;10792;1733;3.5;0.6
53;2021-02-09;369;206;11161;1939;3.7;0.6
53;2021-02-10;266;397;11427;2336;3.7;0.8
53;2021-02-11;433;397;11860;2733;3.9;0.9
53;2021-02-12;318;486;12178;3219;4.0;1.1
53;2021-02-13;96;53;12274;3272;4.0;1.1
53;2021-02-14;0;99;12274;3371;4.0;1.1
53;2021-02-15;239;334;12513;3705;4.1;1.2
53;2021-02-16;528;697;13041;4402;4.3;1.4
53;2021-02-17;391;518;13432;4920;4.4;1.6
53;2021-02-18;547;504;13979;5424;4.6;1.8
53;2021-02-19;895;359;14874;5783;4.9;1.9
53;2021-02-20;139;83;15013;5866;4.9;1.9
53;2021-02-21;1;20;15014;5886;4.9;1.9
53;2021-02-22;161;433;15175;6319;5.0;2.1
53;2021-02-23;59;506;15234;6825;5.0;2.2
53;2021-02-24;137;393;15371;7218;5.0;2.4
53;2021-02-25;457;268;15828;7486;5.2;2.5
53;2021-02-26;437;217;16265;7703;5.3;2.5
53;2021-02-27;86;85;16351;7788;5.4;2.6
53;2021-02-28;0;0;16351;7788;5.4;2.6
53;2021-03-01;231;223;16582;8011;5.4;2.6
53;2021-03-02;246;210;16828;8221;5.5;2.7
53;2021-03-03;321;366;17149;8587;5.6;2.8
53;2021-03-04;859;333;18008;8920;5.9;2.9
53;2021-03-05;660;270;18668;9190;6.1;3.0
53;2021-03-06;447;184;19115;9374;6.3;3.1
53;2021-03-07;276;5;19391;9379;6.4;3.1
53;2021-03-08;375;160;19766;9539;6.5;3.1
53;2021-03-09;878;242;20644;9781;6.8;3.2
53;2021-03-10;807;106;21451;9887;7.0;3.2
53;2021-03-11;1247;228;22698;10115;7.4;3.3
53;2021-03-12;1603;145;24301;10260;8.0;3.4
53;2021-03-13;824;13;25125;10273;8.2;3.4
53;2021-03-14;1;0;25126;10273;8.2;3.4
53;2021-03-15;1001;288;26127;10561;8.6;3.5
53;2021-03-16;1035;331;27162;10892;8.9;3.6
53;2021-03-17;687;257;27849;11149;9.1;3.7
53;2021-03-18;972;345;28821;11494;9.4;3.8
53;2021-03-19;1346;590;30167;12084;9.9;4.0
53;2021-03-20;592;17;30759;12101;10.1;4.0
53;2021-03-21;3;0;30762;12101;10.1;4.0
53;2021-03-22;1213;155;31975;12256;10.5;4.0
53;2021-03-23;1699;71;33674;12327;11.0;4.0
53;2021-03-24;1323;117;34997;12444;11.5;4.1
53;2021-03-25;2323;242;37320;12686;12.2;4.2
53;2021-03-26;1882;152;39202;12838;12.8;4.2
53;2021-03-27;339;3;39541;12841;12.9;4.2
53;2021-03-28;2;0;39543;12841;12.9;4.2
53;2021-03-29;1474;213;41017;13054;13.4;4.3
53;2021-03-30;1944;202;42961;13256;14.1;4.3
53;2021-03-31;1791;224;44752;13480;14.7;4.4
53;2021-04-01;1948;671;46700;14151;15.3;4.6
53;2021-04-02;2075;227;48775;14378;16.0;4.7
53;2021-04-03;414;1;49189;14379;16.1;4.7
53;2021-04-04;10;0;49199;14379;16.1;4.7
53;2021-04-05;9;15;49208;14394;16.1;4.7
53;2021-04-06;1305;504;50513;14898;16.5;4.9
53;2021-04-07;1172;925;51685;15823;16.9;5.2
53;2021-04-08;1663;1006;53348;16829;17.5;5.5
53;2021-04-09;1958;407;55306;17236;18.1;5.6
53;2021-04-10;543;13;55849;17249;18.3;5.6
53;2021-04-11;13;0;55862;17249;18.3;5.6
53;2021-04-12;694;1067;56556;18316;18.5;6.0
53;2021-04-13;1470;1105;58026;19421;19.0;6.4
53;2021-04-14;1022;734;59048;20155;19.3;6.6
53;2021-04-15;1156;1105;60204;21260;19.7;7.0
53;2021-04-16;1271;815;61475;22075;20.1;7.2
53;2021-04-17;279;273;61754;22348;20.2;7.3
53;2021-04-18;0;0;61754;22348;20.2;7.3
53;2021-04-19;681;1061;62435;23409;20.4;7.7
53;2021-04-20;936;1452;63371;24861;20.8;8.1
53;2021-04-21;851;1009;64222;25870;21.0;8.5
53;2021-04-22;1045;1614;65267;27484;21.4;9.0
53;2021-04-23;1329;1054;66596;28538;21.8;9.3
53;2021-04-24;68;7;66664;28545;21.8;9.3
53;2021-04-25;6;39;66670;28584;21.8;9.4
53;2021-04-26;368;1230;67038;29814;22.0;9.8
53;2021-04-27;723;1969;67761;31783;22.2;10.4
53;2021-04-28;977;1393;68738;33176;22.5;10.9
53;2021-04-29;1052;1711;69790;34887;22.9;11.4
53;2021-04-30;1366;1315;71156;36202;23.3;11.9
53;2021-05-01;36;50;71192;36252;23.3;11.9
53;2021-05-02;0;0;71192;36252;23.3;11.9
53;2021-05-03;1570;703;72762;36955;23.8;12.1
53;2021-05-04;1303;1440;74065;38395;24.3;12.6
53;2021-05-05;1611;825;75676;39220;24.8;12.8
53;2021-05-06;1390;1399;77066;40619;25.2;13.3
53;2021-05-07;1537;1301;78603;41920;25.7;13.7
53;2021-05-08;939;36;79542;41956;26.0;13.7
53;2021-05-09;11;2;79553;41958;26.1;13.7
53;2021-05-10;2414;815;81967;42773;26.8;14.0
53;2021-05-11;3097;1281;85064;44054;27.9;14.4
53;2021-05-12;2751;1093;87815;45147;28.8;14.8
53;2021-05-13;350;27;88165;45174;28.9;14.8
53;2021-05-14;2021;677;90186;45851;29.5;15.0
53;2021-05-15;1058;63;91244;45914;29.9;15.0
53;2021-05-16;3;0;91247;45914;29.9;15.0
53;2021-05-17;1701;1196;92948;47110;30.4;15.4
53;2021-05-18;1880;1550;94828;48660;31.1;15.9
53;2021-05-19;2303;746;97131;49406;31.8;16.2
53;2021-05-20;3216;866;100347;50272;32.9;16.5
53;2021-05-21;2798;827;103145;51099;33.8;16.7
53;2021-05-22;21;59;103166;51158;33.8;16.8
53;2021-05-23;1;0;103167;51158;33.8;16.8
53;2021-05-24;8;6;103175;51164;33.8;16.8
53;2021-05-25;1820;802;104995;51966;34.4;17.0
53;2021-05-26;1853;908;106848;52874;35.0;17.3
53;2021-05-27;3072;1079;109920;53953;36.0;17.7
53;2021-05-28;2562;876;112482;54829;36.8;18.0
53;2021-05-29;846;240;113328;55069;37.1;18.0
53;2021-05-30;18;6;113346;55075;37.1;18.0
53;2021-05-31;2565;802;115911;55877;38.0;18.3
53;2021-06-01;3489;1254;119400;57131;39.1;18.7
53;2021-06-02;3183;521;122583;57652;40.1;18.9
53;2021-06-03;4198;784;126781;58436;41.5;19.1
53;2021-06-04;3179;1265;129960;59701;42.6;19.6
53;2021-06-05;137;245;130097;59946;42.6;19.6
53;2021-06-06;1;4;130098;59950;42.6;19.6
53;2021-06-07;2629;922;132727;60872;43.5;19.9
53;2021-06-08;3588;1128;136315;62000;44.6;20.3
53;2021-06-09;2454;943;138769;62943;45.4;20.6
53;2021-06-10;3521;842;142290;63785;46.6;20.9
53;2021-06-11;2964;1210;145254;64995;47.6;21.3
53;2021-06-12;108;138;145362;65133;47.6;21.3
53;2021-06-13;10;2;145372;65135;47.6;21.3
53;2021-06-14;1600;1788;146972;66923;48.1;21.9
53;2021-06-15;1898;2263;148870;69186;48.8;22.7
53;2021-06-16;1828;1733;150698;70919;49.4;23.2
53;2021-06-17;3011;1651;153709;72570;50.3;23.8
53;2021-06-18;2705;1805;156414;74375;51.2;24.4
53;2021-06-19;761;1164;157175;75539;51.5;24.7
53;2021-06-20;3;479;157178;76018;51.5;24.9
53;2021-06-21;918;2523;158096;78541;51.8;25.7
53;2021-06-22;1299;3452;159395;81993;52.2;26.9
53;2021-06-23;1362;2892;160757;84885;52.6;27.8
53;2021-06-24;1802;2033;162559;86918;53.2;28.5
53;2021-06-25;1785;2044;164344;88962;53.8;29.1
53;2021-06-26;977;351;165321;89313;54.1;29.2
53;2021-06-27;8;8;165329;89321;54.1;29.3
53;2021-06-28;662;2899;165991;92220;54.4;30.2
53;2021-06-29;858;3645;166849;95865;54.6;31.4
53;2021-06-30;749;1518;167598;97383;54.9;31.9
53;2021-07-01;1507;2630;169105;100013;55.4;32.8
53;2021-07-02;1528;2025;170633;102038;55.9;33.4
53;2021-07-03;858;574;171491;102612;56.2;33.6
53;2021-07-04;0;4;171491;102616;56.2;33.6
53;2021-07-05;542;2057;172033;104673;56.3;34.3
53;2021-07-06;859;3615;172892;108288;56.6;35.5
53;2021-07-07;1024;2652;173916;110940;57.0;36.3
53;2021-07-08;1313;3116;175229;114056;57.4;37.4
53;2021-07-09;1131;3399;176360;117455;57.8;38.5
53;2021-07-10;422;1001;176782;118456;57.9;38.8
53;2021-07-11;12;20;176794;118476;57.9;38.8
53;2021-07-12;503;3706;177297;122182;58.1;40.0
53;2021-07-13;894;4762;178191;126944;58.4;41.6
53;2021-07-14;104;284;178295;127228;58.4;41.7
53;2021-07-15;1112;4342;179407;131570;58.8;43.1
53;2021-07-16;1248;3847;180655;135417;59.2;44.3
53;2021-07-17;1318;300;181973;135717;59.6;44.4
53;2021-07-18;27;20;182000;135737;59.6;44.5
53;2021-07-19;734;3426;182734;139163;59.8;45.6
53;2021-07-20;985;4122;183719;143285;60.2;46.9
53;2021-07-21;686;3274;184405;146559;60.4;48.0
53;2021-07-22;1512;3522;185917;150081;60.9;49.1
53;2021-07-23;1603;3758;187520;153839;61.4;50.4
53;2021-07-24;956;280;188476;154119;61.7;50.5
53;2021-07-25;60;24;188536;154143;61.7;50.5
53;2021-07-26;1727;1941;190263;156084;62.3;51.1
53;2021-07-27;2356;2820;192619;158904;63.1;52.0
53;2021-07-28;2145;2813;194764;161717;63.8;53.0
53;2021-07-29;2491;2546;197255;164263;64.6;53.8
53;2021-07-30;1828;2647;199083;166910;65.2;54.7
53;2021-07-31;626;229;199709;167139;65.4;54.7
53;2021-08-01;37;25;199746;167164;65.4;54.7
53;2021-08-02;2083;1732;201829;168896;66.1;55.3
53;2021-08-03;2415;1905;204244;170801;66.9;55.9
53;2021-08-04;2475;1863;206719;172664;67.7;56.5
53;2021-08-05;2869;1541;209588;174205;68.6;57.0
53;2021-08-06;2517;1719;212105;175924;69.5;57.6
53;2021-08-07;483;272;212588;176196;69.6;57.7
53;2021-08-08;6;19;212594;176215;69.6;57.7
53;2021-08-09;1839;1649;214433;177864;70.2;58.2
53;2021-08-10;2324;1748;216757;179612;71.0;58.8
53;2021-08-11;1681;867;218438;180479;71.5;59.1
53;2021-08-12;2007;984;220445;181463;72.2;59.4
53;2021-08-13;2039;1315;222484;182778;72.9;59.9
53;2021-08-14;66;63;222550;182841;72.9;59.9
53;2021-08-15;1;2;222551;182843;72.9;59.9
53;2021-08-16;1337;1596;223888;184439;73.3;60.4
53;2021-08-17;1548;1657;225436;186096;73.8;60.9
53;2021-08-18;1515;1600;226951;187696;74.3;61.5
53;2021-08-19;1374;1972;228325;189668;74.8;62.1
53;2021-08-20;1099;2082;229424;191750;75.1;62.8
53;2021-08-21;189;341;229613;192091;75.2;62.9
53;2021-08-22;0;0;229613;192091;75.2;62.9
53;2021-08-23;843;1915;230456;194006;75.5;63.5
53;2021-08-24;903;2117;231359;196123;75.8;64.2
53;2021-08-25;915;2272;232274;198395;76.1;65.0
53;2021-08-26;666;2614;232940;201009;76.3;65.8
53;2021-08-27;753;2645;233693;203654;76.5;66.7
53;2021-08-28;48;133;233741;203787;76.5;66.7
53;2021-08-29;12;31;233753;203818;76.5;66.7
53;2021-08-30;619;2107;234372;205925;76.8;67.4
53;2021-08-31;762;2920;235134;208845;77.0;68.4
53;2021-09-01;342;1637;235476;210482;77.1;68.9
53;2021-09-02;441;1823;235917;212305;77.3;69.5
53;2021-09-03;449;2494;236366;214799;77.4;70.3
53;2021-09-04;115;213;236481;215012;77.4;70.4
53;2021-09-05;1;12;236482;215024;77.4;70.4
53;2021-09-06;300;1664;236782;216688;77.5;71.0
53;2021-09-07;286;1944;237068;218632;77.6;71.6
53;2021-09-08;421;2157;237489;220789;77.8;72.3
53;2021-09-09;237;1461;237726;222250;77.8;72.8
53;2021-09-10;383;2091;238109;224341;78.0;73.5
53;2021-09-11;39;137;238148;224478;78.0;73.5
53;2021-09-12;0;1;238148;224479;78.0;73.5
53;2021-09-13;230;1197;238378;225676;78.1;73.9
53;2021-09-14;242;1049;238620;226725;78.1;74.2
53;2021-09-15;331;1070;238951;227795;78.3;74.6
53;2021-09-16;305;380;239256;228175;78.4;74.7
53;2021-09-17;429;1056;239685;229231;78.5;75.1
53;2021-09-18;44;70;239729;229301;78.5;75.1
53;2021-09-19;8;14;239737;229315;78.5;75.1
53;2021-09-20;122;382;239859;229697;78.5;75.2
53;2021-09-21;248;651;240107;230348;78.6;75.4
53;2021-09-22;193;665;240300;231013;78.7;75.7
53;2021-09-23;132;395;240432;231408;78.7;75.8
53;2021-09-24;197;638;240629;232046;78.8;76.0
53;2021-09-25;27;50;240656;232096;78.8;76.0
53;2021-09-26;0;0;240656;232096;78.8;76.0
53;2021-09-27;159;374;240815;232470;78.9;76.1
53;2021-09-28;163;280;240978;232750;78.9;76.2
53;2021-09-29;159;488;241137;233238;79.0;76.4
53;2021-09-30;87;211;241224;233449;79.0;76.4
53;2021-10-01;267;621;241491;234070;79.1;76.7
53;2021-10-02;28;52;241519;234122;79.1;76.7
53;2021-10-03;3;7;241522;234129;79.1;76.7
54;2020-12-27;0;0;0;0;0.0;0.0
54;2020-12-28;1;0;1;0;0.0;0.0
54;2020-12-29;0;0;1;0;0.0;0.0
54;2020-12-30;1;0;2;0;0.0;0.0
54;2020-12-31;10;0;12;0;0.0;0.0
54;2021-01-01;0;0;12;0;0.0;0.0
54;2021-01-02;0;0;12;0;0.0;0.0
54;2021-01-03;2;0;14;0;0.0;0.0
54;2021-01-04;163;0;177;0;0.0;0.0
54;2021-01-05;396;0;573;0;0.1;0.0
54;2021-01-06;650;1;1223;1;0.2;0.0
54;2021-01-07;816;2;2039;3;0.3;0.0
54;2021-01-08;706;3;2745;6;0.4;0.0
54;2021-01-09;81;0;2826;6;0.4;0.0
54;2021-01-10;78;0;2904;6;0.4;0.0
54;2021-01-11;974;3;3878;9;0.5;0.0
54;2021-01-12;1181;1;5059;10;0.7;0.0
54;2021-01-13;2426;7;7485;17;1.0;0.0
54;2021-01-14;3401;23;10886;40;1.5;0.0
54;2021-01-15;2717;13;13603;53;1.9;0.0
54;2021-01-16;815;4;14418;57;2.0;0.0
54;2021-01-17;209;0;14627;57;2.0;0.0
54;2021-01-18;1557;5;16184;62;2.2;0.0
54;2021-01-19;1707;0;17891;62;2.4;0.0
54;2021-01-20;1525;4;19416;66;2.7;0.0
54;2021-01-21;1371;4;20787;70;2.8;0.0
54;2021-01-22;1092;8;21879;78;3.0;0.0
54;2021-01-23;477;1;22356;79;3.1;0.0
54;2021-01-24;66;0;22422;79;3.1;0.0
54;2021-01-25;946;28;23368;107;3.2;0.0
54;2021-01-26;142;0;23510;107;3.2;0.0
54;2021-01-27;12;148;23522;255;3.2;0.0
54;2021-01-28;32;205;23554;460;3.2;0.1
54;2021-01-29;19;234;23573;694;3.2;0.1
54;2021-01-30;7;0;23580;694;3.2;0.1
54;2021-01-31;1;0;23581;694;3.2;0.1
54;2021-02-01;13;740;23594;1434;3.2;0.2
54;2021-02-02;24;914;23618;2348;3.2;0.3
54;2021-02-03;363;1390;23981;3738;3.3;0.5
54;2021-02-04;739;2229;24720;5967;3.4;0.8
54;2021-02-05;799;1663;25519;7630;3.5;1.0
54;2021-02-06;204;249;25723;7879;3.5;1.1
54;2021-02-07;4;100;25727;7979;3.5;1.1
54;2021-02-08;117;849;25844;8828;3.5;1.2
54;2021-02-09;305;932;26149;9760;3.6;1.3
54;2021-02-10;386;688;26535;10448;3.6;1.4
54;2021-02-11;293;711;26828;11159;3.7;1.5
54;2021-02-12;446;1098;27274;12257;3.7;1.7
54;2021-02-13;148;217;27422;12474;3.8;1.7
54;2021-02-14;9;8;27431;12482;3.8;1.7
54;2021-02-15;428;961;27859;13443;3.8;1.8
54;2021-02-16;401;1067;28260;14510;3.9;2.0
54;2021-02-17;518;820;28778;15330;3.9;2.1
54;2021-02-18;595;679;29373;16009;4.0;2.2
54;2021-02-19;519;642;29892;16651;4.1;2.3
54;2021-02-20;34;247;29926;16898;4.1;2.3
54;2021-02-21;3;20;29929;16918;4.1;2.3
54;2021-02-22;484;530;30413;17448;4.2;2.4
54;2021-02-23;679;506;31092;17954;4.3;2.5
54;2021-02-24;728;336;31820;18290;4.4;2.5
54;2021-02-25;1474;663;33294;18953;4.6;2.6
54;2021-02-26;1776;745;35070;19698;4.8;2.7
54;2021-02-27;698;108;35768;19806;4.9;2.7
54;2021-02-28;11;26;35779;19832;4.9;2.7
54;2021-03-01;636;193;36415;20025;5.0;2.7
54;2021-03-02;1483;146;37898;20171;5.2;2.8
54;2021-03-03;1753;61;39651;20232;5.4;2.8
54;2021-03-04;2025;98;41676;20330;5.7;2.8
54;2021-03-05;2797;144;44473;20474;6.1;2.8
54;2021-03-06;4042;108;48515;20582;6.6;2.8
54;2021-03-07;2626;70;51141;20652;7.0;2.8
54;2021-03-08;1337;63;52478;20715;7.2;2.8
54;2021-03-09;2649;104;55127;20819;7.5;2.9
54;2021-03-10;3194;106;58321;20925;8.0;2.9
54;2021-03-11;3386;98;61707;21023;8.4;2.9
54;2021-03-12;4975;183;66682;21206;9.1;2.9
54;2021-03-13;4203;110;70885;21316;9.7;2.9
54;2021-03-14;543;40;71428;21356;9.8;2.9
54;2021-03-15;1719;103;73147;21459;10.0;2.9
54;2021-03-16;1733;152;74880;21611;10.3;3.0
54;2021-03-17;2082;141;76962;21752;10.5;3.0
54;2021-03-18;2062;164;79024;21916;10.8;3.0
54;2021-03-19;3319;265;82343;22181;11.3;3.0
54;2021-03-20;2309;72;84652;22253;11.6;3.0
54;2021-03-21;295;14;84947;22267;11.6;3.0
54;2021-03-22;1034;302;85981;22569;11.8;3.1
54;2021-03-23;1938;471;87919;23040;12.0;3.2
54;2021-03-24;2194;699;90113;23739;12.3;3.3
54;2021-03-25;3173;715;93286;24454;12.8;3.3
54;2021-03-26;3513;800;96799;25254;13.3;3.5
54;2021-03-27;2419;279;99218;25533;13.6;3.5
54;2021-03-28;280;6;99498;25539;13.6;3.5
54;2021-03-29;1668;369;101166;25908;13.9;3.5
54;2021-03-30;2559;937;103725;26845;14.2;3.7
54;2021-03-31;2599;1130;106324;27975;14.6;3.8
54;2021-04-01;3237;1279;109561;29254;15.0;4.0
54;2021-04-02;2962;1671;112523;30925;15.4;4.2
54;2021-04-03;1264;1302;113787;32227;15.6;4.4
54;2021-04-04;137;418;113924;32645;15.6;4.5
54;2021-04-05;144;572;114068;33217;15.6;4.5
54;2021-04-06;1268;1646;115336;34863;15.8;4.8
54;2021-04-07;924;2251;116260;37114;15.9;5.1
54;2021-04-08;2325;2423;118585;39537;16.2;5.4
54;2021-04-09;4116;3123;122701;42660;16.8;5.8
54;2021-04-10;3208;1676;125909;44336;17.2;6.1
54;2021-04-11;206;944;126115;45280;17.3;6.2
54;2021-04-12;2198;1528;128313;46808;17.6;6.4
54;2021-04-13;3001;1969;131314;48777;18.0;6.7
54;2021-04-14;3263;1862;134577;50639;18.4;6.9
54;2021-04-15;2876;2297;137453;52936;18.8;7.2
54;2021-04-16;3141;2597;140594;55533;19.2;7.6
54;2021-04-17;3475;1485;144069;57018;19.7;7.8
54;2021-04-18;64;245;144133;57263;19.7;7.8
54;2021-04-19;2464;1081;146597;58344;20.1;8.0
54;2021-04-20;3011;1244;149608;59588;20.5;8.2
54;2021-04-21;4401;1630;154009;61218;21.1;8.4
54;2021-04-22;3722;2386;157731;63604;21.6;8.7
54;2021-04-23;3866;2084;161597;65688;22.1;9.0
54;2021-04-24;2347;1039;163944;66727;22.4;9.1
54;2021-04-25;284;277;164228;67004;22.5;9.2
54;2021-04-26;2306;1272;166534;68276;22.8;9.3
54;2021-04-27;3288;1438;169822;69714;23.3;9.5
54;2021-04-28;2975;1940;172797;71654;23.7;9.8
54;2021-04-29;3796;2073;176593;73727;24.2;10.1
54;2021-04-30;4492;1952;181085;75679;24.8;10.4
54;2021-05-01;2265;804;183350;76483;25.1;10.5
54;2021-05-02;229;68;183579;76551;25.1;10.5
54;2021-05-03;3096;937;186675;77488;25.6;10.6
54;2021-05-04;3514;1452;190189;78940;26.0;10.8
54;2021-05-05;4895;1409;195084;80349;26.7;11.0
54;2021-05-06;4434;2797;199518;83146;27.3;11.4
54;2021-05-07;4823;3397;204341;86543;28.0;11.8
54;2021-05-08;2030;644;206371;87187;28.3;11.9
54;2021-05-09;375;136;206746;87323;28.3;12.0
54;2021-05-10;3207;2234;209953;89557;28.7;12.3
54;2021-05-11;5491;2932;215444;92489;29.5;12.7
54;2021-05-12;4145;3386;219589;95875;30.1;13.1
54;2021-05-13;2648;492;222237;96367;30.4;13.2
54;2021-05-14;6883;2002;229120;98369;31.4;13.5
54;2021-05-15;5485;1322;234605;99691;32.1;13.6
54;2021-05-16;944;109;235549;99800;32.2;13.7
54;2021-05-17;3799;829;239348;100629;32.8;13.8
54;2021-05-18;3288;1104;242636;101733;33.2;13.9
54;2021-05-19;3464;1514;246100;103247;33.7;14.1
54;2021-05-20;4537;1616;250637;104863;34.3;14.4
54;2021-05-21;6753;2502;257390;107365;35.2;14.7
54;2021-05-22;5660;1376;263050;108741;36.0;14.9
54;2021-05-23;504;55;263554;108796;36.1;14.9
54;2021-05-24;1444;343;264998;109139;36.3;14.9
54;2021-05-25;4200;1533;269198;110672;36.9;15.2
54;2021-05-26;3535;2214;272733;112886;37.3;15.5
54;2021-05-27;4180;2419;276913;115305;37.9;15.8
54;2021-05-28;4988;3552;281901;118857;38.6;16.3
54;2021-05-29;3844;3996;285745;122853;39.1;16.8
54;2021-05-30;127;83;285872;122936;39.1;16.8
54;2021-05-31;2940;3059;288812;125995;39.5;17.3
54;2021-06-01;2622;4191;291434;130186;39.9;17.8
54;2021-06-02;2165;4086;293599;134272;40.2;18.4
54;2021-06-03;3146;5647;296745;139919;40.6;19.2
54;2021-06-04;5103;5468;301848;145387;41.3;19.9
54;2021-06-05;2342;3280;304190;148667;41.6;20.4
54;2021-06-06;72;236;304262;148903;41.7;20.4
54;2021-06-07;3705;2935;307967;151838;42.2;20.8
54;2021-06-08;4543;4267;312510;156105;42.8;21.4
54;2021-06-09;6002;3311;318512;159416;43.6;21.8
54;2021-06-10;5296;4445;323808;163861;44.3;22.4
54;2021-06-11;5023;4919;328831;168780;45.0;23.1
54;2021-06-12;4242;3226;333073;172006;45.6;23.5
54;2021-06-13;54;210;333127;172216;45.6;23.6
54;2021-06-14;2334;3594;335461;175810;45.9;24.1
54;2021-06-15;2831;4727;338292;180537;46.3;24.7
54;2021-06-16;3490;5657;341782;186194;46.8;25.5
54;2021-06-17;3138;5219;344920;191413;47.2;26.2
54;2021-06-18;4157;6238;349077;197651;47.8;27.1
54;2021-06-19;2648;3126;351725;200777;48.2;27.5
54;2021-06-20;101;339;351826;201116;48.2;27.5
54;2021-06-21;2556;4767;354382;205883;48.5;28.2
54;2021-06-22;2047;6221;356429;212104;48.8;29.0
54;2021-06-23;2244;5593;358673;217697;49.1;29.8
54;2021-06-24;2090;3454;360763;221151;49.4;30.3
54;2021-06-25;2196;7056;362959;228207;49.7;31.2
54;2021-06-26;2383;5672;365342;233879;50.0;32.0
54;2021-06-27;134;607;365476;234486;50.0;32.1
54;2021-06-28;1960;4355;367436;238841;50.3;32.7
54;2021-06-29;1941;5204;369377;244045;50.6;33.4
54;2021-06-30;1982;5122;371359;249167;50.8;34.1
54;2021-07-01;2143;5983;373502;255150;51.1;34.9
54;2021-07-02;2815;7563;376317;262713;51.5;36.0
54;2021-07-03;2836;4095;379153;266808;51.9;36.5
54;2021-07-04;196;498;379349;267306;51.9;36.6
54;2021-07-05;1667;4250;381016;271556;52.2;37.2
54;2021-07-06;2000;5079;383016;276635;52.4;37.9
54;2021-07-07;1904;4844;384920;281479;52.7;38.5
54;2021-07-08;1679;4111;386599;285590;52.9;39.1
54;2021-07-09;3204;6025;389803;291615;53.4;39.9
54;2021-07-10;2546;4375;392349;295990;53.7;40.5
54;2021-07-11;9;103;392358;296093;53.7;40.5
54;2021-07-12;2100;4697;394458;300790;54.0;41.2
54;2021-07-13;2620;4970;397078;305760;54.4;41.9
54;2021-07-14;1535;1506;398613;307266;54.6;42.1
54;2021-07-15;3172;4834;401785;312100;55.0;42.7
54;2021-07-16;4665;6214;406450;318314;55.6;43.6
54;2021-07-17;4005;4767;410455;323081;56.2;44.2
54;2021-07-18;1804;1687;412259;324768;56.4;44.5
54;2021-07-19;2592;4043;414851;328811;56.8;45.0
54;2021-07-20;2910;4813;417761;333624;57.2;45.7
54;2021-07-21;3134;6333;420895;339957;57.6;46.5
54;2021-07-22;3282;5730;424177;345687;58.1;47.3
54;2021-07-23;3982;6976;428159;352663;58.6;48.3
54;2021-07-24;2945;5321;431104;357984;59.0;49.0
54;2021-07-25;71;50;431175;358034;59.0;49.0
54;2021-07-26;2982;4173;434157;362207;59.4;49.6
54;2021-07-27;3717;4008;437874;366215;60.0;50.1
54;2021-07-28;5209;3875;443083;370090;60.7;50.7
54;2021-07-29;5158;3206;448241;373296;61.4;51.1
54;2021-07-30;5133;5003;453374;378299;62.1;51.8
54;2021-07-31;4537;3233;457911;381532;62.7;52.2
54;2021-08-01;257;73;458168;381605;62.7;52.2
54;2021-08-02;3097;3704;461265;385309;63.2;52.8
54;2021-08-03;4109;2918;465374;388227;63.7;53.2
54;2021-08-04;4427;2707;469801;390934;64.3;53.5
54;2021-08-05;4621;2434;474422;393368;65.0;53.9
54;2021-08-06;5455;3990;479877;397358;65.7;54.4
54;2021-08-07;3674;2829;483551;400187;66.2;54.8
54;2021-08-08;248;114;483799;400301;66.2;54.8
54;2021-08-09;2980;2694;486779;402995;66.6;55.2
54;2021-08-10;2564;3767;489343;406762;67.0;55.7
54;2021-08-11;2336;2565;491679;409327;67.3;56.0
54;2021-08-12;2191;3007;493870;412334;67.6;56.5
54;2021-08-13;2628;4448;496498;416782;68.0;57.1
54;2021-08-14;1436;2077;497934;418859;68.2;57.3
54;2021-08-15;31;43;497965;418902;68.2;57.4
54;2021-08-16;1862;3431;499827;422333;68.4;57.8
54;2021-08-17;1949;3312;501776;425645;68.7;58.3
54;2021-08-18;1500;4107;503276;429752;68.9;58.8
54;2021-08-19;1257;2790;504533;432542;69.1;59.2
54;2021-08-20;1877;4933;506410;437475;69.3;59.9
54;2021-08-21;1471;4014;507881;441489;69.5;60.4
54;2021-08-22;63;28;507944;441517;69.5;60.4
54;2021-08-23;1222;3858;509166;445375;69.7;61.0
54;2021-08-24;1140;3156;510306;448531;69.9;61.4
54;2021-08-25;1425;4382;511731;452913;70.1;62.0
54;2021-08-26;1006;3108;512737;456021;70.2;62.4
54;2021-08-27;1526;5325;514263;461346;70.4;63.2
54;2021-08-28;1144;4282;515407;465628;70.6;63.7
54;2021-08-29;16;50;515423;465678;70.6;63.8
54;2021-08-30;1214;4202;516637;469880;70.7;64.3
54;2021-08-31;1066;4707;517703;474587;70.9;65.0
54;2021-09-01;1106;3758;518809;478345;71.0;65.5
54;2021-09-02;728;2168;519537;480513;71.1;65.8
54;2021-09-03;983;3215;520520;483728;71.3;66.2
54;2021-09-04;1174;3429;521694;487157;71.4;66.7
54;2021-09-05;26;32;521720;487189;71.4;66.7
54;2021-09-06;493;1469;522213;488658;71.5;66.9
54;2021-09-07;594;1597;522807;490255;71.6;67.1
54;2021-09-08;630;1889;523437;492144;71.7;67.4
54;2021-09-09;928;2078;524365;494222;71.8;67.7
54;2021-09-10;1003;2784;525368;497006;71.9;68.0
54;2021-09-11;736;2694;526104;499700;72.0;68.4
54;2021-09-12;81;118;526185;499818;72.0;68.4
54;2021-09-13;634;1257;526819;501075;72.1;68.6
54;2021-09-14;609;1475;527428;502550;72.2;68.8
54;2021-09-15;627;1746;528055;504296;72.3;69.0
54;2021-09-16;633;713;528688;505009;72.4;69.1
54;2021-09-17;875;1529;529563;506538;72.5;69.4
54;2021-09-18;480;1437;530043;507975;72.6;69.5
54;2021-09-19;28;38;530071;508013;72.6;69.6
54;2021-09-20;370;658;530441;508671;72.6;69.6
54;2021-09-21;439;939;530880;509610;72.7;69.8
54;2021-09-22;400;1119;531280;510729;72.7;69.9
54;2021-09-23;298;845;531578;511574;72.8;70.0
54;2021-09-24;516;1178;532094;512752;72.8;70.2
54;2021-09-25;317;1076;532411;513828;72.9;70.3
54;2021-09-26;9;30;532420;513858;72.9;70.4
54;2021-09-27;231;675;532651;514533;72.9;70.4
54;2021-09-28;332;630;532983;515163;73.0;70.5
54;2021-09-29;387;805;533370;515968;73.0;70.6
54;2021-09-30;222;465;533592;516433;73.1;70.7
54;2021-10-01;462;1008;534054;517441;73.1;70.8
54;2021-10-02;387;954;534441;518395;73.2;71.0
54;2021-10-03;2;10;534443;518405;73.2;71.0
55;2020-12-27;0;0;0;0;0.0;0.0
55;2020-12-28;2;0;2;0;0.0;0.0
55;2020-12-29;0;0;2;0;0.0;0.0
55;2020-12-30;0;0;2;0;0.0;0.0
55;2020-12-31;0;0;2;0;0.0;0.0
55;2021-01-01;0;0;2;0;0.0;0.0
55;2021-01-02;0;0;2;0;0.0;0.0
55;2021-01-03;0;0;2;0;0.0;0.0
55;2021-01-04;1;0;3;0;0.0;0.0
55;2021-01-05;0;0;3;0;0.0;0.0
55;2021-01-06;0;0;3;0;0.0;0.0
55;2021-01-07;122;0;125;0;0.1;0.0
55;2021-01-08;127;0;252;0;0.1;0.0
55;2021-01-09;52;0;304;0;0.2;0.0
55;2021-01-10;0;0;304;0;0.2;0.0
55;2021-01-11;128;1;432;1;0.2;0.0
55;2021-01-12;119;0;551;1;0.3;0.0
55;2021-01-13;134;0;685;1;0.4;0.0
55;2021-01-14;645;7;1330;8;0.7;0.0
55;2021-01-15;237;0;1567;8;0.9;0.0
55;2021-01-16;62;0;1629;8;0.9;0.0
55;2021-01-17;1;0;1630;8;0.9;0.0
55;2021-01-18;414;1;2044;9;1.1;0.0
55;2021-01-19;352;3;2396;12;1.3;0.0
55;2021-01-20;456;2;2852;14;1.6;0.0
55;2021-01-21;430;0;3282;14;1.8;0.0
55;2021-01-22;390;0;3672;14;2.0;0.0
55;2021-01-23;49;0;3721;14;2.0;0.0
55;2021-01-24;0;0;3721;14;2.0;0.0
55;2021-01-25;436;0;4157;14;2.3;0.0
55;2021-01-26;431;0;4588;14;2.5;0.0
55;2021-01-27;424;0;5012;14;2.8;0.0
55;2021-01-28;485;97;5497;111;3.0;0.1
55;2021-01-29;159;50;5656;161;3.1;0.1
55;2021-01-30;92;27;5748;188;3.2;0.1
55;2021-01-31;0;0;5748;188;3.2;0.1
55;2021-02-01;153;155;5901;343;3.2;0.2
55;2021-02-02;159;133;6060;476;3.3;0.3
55;2021-02-03;53;139;6113;615;3.4;0.3
55;2021-02-04;235;378;6348;993;3.5;0.5
55;2021-02-05;174;138;6522;1131;3.6;0.6
55;2021-02-06;62;56;6584;1187;3.6;0.7
55;2021-02-07;2;53;6586;1240;3.6;0.7
55;2021-02-08;0;17;6586;1257;3.6;0.7
55;2021-02-09;92;115;6678;1372;3.7;0.8
55;2021-02-10;65;23;6743;1395;3.7;0.8
55;2021-02-11;175;93;6918;1488;3.8;0.8
55;2021-02-12;94;27;7012;1515;3.9;0.8
55;2021-02-13;0;0;7012;1515;3.9;0.8
55;2021-02-14;0;0;7012;1515;3.9;0.8
55;2021-02-15;15;306;7027;1821;3.9;1.0
55;2021-02-16;143;277;7170;2098;3.9;1.2
55;2021-02-17;26;388;7196;2486;4.0;1.4
55;2021-02-18;20;258;7216;2744;4.0;1.5
55;2021-02-19;125;245;7341;2989;4.0;1.6
55;2021-02-20;11;0;7352;2989;4.0;1.6
55;2021-02-21;0;0;7352;2989;4.0;1.6
55;2021-02-22;55;365;7407;3354;4.1;1.8
55;2021-02-23;85;366;7492;3720;4.1;2.0
55;2021-02-24;72;347;7564;4067;4.2;2.2
55;2021-02-25;270;621;7834;4688;4.3;2.6
55;2021-02-26;324;205;8158;4893;4.5;2.7
55;2021-02-27;125;85;8283;4978;4.6;2.7
55;2021-02-28;2;8;8285;4986;4.6;2.7
55;2021-03-01;77;118;8362;5104;4.6;2.8
55;2021-03-02;125;136;8487;5240;4.7;2.9
55;2021-03-03;198;3;8685;5243;4.8;2.9
55;2021-03-04;238;40;8923;5283;4.9;2.9
55;2021-03-05;362;43;9285;5326;5.1;2.9
55;2021-03-06;224;6;9509;5332;5.2;2.9
55;2021-03-07;74;1;9583;5333;5.3;2.9
55;2021-03-08;328;49;9911;5382;5.5;3.0
55;2021-03-09;635;48;10546;5430;5.8;3.0
55;2021-03-10;397;24;10943;5454;6.0;3.0
55;2021-03-11;597;139;11540;5593;6.4;3.1
55;2021-03-12;816;89;12356;5682;6.8;3.1
55;2021-03-13;522;12;12878;5694;7.1;3.1
55;2021-03-14;14;0;12892;5694;7.1;3.1
55;2021-03-15;393;23;13285;5717;7.3;3.1
55;2021-03-16;568;105;13853;5822;7.6;3.2
55;2021-03-17;683;21;14536;5843;8.0;3.2
55;2021-03-18;323;23;14859;5866;8.2;3.2
55;2021-03-19;471;59;15330;5925;8.4;3.3
55;2021-03-20;254;15;15584;5940;8.6;3.3
55;2021-03-21;1;1;15585;5941;8.6;3.3
55;2021-03-22;474;20;16059;5961;8.8;3.3
55;2021-03-23;972;65;17031;6026;9.4;3.3
55;2021-03-24;802;43;17833;6069;9.8;3.3
55;2021-03-25;1097;81;18930;6150;10.4;3.4
55;2021-03-26;602;36;19532;6186;10.8;3.4
55;2021-03-27;256;23;19788;6209;10.9;3.4
55;2021-03-28;0;0;19788;6209;10.9;3.4
55;2021-03-29;944;41;20732;6250;11.4;3.4
55;2021-03-30;1425;73;22157;6323;12.2;3.5
55;2021-03-31;1483;70;23640;6393;13.0;3.5
55;2021-04-01;1207;129;24847;6522;13.7;3.6
55;2021-04-02;902;69;25749;6591;14.2;3.6
55;2021-04-03;93;12;25842;6603;14.2;3.6
55;2021-04-04;2;0;25844;6603;14.2;3.6
55;2021-04-05;6;12;25850;6615;14.2;3.6
55;2021-04-06;933;276;26783;6891;14.7;3.8
55;2021-04-07;993;237;27776;7128;15.3;3.9
55;2021-04-08;1649;420;29425;7548;16.2;4.2
55;2021-04-09;1431;261;30856;7809;17.0;4.3
55;2021-04-10;243;175;31099;7984;17.1;4.4
55;2021-04-11;452;22;31551;8006;17.4;4.4
55;2021-04-12;855;328;32406;8334;17.8;4.6
55;2021-04-13;1355;526;33761;8860;18.6;4.9
55;2021-04-14;1372;726;35133;9586;19.3;5.3
55;2021-04-15;1637;458;36770;10044;20.2;5.5
55;2021-04-16;704;379;37474;10423;20.6;5.7
55;2021-04-17;677;31;38151;10454;21.0;5.8
55;2021-04-18;38;18;38189;10472;21.0;5.8
55;2021-04-19;961;346;39150;10818;21.6;6.0
55;2021-04-20;1173;771;40323;11589;22.2;6.4
55;2021-04-21;990;640;41313;12229;22.7;6.7
55;2021-04-22;1099;674;42412;12903;23.3;7.1
55;2021-04-23;1424;598;43836;13501;24.1;7.4
55;2021-04-24;313;124;44149;13625;24.3;7.5
55;2021-04-25;384;51;44533;13676;24.5;7.5
55;2021-04-26;478;815;45011;14491;24.8;8.0
55;2021-04-27;570;994;45581;15485;25.1;8.5
55;2021-04-28;931;815;46512;16300;25.6;9.0
55;2021-04-29;1118;857;47630;17157;26.2;9.4
55;2021-04-30;1280;620;48910;17777;26.9;9.8
55;2021-05-01;153;131;49063;17908;27.0;9.9
55;2021-05-02;2;3;49065;17911;27.0;9.9
55;2021-05-03;1209;629;50274;18540;27.7;10.2
55;2021-05-04;683;1178;50957;19718;28.1;10.9
55;2021-05-05;656;1070;51613;20788;28.4;11.4
55;2021-05-06;1350;1157;52963;21945;29.2;12.1
55;2021-05-07;1433;554;54396;22499;29.9;12.4
55;2021-05-08;156;77;54552;22576;30.0;12.4
55;2021-05-09;62;522;54614;23098;30.1;12.7
55;2021-05-10;860;1029;55474;24127;30.5;13.3
55;2021-05-11;1072;1372;56546;25499;31.1;14.0
55;2021-05-12;1031;1760;57577;27259;31.7;15.0
55;2021-05-13;99;75;57676;27334;31.8;15.0
55;2021-05-14;352;555;58028;27889;31.9;15.4
55;2021-05-15;291;486;58319;28375;32.1;15.6
55;2021-05-16;3;10;58322;28385;32.1;15.6
55;2021-05-17;1028;841;59350;29226;32.7;16.1
55;2021-05-18;1567;886;60917;30112;33.5;16.6
55;2021-05-19;1809;778;62726;30890;34.5;17.0
55;2021-05-20;2215;730;64941;31620;35.8;17.4
55;2021-05-21;2010;799;66951;32419;36.9;17.8
55;2021-05-22;198;167;67149;32586;37.0;17.9
55;2021-05-23;23;120;67172;32706;37.0;18.0
55;2021-05-24;0;0;67172;32706;37.0;18.0
55;2021-05-25;1347;651;68519;33357;37.7;18.4
55;2021-05-26;1674;1017;70193;34374;38.6;18.9
55;2021-05-27;1322;981;71515;35355;39.4;19.5
55;2021-05-28;1521;928;73036;36283;40.2;20.0
55;2021-05-29;1403;695;74439;36978;41.0;20.4
55;2021-05-30;15;205;74454;37183;41.0;20.5
55;2021-05-31;1048;1130;75502;38313;41.6;21.1
55;2021-06-01;919;957;76421;39270;42.1;21.6
55;2021-06-02;1162;979;77583;40249;42.7;22.2
55;2021-06-03;703;538;78286;40787;43.1;22.5
55;2021-06-04;1388;1098;79674;41885;43.9;23.1
55;2021-06-05;1366;278;81040;42163;44.6;23.2
55;2021-06-06;0;2;81040;42165;44.6;23.2
55;2021-06-07;791;714;81831;42879;45.1;23.6
55;2021-06-08;700;1073;82531;43952;45.4;24.2
55;2021-06-09;852;868;83383;44820;45.9;24.7
55;2021-06-10;378;275;83761;45095;46.1;24.8
55;2021-06-11;528;1285;84289;46380;46.4;25.5
55;2021-06-12;761;518;85050;46898;46.8;25.8
55;2021-06-13;265;33;85315;46931;47.0;25.8
55;2021-06-14;391;1362;85706;48293;47.2;26.6
55;2021-06-15;574;1212;86280;49505;47.5;27.3
55;2021-06-16;735;832;87015;50337;47.9;27.7
55;2021-06-17;425;858;87440;51195;48.1;28.2
55;2021-06-18;667;1473;88107;52668;48.5;29.0
55;2021-06-19;593;454;88700;53122;48.8;29.2
55;2021-06-20;0;0;88700;53122;48.8;29.2
55;2021-06-21;441;1023;89141;54145;49.1;29.8
55;2021-06-22;335;1012;89476;55157;49.3;30.4
55;2021-06-23;626;1209;90102;56366;49.6;31.0
55;2021-06-24;163;433;90265;56799;49.7;31.3
55;2021-06-25;642;1227;90907;58026;50.0;31.9
55;2021-06-26;418;341;91325;58367;50.3;32.1
55;2021-06-27;1;2;91326;58369;50.3;32.1
55;2021-06-28;149;1379;91475;59748;50.4;32.9
55;2021-06-29;201;1287;91676;61035;50.5;33.6
55;2021-06-30;272;1927;91948;62962;50.6;34.7
55;2021-07-01;388;1977;92336;64939;50.8;35.8
55;2021-07-02;391;1719;92727;66658;51.0;36.7
55;2021-07-03;107;262;92834;66920;51.1;36.8
55;2021-07-04;12;19;92846;66939;51.1;36.9
55;2021-07-05;222;1508;93068;68447;51.2;37.7
55;2021-07-06;327;898;93395;69345;51.4;38.2
55;2021-07-07;388;1801;93783;71146;51.6;39.2
55;2021-07-08;534;1594;94317;72740;51.9;40.0
55;2021-07-09;456;1478;94773;74218;52.2;40.9
55;2021-07-10;356;1112;95129;75330;52.4;41.5
55;2021-07-11;0;9;95129;75339;52.4;41.5
55;2021-07-12;608;1166;95737;76505;52.7;42.1
55;2021-07-13;599;1487;96336;77992;53.0;42.9
55;2021-07-14;1;13;96337;78005;53.0;42.9
55;2021-07-15;782;1645;97119;79650;53.5;43.9
55;2021-07-16;1255;1807;98374;81457;54.2;44.8
55;2021-07-17;1283;821;99657;82278;54.9;45.3
55;2021-07-18;1;2;99658;82280;54.9;45.3
55;2021-07-19;597;785;100255;83065;55.2;45.7
55;2021-07-20;1001;1019;101256;84084;55.7;46.3
55;2021-07-21;1482;1369;102738;85453;56.6;47.0
55;2021-07-22;1174;565;103912;86018;57.2;47.4
55;2021-07-23;1113;1354;105025;87372;57.8;48.1
55;2021-07-24;819;760;105844;88132;58.3;48.5
55;2021-07-25;120;229;105964;88361;58.3;48.6
55;2021-07-26;668;444;106632;88805;58.7;48.9
55;2021-07-27;1166;479;107798;89284;59.3;49.2
55;2021-07-28;1039;1063;108837;90347;59.9;49.7
55;2021-07-29;670;446;109507;90793;60.3;50.0
55;2021-07-30;1272;966;110779;91759;61.0;50.5
55;2021-07-31;714;613;111493;92372;61.4;50.9
55;2021-08-01;9;5;111502;92377;61.4;50.9
55;2021-08-02;820;443;112322;92820;61.8;51.1
55;2021-08-03;792;417;113114;93237;62.3;51.3
55;2021-08-04;1248;950;114362;94187;63.0;51.9
55;2021-08-05;1055;324;115417;94511;63.5;52.0
55;2021-08-06;819;1095;116236;95606;64.0;52.6
55;2021-08-07;596;336;116832;95942;64.3;52.8
55;2021-08-08;0;0;116832;95942;64.3;52.8
55;2021-08-09;402;306;117234;96248;64.5;53.0
55;2021-08-10;447;776;117681;97024;64.8;53.4
55;2021-08-11;595;640;118276;97664;65.1;53.8
55;2021-08-12;327;488;118603;98152;65.3;54.0
55;2021-08-13;439;1110;119042;99262;65.5;54.6
55;2021-08-14;144;190;119186;99452;65.6;54.8
55;2021-08-15;11;5;119197;99457;65.6;54.8
55;2021-08-16;246;739;119443;100196;65.8;55.2
55;2021-08-17;259;289;119702;100485;65.9;55.3
55;2021-08-18;547;1241;120249;101726;66.2;56.0
55;2021-08-19;450;960;120699;102686;66.4;56.5
55;2021-08-20;624;1012;121323;103698;66.8;57.1
55;2021-08-21;292;772;121615;104470;67.0;57.5
55;2021-08-22;8;6;121623;104476;67.0;57.5
55;2021-08-23;357;612;121980;105088;67.2;57.9
55;2021-08-24;338;833;122318;105921;67.3;58.3
55;2021-08-25;678;1173;122996;107094;67.7;59.0
55;2021-08-26;473;1253;123469;108347;68.0;59.6
55;2021-08-27;333;1246;123802;109593;68.2;60.3
55;2021-08-28;387;578;124189;110171;68.4;60.7
55;2021-08-29;216;59;124405;110230;68.5;60.7
55;2021-08-30;135;677;124540;110907;68.6;61.1
55;2021-08-31;284;824;124824;111731;68.7;61.5
55;2021-09-01;550;1269;125374;113000;69.0;62.2
55;2021-09-02;207;896;125581;113896;69.1;62.7
55;2021-09-03;408;1275;125989;115171;69.4;63.4
55;2021-09-04;287;600;126276;115771;69.5;63.7
55;2021-09-05;18;91;126294;115862;69.5;63.8
55;2021-09-06;60;127;126354;115989;69.6;63.9
55;2021-09-07;277;595;126631;116584;69.7;64.2
55;2021-09-08;273;338;126904;116922;69.9;64.4
55;2021-09-09;198;595;127102;117517;70.0;64.7
55;2021-09-10;180;550;127282;118067;70.1;65.0
55;2021-09-11;93;319;127375;118386;70.1;65.2
55;2021-09-12;1;2;127376;118388;70.1;65.2
55;2021-09-13;95;431;127471;118819;70.2;65.4
55;2021-09-14;230;284;127701;119103;70.3;65.6
55;2021-09-15;273;637;127974;119740;70.5;65.9
55;2021-09-16;96;181;128070;119921;70.5;66.0
55;2021-09-17;86;122;128156;120043;70.6;66.1
55;2021-09-18;138;391;128294;120434;70.6;66.3
55;2021-09-19;1;59;128295;120493;70.6;66.3
55;2021-09-20;65;193;128360;120686;70.7;66.4
55;2021-09-21;100;332;128460;121018;70.7;66.6
55;2021-09-22;109;395;128569;121413;70.8;66.8
55;2021-09-23;95;427;128664;121840;70.8;67.1
55;2021-09-24;88;370;128752;122210;70.9;67.3
55;2021-09-25;56;159;128808;122369;70.9;67.4
55;2021-09-26;0;34;128808;122403;70.9;67.4
55;2021-09-27;46;127;128854;122530;70.9;67.5
55;2021-09-28;51;124;128905;122654;71.0;67.5
55;2021-09-29;156;859;129061;123513;71.1;68.0
55;2021-09-30;58;330;129119;123843;71.1;68.2
55;2021-10-01;56;272;129175;124115;71.1;68.3
55;2021-10-02;87;371;129262;124486;71.2;68.5
55;2021-10-03;0;60;129262;124546;71.2;68.6
56;2020-12-27;0;0;0;0;0.0;0.0
56;2020-12-28;1;0;1;0;0.0;0.0
56;2020-12-29;0;0;1;0;0.0;0.0
56;2020-12-30;0;0;1;0;0.0;0.0
56;2020-12-31;0;0;1;0;0.0;0.0
56;2021-01-01;0;0;1;0;0.0;0.0
56;2021-01-02;1;0;2;0;0.0;0.0
56;2021-01-03;2;0;4;0;0.0;0.0
56;2021-01-04;2;0;6;0;0.0;0.0
56;2021-01-05;1;0;7;0;0.0;0.0
56;2021-01-06;2;0;9;0;0.0;0.0
56;2021-01-07;198;0;207;0;0.0;0.0
56;2021-01-08;119;0;326;0;0.0;0.0
56;2021-01-09;1;0;327;0;0.0;0.0
56;2021-01-10;1;0;328;0;0.0;0.0
56;2021-01-11;242;0;570;0;0.1;0.0
56;2021-01-12;755;1;1325;1;0.2;0.0
56;2021-01-13;638;1;1963;2;0.3;0.0
56;2021-01-14;970;2;2933;4;0.4;0.0
56;2021-01-15;844;5;3777;9;0.5;0.0
56;2021-01-16;235;3;4012;12;0.5;0.0
56;2021-01-17;27;0;4039;12;0.5;0.0
56;2021-01-18;1006;1;5045;13;0.7;0.0
56;2021-01-19;866;0;5911;13;0.8;0.0
56;2021-01-20;885;1;6796;14;0.9;0.0
56;2021-01-21;1450;1;8246;15;1.1;0.0
56;2021-01-22;1183;3;9429;18;1.2;0.0
56;2021-01-23;319;2;9748;20;1.3;0.0
56;2021-01-24;6;0;9754;20;1.3;0.0
56;2021-01-25;830;0;10584;20;1.4;0.0
56;2021-01-26;1034;4;11618;24;1.5;0.0
56;2021-01-27;1081;59;12699;83;1.7;0.0
56;2021-01-28;975;119;13674;202;1.8;0.0
56;2021-01-29;875;100;14549;302;1.9;0.0
56;2021-01-30;139;18;14688;320;1.9;0.0
56;2021-01-31;0;0;14688;320;1.9;0.0
56;2021-02-01;480;113;15168;433;2.0;0.1
56;2021-02-02;941;246;16109;679;2.1;0.1
56;2021-02-03;1025;254;17134;933;2.3;0.1
56;2021-02-04;4702;332;21836;1265;2.9;0.2
56;2021-02-05;3595;418;25431;1683;3.4;0.2
56;2021-02-06;551;162;25982;1845;3.4;0.2
56;2021-02-07;136;26;26118;1871;3.5;0.2
56;2021-02-08;297;257;26415;2128;3.5;0.3
56;2021-02-09;794;406;27209;2534;3.6;0.3
56;2021-02-10;864;637;28073;3171;3.7;0.4
56;2021-02-11;973;999;29046;4170;3.8;0.6
56;2021-02-12;1153;567;30199;4737;4.0;0.6
56;2021-02-13;220;76;30419;4813;4.0;0.6
56;2021-02-14;6;45;30425;4858;4.0;0.6
56;2021-02-15;623;835;31048;5693;4.1;0.8
56;2021-02-16;1219;586;32267;6279;4.3;0.8
56;2021-02-17;1189;771;33456;7050;4.4;0.9
56;2021-02-18;1351;707;34807;7757;4.6;1.0
56;2021-02-19;1323;706;36130;8463;4.8;1.1
56;2021-02-20;366;193;36496;8656;4.8;1.1
56;2021-02-21;2;0;36498;8656;4.8;1.1
56;2021-02-22;376;580;36874;9236;4.9;1.2
56;2021-02-23;742;737;37616;9973;5.0;1.3
56;2021-02-24;918;907;38534;10880;5.1;1.4
56;2021-02-25;2032;3831;40566;14711;5.4;1.9
56;2021-02-26;2356;2100;42922;16811;5.7;2.2
56;2021-02-27;748;366;43670;17177;5.8;2.3
56;2021-02-28;15;112;43685;17289;5.8;2.3
56;2021-03-01;649;449;44334;17738;5.9;2.3
56;2021-03-02;980;655;45314;18393;6.0;2.4
56;2021-03-03;1150;765;46464;19158;6.1;2.5
56;2021-03-04;1965;925;48429;20083;6.4;2.7
56;2021-03-05;2584;1322;51013;21405;6.8;2.8
56;2021-03-06;1209;193;52222;21598;6.9;2.9
56;2021-03-07;282;24;52504;21622;6.9;2.9
56;2021-03-08;1141;349;53645;21971;7.1;2.9
56;2021-03-09;2042;541;55687;22512;7.4;3.0
56;2021-03-10;2000;850;57687;23362;7.6;3.1
56;2021-03-11;3251;695;60938;24057;8.1;3.2
56;2021-03-12;4208;774;65146;24831;8.6;3.3
56;2021-03-13;1885;146;67031;24977;8.9;3.3
56;2021-03-14;195;4;67226;24981;8.9;3.3
56;2021-03-15;1285;521;68511;25502;9.1;3.4
56;2021-03-16;1088;998;69599;26500;9.2;3.5
56;2021-03-17;1371;757;70970;27257;9.4;3.6
56;2021-03-18;2001;1840;72971;29097;9.7;3.9
56;2021-03-19;2947;1366;75918;30463;10.0;4.0
56;2021-03-20;1492;202;77410;30665;10.2;4.1
56;2021-03-21;209;22;77619;30687;10.3;4.1
56;2021-03-22;1612;400;79231;31087;10.5;4.1
56;2021-03-23;2810;678;82041;31765;10.9;4.2
56;2021-03-24;3450;520;85491;32285;11.3;4.3
56;2021-03-25;4238;714;89729;32999;11.9;4.4
56;2021-03-26;5092;761;94821;33760;12.5;4.5
56;2021-03-27;1502;288;96323;34048;12.7;4.5
56;2021-03-28;264;11;96587;34059;12.8;4.5
56;2021-03-29;2236;501;98823;34560;13.1;4.6
56;2021-03-30;3519;785;102342;35345;13.5;4.7
56;2021-03-31;3116;719;105458;36064;14.0;4.8
56;2021-04-01;4078;818;109536;36882;14.5;4.9
56;2021-04-02;3925;945;113461;37827;15.0;5.0
56;2021-04-03;1186;270;114647;38097;15.2;5.0
56;2021-04-04;233;4;114880;38101;15.2;5.0
56;2021-04-05;244;8;115124;38109;15.2;5.0
56;2021-04-06;2828;1233;117952;39342;15.6;5.2
56;2021-04-07;4023;1193;121975;40535;16.1;5.4
56;2021-04-08;5295;1164;127270;41699;16.8;5.5
56;2021-04-09;7396;1281;134666;42980;17.8;5.7
56;2021-04-10;2576;428;137242;43408;18.2;5.7
56;2021-04-11;194;101;137436;43509;18.2;5.8
56;2021-04-12;3932;832;141368;44341;18.7;5.9
56;2021-04-13;5965;1263;147333;45604;19.5;6.0
56;2021-04-14;5168;1433;152501;47037;20.2;6.2
56;2021-04-15;7153;1775;159654;48812;21.1;6.5
56;2021-04-16;7842;2012;167496;50824;22.2;6.7
56;2021-04-17;3130;648;170626;51472;22.6;6.8
56;2021-04-18;528;110;171154;51582;22.7;6.8
56;2021-04-19;3719;1261;174873;52843;23.1;7.0
56;2021-04-20;4107;1974;178980;54817;23.7;7.3
56;2021-04-21;4059;2321;183039;57138;24.2;7.6
56;2021-04-22;5173;1918;188212;59056;24.9;7.8
56;2021-04-23;5172;2414;193384;61470;25.6;8.1
56;2021-04-24;2899;639;196283;62109;26.0;8.2
56;2021-04-25;465;149;196748;62258;26.0;8.2
56;2021-04-26;4710;1658;201458;63916;26.7;8.5
56;2021-04-27;5097;2538;206555;66454;27.3;8.8
56;2021-04-28;4966;2243;211521;68697;28.0;9.1
56;2021-04-29;5843;2925;217364;71622;28.8;9.5
56;2021-04-30;6246;2786;223610;74408;29.6;9.8
56;2021-05-01;2489;363;226099;74771;29.9;9.9
56;2021-05-02;307;254;226406;75025;30.0;9.9
56;2021-05-03;3863;2050;230269;77075;30.5;10.2
56;2021-05-04;4379;3899;234648;80974;31.1;10.7
56;2021-05-05;3523;3871;238171;84845;31.5;11.2
56;2021-05-06;4377;5430;242548;90275;32.1;11.9
56;2021-05-07;4267;4990;246815;95265;32.7;12.6
56;2021-05-08;1645;320;248460;95585;32.9;12.7
56;2021-05-09;494;227;248954;95812;32.9;12.7
56;2021-05-10;3751;3803;252705;99615;33.4;13.2
56;2021-05-11;4169;5041;256874;104656;34.0;13.9
56;2021-05-12;4342;4771;261216;109427;34.6;14.5
56;2021-05-13;2397;1014;263613;110441;34.9;14.6
56;2021-05-14;4227;4347;267840;114788;35.4;15.2
56;2021-05-15;2488;1895;270328;116683;35.8;15.4
56;2021-05-16;237;488;270565;117171;35.8;15.5
56;2021-05-17;2513;3664;273078;120835;36.1;16.0
56;2021-05-18;3522;4092;276600;124927;36.6;16.5
56;2021-05-19;3527;3391;280127;128318;37.1;17.0
56;2021-05-20;3805;4808;283932;133126;37.6;17.6
56;2021-05-21;3748;5217;287680;138343;38.1;18.3
56;2021-05-22;1697;2207;289377;140550;38.3;18.6
56;2021-05-23;284;197;289661;140747;38.3;18.6
56;2021-05-24;2058;497;291719;141244;38.6;18.7
56;2021-05-25;3140;4471;294859;145715;39.0;19.3
56;2021-05-26;3735;3933;298594;149648;39.5;19.8
56;2021-05-27;4362;4863;302956;154511;40.1;20.4
56;2021-05-28;4638;5938;307594;160449;40.7;21.2
56;2021-05-29;1886;1632;309480;162081;41.0;21.5
56;2021-05-30;318;67;309798;162148;41.0;21.5
56;2021-05-31;4502;3212;314300;165360;41.6;21.9
56;2021-06-01;5664;3379;319964;168739;42.3;22.3
56;2021-06-02;5631;2946;325595;171685;43.1;22.7
56;2021-06-03;6189;3292;331784;174977;43.9;23.2
56;2021-06-04;5813;4401;337597;179378;44.7;23.7
56;2021-06-05;4346;2372;341943;181750;45.3;24.1
56;2021-06-06;496;615;342439;182365;45.3;24.1
56;2021-06-07;5101;3167;347540;185532;46.0;24.6
56;2021-06-08;6070;3365;353610;188897;46.8;25.0
56;2021-06-09;6429;2811;360039;191708;47.7;25.4
56;2021-06-10;7478;2873;367517;194581;48.6;25.8
56;2021-06-11;6768;3864;374285;198445;49.5;26.3
56;2021-06-12;5103;2062;379388;200507;50.2;26.5
56;2021-06-13;1978;439;381366;200946;50.5;26.6
56;2021-06-14;3313;4589;384679;205535;50.9;27.2
56;2021-06-15;4201;4878;388880;210413;51.5;27.8
56;2021-06-16;4494;4501;393374;214914;52.1;28.4
56;2021-06-17;4257;4748;397631;219662;52.6;29.1
56;2021-06-18;4513;5967;402144;225629;53.2;29.9
56;2021-06-19;3832;2144;405976;227773;53.7;30.1
56;2021-06-20;1503;340;407479;228113;53.9;30.2
56;2021-06-21;3306;4461;410785;232574;54.4;30.8
56;2021-06-22;3483;5433;414268;238007;54.8;31.5
56;2021-06-23;3763;5061;418031;243068;55.3;32.2
56;2021-06-24;3478;5318;421509;248386;55.8;32.9
56;2021-06-25;3884;6280;425393;254666;56.3;33.7
56;2021-06-26;3202;2915;428595;257581;56.7;34.1
56;2021-06-27;305;163;428900;257744;56.8;34.1
56;2021-06-28;1575;3982;430475;261726;57.0;34.6
56;2021-06-29;2433;5761;432908;267487;57.3;35.4
56;2021-06-30;2499;5560;435407;273047;57.6;36.1
56;2021-07-01;2735;4956;438142;278003;58.0;36.8
56;2021-07-02;2656;6201;440798;284204;58.3;37.6
56;2021-07-03;2203;2677;443001;286881;58.6;38.0
56;2021-07-04;778;811;443779;287692;58.7;38.1
56;2021-07-05;1872;5442;445651;293134;59.0;38.8
56;2021-07-06;2190;5931;447841;299065;59.3;39.6
56;2021-07-07;2844;5642;450685;304707;59.6;40.3
56;2021-07-08;3085;6035;453770;310742;60.1;41.1
56;2021-07-09;2213;7097;455983;317839;60.3;42.1
56;2021-07-10;1126;3000;457109;320839;60.5;42.5
56;2021-07-11;256;344;457365;321183;60.5;42.5
56;2021-07-12;2181;6605;459546;327788;60.8;43.4
56;2021-07-13;3259;7466;462805;335254;61.3;44.4
56;2021-07-14;1785;2591;464590;337845;61.5;44.7
56;2021-07-15;3820;7068;468410;344913;62.0;45.6
56;2021-07-16;4076;8082;472486;352995;62.5;46.7
56;2021-07-17;2320;3524;474806;356519;62.8;47.2
56;2021-07-18;256;478;475062;356997;62.9;47.2
56;2021-07-19;2868;6357;477930;363354;63.3;48.1
56;2021-07-20;3722;7910;481652;371264;63.7;49.1
56;2021-07-21;3095;7516;484747;378780;64.2;50.1
56;2021-07-22;4391;8027;489138;386807;64.7;51.2
56;2021-07-23;4389;8406;493527;395213;65.3;52.3
56;2021-07-24;1687;4600;495214;399813;65.5;52.9
56;2021-07-25;551;1916;495765;401729;65.6;53.2
56;2021-07-26;3680;5451;499445;407180;66.1;53.9
56;2021-07-27;5375;6194;504820;413374;66.8;54.7
56;2021-07-28;4689;5463;509509;418837;67.4;55.4
56;2021-07-29;5378;5626;514887;424463;68.1;56.2
56;2021-07-30;5383;5863;520270;430326;68.9;57.0
56;2021-07-31;2157;2690;522427;433016;69.1;57.3
56;2021-08-01;1254;977;523681;433993;69.3;57.4
56;2021-08-02;4536;4598;528217;438591;69.9;58.0
56;2021-08-03;6384;4957;534601;443548;70.8;58.7
56;2021-08-04;5953;4363;540554;447911;71.5;59.3
56;2021-08-05;6097;4605;546651;452516;72.3;59.9
56;2021-08-06;5855;4925;552506;457441;73.1;60.5
56;2021-08-07;2859;2225;555365;459666;73.5;60.8
56;2021-08-08;1830;566;557195;460232;73.7;60.9
56;2021-08-09;3936;4266;561131;464498;74.3;61.5
56;2021-08-10;4927;4612;566058;469110;74.9;62.1
56;2021-08-11;4565;4137;570623;473247;75.5;62.6
56;2021-08-12;4487;4544;575110;477791;76.1;63.2
56;2021-08-13;4214;4814;579324;482605;76.7;63.9
56;2021-08-14;1792;2136;581116;484741;76.9;64.2
56;2021-08-15;348;485;581464;485226;77.0;64.2
56;2021-08-16;3065;4521;584529;489747;77.4;64.8
56;2021-08-17;3762;5055;588291;494802;77.9;65.5
56;2021-08-18;3738;4609;592029;499411;78.4;66.1
56;2021-08-19;3068;4992;595097;504403;78.8;66.8
56;2021-08-20;2901;5259;597998;509662;79.1;67.5
56;2021-08-21;1159;2399;599157;512061;79.3;67.8
56;2021-08-22;129;503;599286;512564;79.3;67.8
56;2021-08-23;1927;4969;601213;517533;79.6;68.5
56;2021-08-24;1922;5513;603135;523046;79.8;69.2
56;2021-08-25;1709;5056;604844;528102;80.1;69.9
56;2021-08-26;1409;5325;606253;533427;80.2;70.6
56;2021-08-27;1748;5878;608001;539305;80.5;71.4
56;2021-08-28;604;2801;608605;542106;80.5;71.7
56;2021-08-29;79;476;608684;542582;80.6;71.8
56;2021-08-30;1381;4746;610065;547328;80.7;72.4
56;2021-08-31;1473;4793;611538;552121;80.9;73.1
56;2021-09-01;1319;4198;612857;556319;81.1;73.6
56;2021-09-02;1081;4037;613938;560356;81.3;74.2
56;2021-09-03;1101;4597;615039;564953;81.4;74.8
56;2021-09-04;765;2445;615804;567398;81.5;75.1
56;2021-09-05;128;371;615932;567769;81.5;75.1
56;2021-09-06;883;3622;616815;571391;81.6;75.6
56;2021-09-07;817;3470;617632;574861;81.7;76.1
56;2021-09-08;965;3468;618597;578329;81.9;76.5
56;2021-09-09;797;3023;619394;581352;82.0;76.9
56;2021-09-10;937;3489;620331;584841;82.1;77.4
56;2021-09-11;473;2109;620804;586950;82.2;77.7
56;2021-09-12;34;171;620838;587121;82.2;77.7
56;2021-09-13;753;2677;621591;589798;82.3;78.1
56;2021-09-14;695;2777;622286;592575;82.4;78.4
56;2021-09-15;713;2499;622999;595074;82.5;78.8
56;2021-09-16;702;1591;623701;596665;82.5;79.0
56;2021-09-17;756;2148;624457;598813;82.6;79.3
56;2021-09-18;305;1706;624762;600519;82.7;79.5
56;2021-09-19;32;112;624794;600631;82.7;79.5
56;2021-09-20;426;1288;625220;601919;82.7;79.7
56;2021-09-21;497;1165;625717;603084;82.8;79.8
56;2021-09-22;464;1704;626181;604788;82.9;80.0
56;2021-09-23;543;1048;626724;605836;82.9;80.2
56;2021-09-24;576;1613;627300;607449;83.0;80.4
56;2021-09-25;251;1028;627551;608477;83.1;80.5
56;2021-09-26;12;79;627563;608556;83.1;80.5
56;2021-09-27;475;1000;628038;609556;83.1;80.7
56;2021-09-28;434;958;628472;610514;83.2;80.8
56;2021-09-29;386;1168;628858;611682;83.2;81.0
56;2021-09-30;330;606;629188;612288;83.3;81.0
56;2021-10-01;513;1255;629701;613543;83.3;81.2
56;2021-10-02;155;400;629856;613943;83.4;81.3
56;2021-10-03;5;77;629861;614020;83.4;81.3
57;2020-12-27;2;0;2;0;0.0;0.0
57;2020-12-28;0;0;2;0;0.0;0.0
57;2020-12-29;2;0;4;0;0.0;0.0
57;2020-12-30;1;0;5;0;0.0;0.0
57;2020-12-31;0;0;5;0;0.0;0.0
57;2021-01-01;1;0;6;0;0.0;0.0
57;2021-01-02;3;0;9;0;0.0;0.0
57;2021-01-03;0;0;9;0;0.0;0.0
57;2021-01-04;17;0;26;0;0.0;0.0
57;2021-01-05;199;0;225;0;0.0;0.0
57;2021-01-06;226;1;451;1;0.0;0.0
57;2021-01-07;586;2;1037;3;0.1;0.0
57;2021-01-08;509;2;1546;5;0.1;0.0
57;2021-01-09;203;0;1749;5;0.2;0.0
57;2021-01-10;109;1;1858;6;0.2;0.0
57;2021-01-11;470;1;2328;7;0.2;0.0
57;2021-01-12;612;5;2940;12;0.3;0.0
57;2021-01-13;696;2;3636;14;0.4;0.0
57;2021-01-14;708;6;4344;20;0.4;0.0
57;2021-01-15;636;5;4980;25;0.5;0.0
57;2021-01-16;452;1;5432;26;0.5;0.0
57;2021-01-17;493;1;5925;27;0.6;0.0
57;2021-01-18;2715;20;8640;47;0.8;0.0
57;2021-01-19;2567;20;11207;67;1.1;0.0
57;2021-01-20;2764;17;13971;84;1.3;0.0
57;2021-01-21;1797;5;15768;89;1.5;0.0
57;2021-01-22;1325;6;17093;95;1.7;0.0
57;2021-01-23;543;15;17636;110;1.7;0.0
57;2021-01-24;1;0;17637;110;1.7;0.0
57;2021-01-25;869;174;18506;284;1.8;0.0
57;2021-01-26;1112;202;19618;486;1.9;0.0
57;2021-01-27;1070;160;20688;646;2.0;0.1
57;2021-01-28;1040;241;21728;887;2.1;0.1
57;2021-01-29;983;368;22711;1255;2.2;0.1
57;2021-01-30;440;82;23151;1337;2.2;0.1
57;2021-01-31;11;16;23162;1353;2.2;0.1
57;2021-02-01;828;321;23990;1674;2.3;0.2
57;2021-02-02;989;334;24979;2008;2.4;0.2
57;2021-02-03;986;294;25965;2302;2.5;0.2
57;2021-02-04;1138;773;27103;3075;2.6;0.3
57;2021-02-05;927;324;28030;3399;2.7;0.3
57;2021-02-06;481;308;28511;3707;2.8;0.4
57;2021-02-07;103;333;28614;4040;2.8;0.4
57;2021-02-08;1258;1395;29872;5435;2.9;0.5
57;2021-02-09;1763;1575;31635;7010;3.1;0.7
57;2021-02-10;1712;1957;33347;8967;3.2;0.9
57;2021-02-11;1488;1265;34835;10232;3.4;1.0
57;2021-02-12;1227;612;36062;10844;3.5;1.0
57;2021-02-13;1152;133;37214;10977;3.6;1.1
57;2021-02-14;1211;27;38425;11004;3.7;1.1
57;2021-02-15;766;698;39191;11702;3.8;1.1
57;2021-02-16;1076;655;40267;12357;3.9;1.2
57;2021-02-17;1008;790;41275;13147;4.0;1.3
57;2021-02-18;976;968;42251;14115;4.1;1.4
57;2021-02-19;956;730;43207;14845;4.2;1.4
57;2021-02-20;1172;487;44379;15332;4.3;1.5
57;2021-02-21;323;13;44702;15345;4.3;1.5
57;2021-02-22;1230;735;45932;16080;4.4;1.6
57;2021-02-23;2234;917;48166;16997;4.6;1.6
57;2021-02-24;2287;822;50453;17819;4.9;1.7
57;2021-02-25;3297;945;53750;18764;5.2;1.8
57;2021-02-26;3593;826;57343;19590;5.5;1.9
57;2021-02-27;3697;478;61040;20068;5.9;1.9
57;2021-02-28;1897;58;62937;20126;6.1;1.9
57;2021-03-01;2071;1201;65008;21327;6.3;2.1
57;2021-03-02;2859;1420;67867;22747;6.6;2.2
57;2021-03-03;2816;1464;70683;24211;6.8;2.3
57;2021-03-04;3276;1182;73959;25393;7.1;2.5
57;2021-03-05;4459;1140;78418;26533;7.6;2.6
57;2021-03-06;7246;695;85664;27228;8.3;2.6
57;2021-03-07;6070;256;91734;27484;8.9;2.7
57;2021-03-08;2300;909;94034;28393;9.1;2.7
57;2021-03-09;3385;1195;97419;29588;9.4;2.9
57;2021-03-10;3583;893;101002;30481;9.8;2.9
57;2021-03-11;4041;1174;105043;31655;10.1;3.1
57;2021-03-12;5112;1124;110155;32779;10.6;3.2
57;2021-03-13;6284;940;116439;33719;11.2;3.3
57;2021-03-14;2425;423;118864;34142;11.5;3.3
57;2021-03-15;2966;864;121830;35006;11.8;3.4
57;2021-03-16;3060;1275;124890;36281;12.1;3.5
57;2021-03-17;3049;1138;127939;37419;12.4;3.6
57;2021-03-18;3402;1061;131341;38480;12.7;3.7
57;2021-03-19;4626;1040;135967;39520;13.1;3.8
57;2021-03-20;4702;1025;140669;40545;13.6;3.9
57;2021-03-21;1895;250;142564;40795;13.8;3.9
57;2021-03-22;2479;1476;145043;42271;14.0;4.1
57;2021-03-23;3443;2334;148486;44605;14.3;4.3
57;2021-03-24;3898;2137;152384;46742;14.7;4.5
57;2021-03-25;4743;2588;157127;49330;15.2;4.8
57;2021-03-26;4842;2261;161969;51591;15.6;5.0
57;2021-03-27;3710;3139;165679;54730;16.0;5.3
57;2021-03-28;1398;1827;167077;56557;16.1;5.5
57;2021-03-29;1932;2171;169009;58728;16.3;5.7
57;2021-03-30;3300;2472;172309;61200;16.6;5.9
57;2021-03-31;2826;2289;175135;63489;16.9;6.1
57;2021-04-01;3223;3163;178358;66652;17.2;6.4
57;2021-04-02;2392;2569;180750;69221;17.4;6.7
57;2021-04-03;2565;2649;183315;71870;17.7;6.9
57;2021-04-04;596;968;183911;72838;17.8;7.0
57;2021-04-05;1922;674;185833;73512;17.9;7.1
57;2021-04-06;2451;2829;188284;76341;18.2;7.4
57;2021-04-07;3815;3089;192099;79430;18.5;7.7
57;2021-04-08;5613;2899;197712;82329;19.1;7.9
57;2021-04-09;5013;2728;202725;85057;19.6;8.2
57;2021-04-10;2353;3635;205078;88692;19.8;8.6
57;2021-04-11;1099;1890;206177;90582;19.9;8.7
57;2021-04-12;1795;2745;207972;93327;20.1;9.0
57;2021-04-13;1976;3022;209948;96349;20.3;9.3
57;2021-04-14;1922;2985;211870;99334;20.5;9.6
57;2021-04-15;2364;3425;214234;102759;20.7;9.9
57;2021-04-16;2700;3290;216934;106049;20.9;10.2
57;2021-04-17;2474;3179;219408;109228;21.2;10.5
57;2021-04-18;1241;1771;220649;110999;21.3;10.7
57;2021-04-19;2142;2257;222791;113256;21.5;10.9
57;2021-04-20;2513;2780;225304;116036;21.8;11.2
57;2021-04-21;2568;2379;227872;118415;22.0;11.4
57;2021-04-22;3208;2250;231080;120665;22.3;11.6
57;2021-04-23;4058;2575;235138;123240;22.7;11.9
57;2021-04-24;3395;2560;238533;125800;23.0;12.1
57;2021-04-25;757;1126;239290;126926;23.1;12.3
57;2021-04-26;2972;1992;242262;128918;23.4;12.4
57;2021-04-27;3898;2375;246160;131293;23.8;12.7
57;2021-04-28;4212;2589;250372;133882;24.2;12.9
57;2021-04-29;5261;3444;255633;137326;24.7;13.3
57;2021-04-30;4729;3529;260362;140855;25.1;13.6
57;2021-05-01;2356;1685;262718;142540;25.4;13.8
57;2021-05-02;790;912;263508;143452;25.4;13.8
57;2021-05-03;3561;2990;267069;146442;25.8;14.1
57;2021-05-04;4871;3161;271940;149603;26.3;14.4
57;2021-05-05;6123;3157;278063;152760;26.8;14.7
57;2021-05-06;5990;3274;284053;156034;27.4;15.1
57;2021-05-07;6852;3438;290905;159472;28.1;15.4
57;2021-05-08;4051;1605;294956;161077;28.5;15.5
57;2021-05-09;2048;1114;297004;162191;28.7;15.7
57;2021-05-10;5129;3063;302133;165254;29.2;16.0
57;2021-05-11;7451;2848;309584;168102;29.9;16.2
57;2021-05-12;7843;3242;317427;171344;30.6;16.5
57;2021-05-13;4509;915;321936;172259;31.1;16.6
57;2021-05-14;7839;2628;329775;174887;31.8;16.9
57;2021-05-15;5965;2045;335740;176932;32.4;17.1
57;2021-05-16;3307;578;339047;177510;32.7;17.1
57;2021-05-17;3867;2063;342914;179573;33.1;17.3
57;2021-05-18;6292;2103;349206;181676;33.7;17.5
57;2021-05-19;7019;2328;356225;184004;34.4;17.8
57;2021-05-20;6047;2172;362272;186176;35.0;18.0
57;2021-05-21;7564;2922;369836;189098;35.7;18.3
57;2021-05-22;4895;2171;374731;191269;36.2;18.5
57;2021-05-23;1964;430;376695;191699;36.4;18.5
57;2021-05-24;3027;1056;379722;192755;36.7;18.6
57;2021-05-25;5571;2804;385293;195559;37.2;18.9
57;2021-05-26;6374;3177;391667;198736;37.8;19.2
57;2021-05-27;5794;3120;397461;201856;38.4;19.5
57;2021-05-28;7024;4732;404485;206588;39.0;19.9
57;2021-05-29;5220;4243;409705;210831;39.6;20.4
57;2021-05-30;1968;1743;411673;212574;39.7;20.5
57;2021-05-31;4315;3339;415988;215913;40.2;20.8
57;2021-06-01;5934;3714;421922;219627;40.7;21.2
57;2021-06-02;6340;3898;428262;223525;41.3;21.6
57;2021-06-03;6209;3691;434471;227216;41.9;21.9
57;2021-06-04;7568;4990;442039;232206;42.7;22.4
57;2021-06-05;4764;4030;446803;236236;43.1;22.8
57;2021-06-06;1992;889;448795;237125;43.3;22.9
57;2021-06-07;4316;4034;453111;241159;43.7;23.3
57;2021-06-08;6721;4313;459832;245472;44.4;23.7
57;2021-06-09;6876;4154;466708;249626;45.1;24.1
57;2021-06-10;6218;4595;472926;254221;45.7;24.5
57;2021-06-11;5361;5363;478287;259584;46.2;25.1
57;2021-06-12;5741;4446;484028;264030;46.7;25.5
57;2021-06-13;1500;1142;485528;265172;46.9;25.6
57;2021-06-14;3381;4697;488909;269869;47.2;26.1
57;2021-06-15;3815;6023;492724;275892;47.6;26.6
57;2021-06-16;4400;6599;497124;282491;48.0;27.3
57;2021-06-17;4200;6072;501324;288563;48.4;27.9
57;2021-06-18;4273;7306;505597;295869;48.8;28.6
57;2021-06-19;4158;6291;509755;302160;49.2;29.2
57;2021-06-20;986;1665;510741;303825;49.3;29.3
57;2021-06-21;2065;5966;512806;309791;49.5;29.9
57;2021-06-22;2644;7986;515450;317777;49.8;30.7
57;2021-06-23;3071;8385;518521;326162;50.1;31.5
57;2021-06-24;2457;5284;520978;331446;50.3;32.0
57;2021-06-25;2856;7825;523834;339271;50.6;32.8
57;2021-06-26;2871;7255;526705;346526;50.8;33.5
57;2021-06-27;752;2985;527457;349511;50.9;33.7
57;2021-06-28;1591;5078;529048;354589;51.1;34.2
57;2021-06-29;2082;6830;531130;361419;51.3;34.9
57;2021-06-30;3067;7321;534197;368740;51.6;35.6
57;2021-07-01;2706;5957;536903;374697;51.8;36.2
57;2021-07-02;2697;8072;539600;382769;52.1;37.0
57;2021-07-03;3238;6528;542838;389297;52.4;37.6
57;2021-07-04;942;2467;543780;391764;52.5;37.8
57;2021-07-05;1712;4607;545492;396371;52.7;38.3
57;2021-07-06;2425;6480;547917;402851;52.9;38.9
57;2021-07-07;2732;7089;550649;409940;53.2;39.6
57;2021-07-08;2495;5875;553144;415815;53.4;40.1
57;2021-07-09;3424;8413;556568;424228;53.7;41.0
57;2021-07-10;3097;6941;559665;431169;54.0;41.6
57;2021-07-11;854;2233;560519;433402;54.1;41.8
57;2021-07-12;2441;6434;562960;439836;54.3;42.5
57;2021-07-13;4415;7504;567375;447340;54.8;43.2
57;2021-07-14;2823;3842;570198;451182;55.0;43.6
57;2021-07-15;3961;7790;574159;458972;55.4;44.3
57;2021-07-16;5641;9829;579800;468801;56.0;45.3
57;2021-07-17;5823;7281;585623;476082;56.5;46.0
57;2021-07-18;1491;2660;587114;478742;56.7;46.2
57;2021-07-19;2373;6202;589487;484944;56.9;46.8
57;2021-07-20;4331;6914;593818;491858;57.3;47.5
57;2021-07-21;5300;6906;599118;498764;57.8;48.1
57;2021-07-22;5982;5955;605100;504719;58.4;48.7
57;2021-07-23;7016;6406;612116;511125;59.1;49.3
57;2021-07-24;4537;7037;616653;518162;59.5;50.0
57;2021-07-25;1334;1770;617987;519932;59.7;50.2
57;2021-07-26;3724;4491;621711;524423;60.0;50.6
57;2021-07-27;6866;4951;628577;529374;60.7;51.1
57;2021-07-28;7487;4565;636064;533939;61.4;51.5
57;2021-07-29;7634;4600;643698;538539;62.1;52.0
57;2021-07-30;6872;4899;650570;543438;62.8;52.5
57;2021-07-31;5707;5022;656277;548460;63.4;52.9
57;2021-08-01;2027;1116;658304;549576;63.6;53.1
57;2021-08-02;3543;3181;661847;552757;63.9;53.4
57;2021-08-03;5804;4283;667651;557040;64.5;53.8
57;2021-08-04;5228;3461;672879;560501;65.0;54.1
57;2021-08-05;5375;3777;678254;564278;65.5;54.5
57;2021-08-06;5624;4852;683878;569130;66.0;54.9
57;2021-08-07;4587;5169;688465;574299;66.5;55.4
57;2021-08-08;1478;1508;689943;575807;66.6;55.6
57;2021-08-09;2622;3174;692565;578981;66.9;55.9
57;2021-08-10;3519;3787;696084;582768;67.2;56.3
57;2021-08-11;3724;4023;699808;586791;67.6;56.6
57;2021-08-12;3159;5217;702967;592008;67.9;57.2
57;2021-08-13;3497;4733;706464;596741;68.2;57.6
57;2021-08-14;2165;5186;708629;601927;68.4;58.1
57;2021-08-15;529;1093;709158;603020;68.5;58.2
57;2021-08-16;1790;3567;710948;606587;68.6;58.6
57;2021-08-17;2380;5355;713328;611942;68.9;59.1
57;2021-08-18;2471;5374;715799;617316;69.1;59.6
57;2021-08-19;2214;5486;718013;622802;69.3;60.1
57;2021-08-20;2057;6031;720070;628833;69.5;60.7
57;2021-08-21;1875;5394;721945;634227;69.7;61.2
57;2021-08-22;454;1530;722399;635757;69.7;61.4
57;2021-08-23;1144;3719;723543;639476;69.8;61.7
57;2021-08-24;1817;5614;725360;645090;70.0;62.3
57;2021-08-25;1618;5318;726978;650408;70.2;62.8
57;2021-08-26;1607;4674;728585;655082;70.3;63.2
57;2021-08-27;1768;5897;730353;660979;70.5;63.8
57;2021-08-28;2013;5385;732366;666364;70.7;64.3
57;2021-08-29;342;1090;732708;667454;70.7;64.4
57;2021-08-30;1032;3260;733740;670714;70.8;64.7
57;2021-08-31;1552;4425;735292;675139;71.0;65.2
57;2021-09-01;1460;4155;736752;679294;71.1;65.6
57;2021-09-02;1178;3402;737930;682696;71.2;65.9
57;2021-09-03;1553;4351;739483;687047;71.4;66.3
57;2021-09-04;1680;4004;741163;691051;71.6;66.7
57;2021-09-05;383;940;741546;691991;71.6;66.8
57;2021-09-06;755;2131;742301;694122;71.7;67.0
57;2021-09-07;690;2248;742991;696370;71.7;67.2
57;2021-09-08;911;2919;743902;699289;71.8;67.5
57;2021-09-09;601;2361;744503;701650;71.9;67.7
57;2021-09-10;1077;2973;745580;704623;72.0;68.0
57;2021-09-11;1178;3250;746758;707873;72.1;68.3
57;2021-09-12;245;548;747003;708421;72.1;68.4
57;2021-09-13;581;1791;747584;710212;72.2;68.6
57;2021-09-14;768;2343;748352;712555;72.2;68.8
57;2021-09-15;768;1993;749120;714548;72.3;69.0
57;2021-09-16;708;1227;749828;715775;72.4;69.1
57;2021-09-17;1107;1789;750935;717564;72.5;69.3
57;2021-09-18;805;2586;751740;720150;72.6;69.5
57;2021-09-19;119;345;751859;720495;72.6;69.6
57;2021-09-20;408;867;752267;721362;72.6;69.6
57;2021-09-21;497;827;752764;722189;72.7;69.7
57;2021-09-22;489;1303;753253;723492;72.7;69.8
57;2021-09-23;465;1212;753718;724704;72.8;70.0
57;2021-09-24;739;1433;754457;726137;72.8;70.1
57;2021-09-25;503;1997;754960;728134;72.9;70.3
57;2021-09-26;121;326;755081;728460;72.9;70.3
57;2021-09-27;439;843;755520;729303;72.9;70.4
57;2021-09-28;313;597;755833;729900;73.0;70.5
57;2021-09-29;548;1106;756381;731006;73.0;70.6
57;2021-09-30;289;615;756670;731621;73.0;70.6
57;2021-10-01;514;1324;757184;732945;73.1;70.8
57;2021-10-02;658;1556;757842;734501;73.2;70.9
57;2021-10-03;121;232;757963;734733;73.2;70.9
58;2020-12-27;0;0;0;0;0.0;0.0
58;2020-12-28;0;0;0;0;0.0;0.0
58;2020-12-29;1;0;1;0;0.0;0.0
58;2020-12-30;0;0;1;0;0.0;0.0
58;2020-12-31;0;0;1;0;0.0;0.0
58;2021-01-01;0;0;1;0;0.0;0.0
58;2021-01-02;0;0;1;0;0.0;0.0
58;2021-01-03;1;0;2;0;0.0;0.0
58;2021-01-04;0;0;2;0;0.0;0.0
58;2021-01-05;2;0;4;0;0.0;0.0
58;2021-01-06;145;0;149;0;0.1;0.0
58;2021-01-07;241;0;390;0;0.2;0.0
58;2021-01-08;63;0;453;0;0.2;0.0
58;2021-01-09;1;0;454;0;0.2;0.0
58;2021-01-10;0;0;454;0;0.2;0.0
58;2021-01-11;54;0;508;0;0.3;0.0
58;2021-01-12;260;0;768;0;0.4;0.0
58;2021-01-13;412;3;1180;3;0.6;0.0
58;2021-01-14;292;1;1472;4;0.7;0.0
58;2021-01-15;142;0;1614;4;0.8;0.0
58;2021-01-16;10;1;1624;5;0.8;0.0
58;2021-01-17;0;0;1624;5;0.8;0.0
58;2021-01-18;413;1;2037;6;1.0;0.0
58;2021-01-19;987;2;3024;8;1.5;0.0
58;2021-01-20;1206;2;4230;10;2.1;0.0
58;2021-01-21;962;4;5192;14;2.6;0.0
58;2021-01-22;779;3;5971;17;3.0;0.0
58;2021-01-23;253;0;6224;17;3.1;0.0
58;2021-01-24;2;0;6226;17;3.1;0.0
58;2021-01-25;439;0;6665;17;3.3;0.0
58;2021-01-26;650;3;7315;20;3.7;0.0
58;2021-01-27;604;44;7919;64;4.0;0.0
58;2021-01-28;758;65;8677;129;4.3;0.1
58;2021-01-29;838;5;9515;134;4.8;0.1
58;2021-01-30;281;0;9796;134;4.9;0.1
58;2021-01-31;10;0;9806;134;4.9;0.1
58;2021-02-01;200;71;10006;205;5.0;0.1
58;2021-02-02;566;79;10572;284;5.3;0.1
58;2021-02-03;279;135;10851;419;5.4;0.2
58;2021-02-04;284;85;11135;504;5.6;0.3
58;2021-02-05;184;86;11319;590;5.7;0.3
58;2021-02-06;89;0;11408;590;5.7;0.3
58;2021-02-07;0;0;11408;590;5.7;0.3
58;2021-02-08;306;60;11714;650;5.9;0.3
58;2021-02-09;503;294;12217;944;6.1;0.5
58;2021-02-10;350;358;12567;1302;6.3;0.7
58;2021-02-11;286;365;12853;1667;6.4;0.8
58;2021-02-12;243;191;13096;1858;6.6;0.9
58;2021-02-13;83;29;13179;1887;6.6;0.9
58;2021-02-14;0;3;13179;1890;6.6;0.9
58;2021-02-15;114;365;13293;2255;6.7;1.1
58;2021-02-16;208;701;13501;2956;6.8;1.5
58;2021-02-17;221;600;13722;3556;6.9;1.8
58;2021-02-18;187;570;13909;4126;7.0;2.1
58;2021-02-19;238;586;14147;4712;7.1;2.4
58;2021-02-20;63;170;14210;4882;7.1;2.4
58;2021-02-21;0;30;14210;4912;7.1;2.5
58;2021-02-22;78;298;14288;5210;7.2;2.6
58;2021-02-23;49;483;14337;5693;7.2;2.9
58;2021-02-24;39;495;14376;6188;7.2;3.1
58;2021-02-25;252;591;14628;6779;7.3;3.4
58;2021-02-26;246;484;14874;7263;7.5;3.6
58;2021-02-27;104;142;14978;7405;7.5;3.7
58;2021-02-28;11;8;14989;7413;7.5;3.7
58;2021-03-01;145;183;15134;7596;7.6;3.8
58;2021-03-02;416;527;15550;8123;7.8;4.1
58;2021-03-03;523;248;16073;8371;8.1;4.2
58;2021-03-04;725;257;16798;8628;8.4;4.3
58;2021-03-05;866;192;17664;8820;8.8;4.4
58;2021-03-06;577;77;18241;8897;9.1;4.5
58;2021-03-07;63;10;18304;8907;9.2;4.5
58;2021-03-08;156;269;18460;9176;9.2;4.6
58;2021-03-09;545;476;19005;9652;9.5;4.8
58;2021-03-10;838;215;19843;9867;9.9;4.9
58;2021-03-11;857;247;20700;10114;10.4;5.1
58;2021-03-12;862;185;21562;10299;10.8;5.2
58;2021-03-13;506;64;22068;10363;11.1;5.2
58;2021-03-14;34;1;22102;10364;11.1;5.2
58;2021-03-15;530;108;22632;10472;11.3;5.2
58;2021-03-16;725;219;23357;10691;11.7;5.4
58;2021-03-17;755;189;24112;10880;12.1;5.5
58;2021-03-18;584;172;24696;11052;12.4;5.5
58;2021-03-19;540;98;25236;11150;12.6;5.6
58;2021-03-20;322;64;25558;11214;12.8;5.6
58;2021-03-21;17;0;25575;11214;12.8;5.6
58;2021-03-22;797;25;26372;11239;13.2;5.6
58;2021-03-23;1636;42;28008;11281;14.0;5.7
58;2021-03-24;1370;76;29378;11357;14.7;5.7
58;2021-03-25;1840;47;31218;11404;15.6;5.7
58;2021-03-26;1414;56;32632;11460;16.3;5.7
58;2021-03-27;358;8;32990;11468;16.5;5.7
58;2021-03-28;20;0;33010;11468;16.5;5.7
58;2021-03-29;636;148;33646;11616;16.9;5.8
58;2021-03-30;1187;254;34833;11870;17.5;5.9
58;2021-03-31;1116;390;35949;12260;18.0;6.1
58;2021-04-01;1548;401;37497;12661;18.8;6.3
58;2021-04-02;1463;360;38960;13021;19.5;6.5
58;2021-04-03;568;148;39528;13169;19.8;6.6
58;2021-04-04;1;1;39529;13170;19.8;6.6
58;2021-04-05;47;0;39576;13170;19.8;6.6
58;2021-04-06;823;343;40399;13513;20.2;6.8
58;2021-04-07;696;550;41095;14063;20.6;7.0
58;2021-04-08;1493;427;42588;14490;21.3;7.3
58;2021-04-09;1775;486;44363;14976;22.2;7.5
58;2021-04-10;650;201;45013;15177;22.6;7.6
58;2021-04-11;17;3;45030;15180;22.6;7.6
58;2021-04-12;1117;502;46147;15682;23.1;7.9
58;2021-04-13;1435;629;47582;16311;23.8;8.2
58;2021-04-14;1358;695;48940;17006;24.5;8.5
58;2021-04-15;1441;608;50381;17614;25.2;8.8
58;2021-04-16;1734;516;52115;18130;26.1;9.1
58;2021-04-17;721;233;52836;18363;26.5;9.2
58;2021-04-18;20;7;52856;18370;26.5;9.2
58;2021-04-19;530;602;53386;18972;26.7;9.5
58;2021-04-20;487;1119;53873;20091;27.0;10.1
58;2021-04-21;628;967;54501;21058;27.3;10.6
58;2021-04-22;768;1519;55269;22577;27.7;11.3
58;2021-04-23;919;784;56188;23361;28.2;11.7
58;2021-04-24;211;206;56399;23567;28.3;11.8
58;2021-04-25;109;9;56508;23576;28.3;11.8
58;2021-04-26;762;248;57270;23824;28.7;11.9
58;2021-04-27;1499;1106;58769;24930;29.4;12.5
58;2021-04-28;1536;1041;60305;25971;30.2;13.0
58;2021-04-29;1444;1039;61749;27010;30.9;13.5
58;2021-04-30;1258;936;63007;27946;31.6;14.0
58;2021-05-01;6;17;63013;27963;31.6;14.0
58;2021-05-02;4;2;63017;27965;31.6;14.0
58;2021-05-03;1042;407;64059;28372;32.1;14.2
58;2021-05-04;1073;1344;65132;29716;32.6;14.9
58;2021-05-05;955;1092;66087;30808;33.1;15.4
58;2021-05-06;1363;1053;67450;31861;33.8;16.0
58;2021-05-07;1111;1088;68561;32949;34.3;16.5
58;2021-05-08;59;60;68620;33009;34.4;16.5
58;2021-05-09;7;21;68627;33030;34.4;16.5
58;2021-05-10;875;990;69502;34020;34.8;17.0
58;2021-05-11;1184;1981;70686;36001;35.4;18.0
58;2021-05-12;1660;1558;72346;37559;36.2;18.8
58;2021-05-13;49;183;72395;37742;36.3;18.9
58;2021-05-14;2311;907;74706;38649;37.4;19.4
58;2021-05-15;1726;456;76432;39105;38.3;19.6
58;2021-05-16;118;33;76550;39138;38.4;19.6
58;2021-05-17;793;611;77343;39749;38.7;19.9
58;2021-05-18;1333;1181;78676;40930;39.4;20.5
58;2021-05-19;1738;548;80414;41478;40.3;20.8
58;2021-05-20;1701;674;82115;42152;41.1;21.1
58;2021-05-21;854;719;82969;42871;41.6;21.5
58;2021-05-22;304;237;83273;43108;41.7;21.6
58;2021-05-23;2;21;83275;43129;41.7;21.6
58;2021-05-24;21;41;83296;43170;41.7;21.6
58;2021-05-25;1386;1155;84682;44325;42.4;22.2
58;2021-05-26;845;832;85527;45157;42.9;22.6
58;2021-05-27;753;935;86280;46092;43.2;23.1
58;2021-05-28;429;905;86709;46997;43.4;23.5
58;2021-05-29;151;209;86860;47206;43.5;23.7
58;2021-05-30;21;19;86881;47225;43.5;23.7
58;2021-05-31;757;385;87638;47610;43.9;23.9
58;2021-06-01;1372;1644;89010;49254;44.6;24.7
58;2021-06-02;1467;1049;90477;50303;45.3;25.2
58;2021-06-03;1024;956;91501;51259;45.8;25.7
58;2021-06-04;842;902;92343;52161;46.3;26.1
58;2021-06-05;272;263;92615;52424;46.4;26.3
58;2021-06-06;26;44;92641;52468;46.4;26.3
58;2021-06-07;712;791;93353;53259;46.8;26.7
58;2021-06-08;1321;1758;94674;55017;47.4;27.6
58;2021-06-09;1417;1007;96091;56024;48.1;28.1
58;2021-06-10;1106;974;97197;56998;48.7;28.6
58;2021-06-11;1023;907;98220;57905;49.2;29.0
58;2021-06-12;1056;415;99276;58320;49.7;29.2
58;2021-06-13;36;33;99312;58353;49.8;29.2
58;2021-06-14;516;1016;99828;59369;50.0;29.7
58;2021-06-15;1592;1757;101420;61126;50.8;30.6
58;2021-06-16;1806;992;103226;62118;51.7;31.1
58;2021-06-17;2023;1101;105249;63219;52.7;31.7
58;2021-06-18;986;1061;106235;64280;53.2;32.2
58;2021-06-19;581;320;106816;64600;53.5;32.4
58;2021-06-20;9;2;106825;64602;53.5;32.4
58;2021-06-21;472;553;107297;65155;53.8;32.6
58;2021-06-22;1028;1960;108325;67115;54.3;33.6
58;2021-06-23;1477;1504;109802;68619;55.0;34.4
58;2021-06-24;729;1022;110531;69641;55.4;34.9
58;2021-06-25;824;1719;111355;71360;55.8;35.8
58;2021-06-26;554;1228;111909;72588;56.1;36.4
58;2021-06-27;18;22;111927;72610;56.1;36.4
58;2021-06-28;463;987;112390;73597;56.3;36.9
58;2021-06-29;623;2161;113013;75758;56.6;38.0
58;2021-06-30;999;1624;114012;77382;57.1;38.8
58;2021-07-01;760;1670;114772;79052;57.5;39.6
58;2021-07-02;444;849;115216;79901;57.7;40.0
58;2021-07-03;249;512;115465;80413;57.8;40.3
58;2021-07-04;12;30;115477;80443;57.9;40.3
58;2021-07-05;510;763;115987;81206;58.1;40.7
58;2021-07-06;695;2121;116682;83327;58.5;41.7
58;2021-07-07;388;947;117070;84274;58.7;42.2
58;2021-07-08;399;1016;117469;85290;58.9;42.7
58;2021-07-09;709;1419;118178;86709;59.2;43.4
58;2021-07-10;260;412;118438;87121;59.3;43.6
58;2021-07-11;175;52;118613;87173;59.4;43.7
58;2021-07-12;197;965;118810;88138;59.5;44.2
58;2021-07-13;933;2503;119743;90641;60.0;45.4
58;2021-07-14;27;58;119770;90699;60.0;45.4
58;2021-07-15;1134;1935;120904;92634;60.6;46.4
58;2021-07-16;1411;1441;122315;94075;61.3;47.1
58;2021-07-17;463;288;122778;94363;61.5;47.3
58;2021-07-18;102;21;122880;94384;61.6;47.3
58;2021-07-19;1655;987;124535;95371;62.4;47.8
58;2021-07-20;1408;2455;125943;97826;63.1;49.0
58;2021-07-21;1178;2010;127121;99836;63.7;50.0
58;2021-07-22;1143;1670;128264;101506;64.3;50.9
58;2021-07-23;1268;1444;129532;102950;64.9;51.6
58;2021-07-24;1000;1272;130532;104222;65.4;52.2
58;2021-07-25;89;40;130621;104262;65.4;52.2
58;2021-07-26;980;858;131601;105120;65.9;52.7
58;2021-07-27;1566;2569;133167;107689;66.7;54.0
58;2021-07-28;1570;1971;134737;109660;67.5;54.9
58;2021-07-29;1581;1621;136318;111281;68.3;55.8
58;2021-07-30;1466;1428;137784;112709;69.0;56.5
58;2021-07-31;568;524;138352;113233;69.3;56.7
58;2021-08-01;35;13;138387;113246;69.3;56.7
58;2021-08-02;1590;854;139977;114100;70.1;57.2
58;2021-08-03;2051;1779;142028;115879;71.2;58.1
58;2021-08-04;1307;1184;143335;117063;71.8;58.6
58;2021-08-05;1621;1175;144956;118238;72.6;59.2
58;2021-08-06;1359;1032;146315;119270;73.3;59.8
58;2021-08-07;318;401;146633;119671;73.5;60.0
58;2021-08-08;30;58;146663;119729;73.5;60.0
58;2021-08-09;1083;1388;147746;121117;74.0;60.7
58;2021-08-10;1779;1387;149525;122504;74.9;61.4
58;2021-08-11;1134;780;150659;123284;75.5;61.8
58;2021-08-12;1067;1108;151726;124392;76.0;62.3
58;2021-08-13;931;955;152657;125347;76.5;62.8
58;2021-08-14;232;317;152889;125664;76.6;63.0
58;2021-08-15;14;27;152903;125691;76.6;63.0
58;2021-08-16;311;1402;153214;127093;76.8;63.7
58;2021-08-17;805;1337;154019;128430;77.2;64.3
58;2021-08-18;766;1171;154785;129601;77.5;64.9
58;2021-08-19;731;1342;155516;130943;77.9;65.6
58;2021-08-20;707;1298;156223;132241;78.3;66.3
58;2021-08-21;253;476;156476;132717;78.4;66.5
58;2021-08-22;9;86;156485;132803;78.4;66.5
58;2021-08-23;418;815;156903;133618;78.6;66.9
58;2021-08-24;513;1481;157416;135099;78.9;67.7
58;2021-08-25;436;1542;157852;136641;79.1;68.5
58;2021-08-26;553;1731;158405;138372;79.4;69.3
58;2021-08-27;494;1565;158899;139937;79.6;70.1
58;2021-08-28;244;640;159143;140577;79.7;70.4
58;2021-08-29;9;42;159152;140619;79.7;70.5
58;2021-08-30;356;808;159508;141427;79.9;70.9
58;2021-08-31;492;1607;160000;143034;80.2;71.7
58;2021-09-01;428;1676;160428;144710;80.4;72.5
58;2021-09-02;290;1361;160718;146071;80.5;73.2
58;2021-09-03;364;1564;161082;147635;80.7;74.0
58;2021-09-04;206;700;161288;148335;80.8;74.3
58;2021-09-05;3;27;161291;148362;80.8;74.3
58;2021-09-06;117;561;161408;148923;80.9;74.6
58;2021-09-07;319;985;161727;149908;81.0;75.1
58;2021-09-08;240;1331;161967;151239;81.1;75.8
58;2021-09-09;248;704;162215;151943;81.3;76.1
58;2021-09-10;260;963;162475;152906;81.4;76.6
58;2021-09-11;129;526;162604;153432;81.5;76.9
58;2021-09-12;5;17;162609;153449;81.5;76.9
58;2021-09-13;207;749;162816;154198;81.6;77.3
58;2021-09-14;290;973;163106;155171;81.7;77.7
58;2021-09-15;189;573;163295;155744;81.8;78.0
58;2021-09-16;205;451;163500;156195;81.9;78.3
58;2021-09-17;197;376;163697;156571;82.0;78.4
58;2021-09-18;118;362;163815;156933;82.1;78.6
58;2021-09-19;5;4;163820;156937;82.1;78.6
58;2021-09-20;173;228;163993;157165;82.2;78.7
58;2021-09-21;139;421;164132;157586;82.2;79.0
58;2021-09-22;159;535;164291;158121;82.3;79.2
58;2021-09-23;134;288;164425;158409;82.4;79.4
58;2021-09-24;111;390;164536;158799;82.4;79.6
58;2021-09-25;93;374;164629;159173;82.5;79.7
58;2021-09-26;6;13;164635;159186;82.5;79.8
58;2021-09-27;91;232;164726;159418;82.5;79.9
58;2021-09-28;126;328;164852;159746;82.6;80.0
58;2021-09-29;99;344;164951;160090;82.6;80.2
58;2021-09-30;67;217;165018;160307;82.7;80.3
58;2021-10-01;76;218;165094;160525;82.7;80.4
58;2021-10-02;85;220;165179;160745;82.8;80.5
58;2021-10-03;0;6;165179;160751;82.8;80.5
59;2020-12-27;1;0;1;0;0.0;0.0
59;2020-12-28;27;0;28;0;0.0;0.0
59;2020-12-29;0;0;28;0;0.0;0.0
59;2020-12-30;0;0;28;0;0.0;0.0
59;2020-12-31;2;0;30;0;0.0;0.0
59;2021-01-01;3;0;33;0;0.0;0.0
59;2021-01-02;4;0;37;0;0.0;0.0
59;2021-01-03;4;0;41;0;0.0;0.0
59;2021-01-04;79;0;120;0;0.0;0.0
59;2021-01-05;217;0;337;0;0.0;0.0
59;2021-01-06;428;1;765;1;0.0;0.0
59;2021-01-07;1314;0;2079;1;0.1;0.0
59;2021-01-08;1262;5;3341;6;0.1;0.0
59;2021-01-09;608;3;3949;9;0.2;0.0
59;2021-01-10;430;0;4379;9;0.2;0.0
59;2021-01-11;1846;5;6225;14;0.2;0.0
59;2021-01-12;2471;2;8696;16;0.3;0.0
59;2021-01-13;2369;2;11065;18;0.4;0.0
59;2021-01-14;2759;21;13824;39;0.5;0.0
59;2021-01-15;2276;15;16100;54;0.6;0.0
59;2021-01-16;771;1;16871;55;0.7;0.0
59;2021-01-17;560;2;17431;57;0.7;0.0
59;2021-01-18;3511;13;20942;70;0.8;0.0
59;2021-01-19;4758;8;25700;78;1.0;0.0
59;2021-01-20;4136;11;29836;89;1.2;0.0
59;2021-01-21;4731;31;34567;120;1.3;0.0
59;2021-01-22;4025;10;38592;130;1.5;0.0
59;2021-01-23;1217;3;39809;133;1.5;0.0
59;2021-01-24;170;0;39979;133;1.5;0.0
59;2021-01-25;2729;50;42708;183;1.6;0.0
59;2021-01-26;2823;127;45531;310;1.8;0.0
59;2021-01-27;1736;286;47267;596;1.8;0.0
59;2021-01-28;3398;714;50665;1310;2.0;0.1
59;2021-01-29;2544;717;53209;2027;2.1;0.1
59;2021-01-30;288;142;53497;2169;2.1;0.1
59;2021-01-31;24;0;53521;2169;2.1;0.1
59;2021-02-01;79;760;53600;2929;2.1;0.1
59;2021-02-02;691;1328;54291;4257;2.1;0.2
59;2021-02-03;3755;1340;58046;5597;2.2;0.2
59;2021-02-04;2966;1600;61012;7197;2.4;0.3
59;2021-02-05;1071;1278;62083;8475;2.4;0.3
59;2021-02-06;207;298;62290;8773;2.4;0.3
59;2021-02-07;268;49;62558;8822;2.4;0.3
59;2021-02-08;684;1364;63242;10186;2.4;0.4
59;2021-02-09;1015;1538;64257;11724;2.5;0.5
59;2021-02-10;975;1390;65232;13114;2.5;0.5
59;2021-02-11;1347;1590;66579;14704;2.6;0.6
59;2021-02-12;1415;1413;67994;16117;2.6;0.6
59;2021-02-13;207;594;68201;16711;2.6;0.6
59;2021-02-14;13;39;68214;16750;2.6;0.6
59;2021-02-15;1397;2176;69611;18926;2.7;0.7
59;2021-02-16;1436;2653;71047;21579;2.7;0.8
59;2021-02-17;1623;2732;72670;24311;2.8;0.9
59;2021-02-18;3106;4154;75776;28465;2.9;1.1
59;2021-02-19;3209;3031;78985;31496;3.1;1.2
59;2021-02-20;1413;1235;80398;32731;3.1;1.3
59;2021-02-21;242;236;80640;32967;3.1;1.3
59;2021-02-22;1430;1997;82070;34964;3.2;1.4
59;2021-02-23;2659;2277;84729;37241;3.3;1.4
59;2021-02-24;4109;3610;88838;40851;3.4;1.6
59;2021-02-25;6920;3446;95758;44297;3.7;1.7
59;2021-02-26;6498;1691;102256;45988;3.9;1.8
59;2021-02-27;3095;181;105351;46169;4.1;1.8
59;2021-02-28;208;59;105559;46228;4.1;1.8
59;2021-03-01;3692;577;109251;46805;4.2;1.8
59;2021-03-02;4794;515;114045;47320;4.4;1.8
59;2021-03-03;5748;925;119793;48245;4.6;1.9
59;2021-03-04;7083;876;126876;49121;4.9;1.9
59;2021-03-05;7837;900;134713;50021;5.2;1.9
59;2021-03-06;11562;483;146275;50504;5.6;2.0
59;2021-03-07;7586;322;153861;50826;5.9;2.0
59;2021-03-08;4497;1006;158358;51832;6.1;2.0
59;2021-03-09;6578;1280;164936;53112;6.4;2.1
59;2021-03-10;7028;1073;171964;54185;6.6;2.1
59;2021-03-11;9477;1777;181441;55962;7.0;2.2
59;2021-03-12;12158;1487;193599;57449;7.5;2.2
59;2021-03-13;16557;1063;210156;58512;8.1;2.3
59;2021-03-14;6964;327;217120;58839;8.4;2.3
59;2021-03-15;5613;1439;222733;60278;8.6;2.3
59;2021-03-16;3741;1270;226474;61548;8.7;2.4
59;2021-03-17;3856;2044;230330;63592;8.9;2.5
59;2021-03-18;3956;2430;234286;66022;9.0;2.6
59;2021-03-19;7743;1753;242029;67775;9.3;2.6
59;2021-03-20;16023;1267;258052;69042;10.0;2.7
59;2021-03-21;6318;445;264370;69487;10.2;2.7
59;2021-03-22;5448;1740;269818;71227;10.4;2.8
59;2021-03-23;7772;2777;277590;74004;10.7;2.9
59;2021-03-24;6861;2936;284451;76940;11.0;3.0
59;2021-03-25;10534;2537;294985;79477;11.4;3.1
59;2021-03-26;12252;2805;307237;82282;11.9;3.2
59;2021-03-27;15275;1149;322512;83431;12.5;3.2
59;2021-03-28;7984;358;330496;83789;12.8;3.2
59;2021-03-29;5495;3170;335991;86959;13.0;3.4
59;2021-03-30;7540;3726;343531;90685;13.3;3.5
59;2021-03-31;6156;4068;349687;94753;13.5;3.7
59;2021-04-01;7494;4899;357181;99652;13.8;3.8
59;2021-04-02;7645;5494;364826;105146;14.1;4.1
59;2021-04-03;13018;4292;377844;109438;14.6;4.2
59;2021-04-04;5348;2175;383192;111613;14.8;4.3
59;2021-04-05;6021;1530;389213;113143;15.0;4.4
59;2021-04-06;5406;4473;394619;117616;15.2;4.5
59;2021-04-07;7622;5416;402241;123032;15.5;4.8
59;2021-04-08;10393;5737;412634;128769;15.9;5.0
59;2021-04-09;13421;5922;426055;134691;16.5;5.2
59;2021-04-10;11479;6126;437534;140817;16.9;5.4
59;2021-04-11;4636;3554;442170;144371;17.1;5.6
59;2021-04-12;6304;4341;448474;148712;17.3;5.7
59;2021-04-13;8934;4785;457408;153497;17.7;5.9
59;2021-04-14;8789;4341;466197;157838;18.0;6.1
59;2021-04-15;10306;4843;476503;162681;18.4;6.3
59;2021-04-16;10879;5496;487382;168177;18.8;6.5
59;2021-04-17;7295;9068;494677;177245;19.1;6.8
59;2021-04-18;3234;4158;497911;181403;19.2;7.0
59;2021-04-19;5044;4287;502955;185690;19.4;7.2
59;2021-04-20;6898;4207;509853;189897;19.7;7.3
59;2021-04-21;6271;4421;516124;194318;19.9;7.5
59;2021-04-22;8612;5516;524736;199834;20.3;7.7
59;2021-04-23;8458;5678;533194;205512;20.6;7.9
59;2021-04-24;5537;8046;538731;213558;20.8;8.2
59;2021-04-25;3242;6075;541973;219633;20.9;8.5
59;2021-04-26;6493;3776;548466;223409;21.2;8.6
59;2021-04-27;8367;5156;556833;228565;21.5;8.8
59;2021-04-28;8767;6530;565600;235095;21.8;9.1
59;2021-04-29;9417;8489;575017;243584;22.2;9.4
59;2021-04-30;10605;8465;585622;252049;22.6;9.7
59;2021-05-01;11998;7598;597620;259647;23.1;10.0
59;2021-05-02;8641;5990;606261;265637;23.4;10.3
59;2021-05-03;9553;5044;615814;270681;23.8;10.5
59;2021-05-04;11426;5965;627240;276646;24.2;10.7
59;2021-05-05;10295;6189;637535;282835;24.6;10.9
59;2021-05-06;11197;8427;648732;291262;25.1;11.3
59;2021-05-07;13297;9561;662029;300823;25.6;11.6
59;2021-05-08;14742;4169;676771;304992;26.1;11.8
59;2021-05-09;11492;3329;688263;308321;26.6;11.9
59;2021-05-10;12746;6623;701009;314944;27.1;12.2
59;2021-05-11;15112;8298;716121;323242;27.7;12.5
59;2021-05-12;16625;8627;732746;331869;28.3;12.8
59;2021-05-13;18441;3456;751187;335325;29.0;13.0
59;2021-05-14;15782;6960;766969;342285;29.6;13.2
59;2021-05-15;23443;5281;790412;347566;30.5;13.4
59;2021-05-16;21176;2416;811588;349982;31.3;13.5
59;2021-05-17;15066;5256;826654;355238;31.9;13.7
59;2021-05-18;16922;5657;843576;360895;32.6;13.9
59;2021-05-19;18319;5107;861895;366002;33.3;14.1
59;2021-05-20;17934;6983;879829;372985;34.0;14.4
59;2021-05-21;18370;8262;898199;381247;34.7;14.7
59;2021-05-22;23811;5669;922010;386916;35.6;14.9
59;2021-05-23;17921;2276;939931;389192;36.3;15.0
59;2021-05-24;16690;2144;956621;391336;36.9;15.1
59;2021-05-25;14990;6651;971611;397987;37.5;15.4
59;2021-05-26;15892;7030;987503;405017;38.1;15.6
59;2021-05-27;16151;9154;1003654;414171;38.8;16.0
59;2021-05-28;15884;11419;1019538;425590;39.4;16.4
59;2021-05-29;14370;8686;1033908;434276;39.9;16.8
59;2021-05-30;8406;1840;1042314;436116;40.3;16.8
59;2021-05-31;14203;7947;1056517;444063;40.8;17.2
59;2021-06-01;15088;10361;1071605;454424;41.4;17.6
59;2021-06-02;14769;9901;1086374;464325;42.0;17.9
59;2021-06-03;15630;12101;1102004;476426;42.6;18.4
59;2021-06-04;15608;13437;1117612;489863;43.2;18.9
59;2021-06-05;14979;9337;1132591;499200;43.7;19.3
59;2021-06-06;8826;3205;1141417;502405;44.1;19.4
59;2021-06-07;10526;9415;1151943;511820;44.5;19.8
59;2021-06-08;11759;11072;1163702;522892;44.9;20.2
59;2021-06-09;10758;11879;1174460;534771;45.4;20.7
59;2021-06-10;11501;12305;1185961;547076;45.8;21.1
59;2021-06-11;10973;15970;1196934;563046;46.2;21.7
59;2021-06-12;11068;13674;1208002;576720;46.7;22.3
59;2021-06-13;6344;7028;1214346;583748;46.9;22.5
59;2021-06-14;6505;12674;1220851;596422;47.2;23.0
59;2021-06-15;8231;15946;1229082;612368;47.5;23.7
59;2021-06-16;9203;13541;1238285;625909;47.8;24.2
59;2021-06-17;9187;15644;1247472;641553;48.2;24.8
59;2021-06-18;9081;20058;1256553;661611;48.5;25.6
59;2021-06-19;8953;17489;1265506;679100;48.9;26.2
59;2021-06-20;4900;10189;1270406;689289;49.1;26.6
59;2021-06-21;5280;15964;1275686;705253;49.3;27.2
59;2021-06-22;6336;18672;1282022;723925;49.5;28.0
59;2021-06-23;6168;19082;1288190;743007;49.8;28.7
59;2021-06-24;7338;20518;1295528;763525;50.0;29.5
59;2021-06-25;6507;21190;1302035;784715;50.3;30.3
59;2021-06-26;6489;23744;1308524;808459;50.5;31.2
59;2021-06-27;4752;17078;1313276;825537;50.7;31.9
59;2021-06-28;5003;19812;1318279;845349;50.9;32.7
59;2021-06-29;5549;20376;1323828;865725;51.1;33.4
59;2021-06-30;6131;20096;1329959;885821;51.4;34.2
59;2021-07-01;6771;20837;1336730;906658;51.6;35.0
59;2021-07-02;6837;23240;1343567;929898;51.9;35.9
59;2021-07-03;5563;24605;1349130;954503;52.1;36.9
59;2021-07-04;4416;15976;1353546;970479;52.3;37.5
59;2021-07-05;5671;17486;1359217;987965;52.5;38.2
59;2021-07-06;6609;18796;1365826;1006761;52.8;38.9
59;2021-07-07;6939;17447;1372765;1024208;53.0;39.6
59;2021-07-08;8027;17683;1380792;1041891;53.3;40.2
59;2021-07-09;7705;20296;1388497;1062187;53.6;41.0
59;2021-07-10;7450;18538;1395947;1080725;53.9;41.7
59;2021-07-11;4448;10231;1400395;1090956;54.1;42.1
59;2021-07-12;5917;18043;1406312;1108999;54.3;42.8
59;2021-07-13;9911;20748;1416223;1129747;54.7;43.6
59;2021-07-14;9782;8453;1426005;1138200;55.1;44.0
59;2021-07-15;11638;20387;1437643;1158587;55.5;44.8
59;2021-07-16;13216;20491;1450859;1179078;56.0;45.5
59;2021-07-17;12399;17468;1463258;1196546;56.5;46.2
59;2021-07-18;7962;8683;1471220;1205229;56.8;46.6
59;2021-07-19;10404;16444;1481624;1221673;57.2;47.2
59;2021-07-20;13409;17119;1495033;1238792;57.7;47.8
59;2021-07-21;14525;15598;1509558;1254390;58.3;48.5
59;2021-07-22;17062;15205;1526620;1269595;59.0;49.0
59;2021-07-23;15728;15824;1542348;1285419;59.6;49.6
59;2021-07-24;16356;12298;1558704;1297717;60.2;50.1
59;2021-07-25;11916;7340;1570620;1305057;60.7;50.4
59;2021-07-26;13041;12615;1583661;1317672;61.2;50.9
59;2021-07-27;16228;11961;1599889;1329633;61.8;51.4
59;2021-07-28;17456;11666;1617345;1341299;62.5;51.8
59;2021-07-29;17423;11672;1634768;1352971;63.1;52.3
59;2021-07-30;15921;11608;1650689;1364579;63.8;52.7
59;2021-07-31;14021;9209;1664710;1373788;64.3;53.1
59;2021-08-01;9959;4572;1674669;1378360;64.7;53.2
59;2021-08-02;12213;10032;1686882;1388392;65.2;53.6
59;2021-08-03;13452;10057;1700334;1398449;65.7;54.0
59;2021-08-04;11239;8285;1711573;1406734;66.1;54.3
59;2021-08-05;12722;9786;1724295;1416520;66.6;54.7
59;2021-08-06;12562;11040;1736857;1427560;67.1;55.1
59;2021-08-07;9739;9300;1746596;1436860;67.5;55.5
59;2021-08-08;6960;5267;1753556;1442127;67.7;55.7
59;2021-08-09;8410;10828;1761966;1452955;68.1;56.1
59;2021-08-10;10405;10755;1772371;1463710;68.5;56.5
59;2021-08-11;8675;9320;1781046;1473030;68.8;56.9
59;2021-08-12;9002;12077;1790048;1485107;69.1;57.4
59;2021-08-13;8638;11750;1798686;1496857;69.5;57.8
59;2021-08-14;5952;10392;1804638;1507249;69.7;58.2
59;2021-08-15;3376;4666;1808014;1511915;69.8;58.4
59;2021-08-16;5876;13865;1813890;1525780;70.1;58.9
59;2021-08-17;6988;12764;1820878;1538544;70.3;59.4
59;2021-08-18;5955;11468;1826833;1550012;70.6;59.9
59;2021-08-19;6353;13871;1833186;1563883;70.8;60.4
59;2021-08-20;5836;14587;1839022;1578470;71.0;61.0
59;2021-08-21;4188;10295;1843210;1588765;71.2;61.4
59;2021-08-22;2851;7651;1846061;1596416;71.3;61.7
59;2021-08-23;4788;15732;1850849;1612148;71.5;62.3
59;2021-08-24;5300;15191;1856149;1627339;71.7;62.9
59;2021-08-25;4666;13085;1860815;1640424;71.9;63.4
59;2021-08-26;5209;14348;1866024;1654772;72.1;63.9
59;2021-08-27;5007;15429;1871031;1670201;72.3;64.5
59;2021-08-28;3807;12372;1874838;1682573;72.4;65.0
59;2021-08-29;1943;8435;1876781;1691008;72.5;65.3
59;2021-08-30;3890;12945;1880671;1703953;72.6;65.8
59;2021-08-31;3822;12944;1884493;1716897;72.8;66.3
59;2021-09-01;3295;10715;1887788;1727612;72.9;66.7
59;2021-09-02;3204;10950;1890992;1738562;73.0;67.2
59;2021-09-03;3798;12125;1894790;1750687;73.2;67.6
59;2021-09-04;3393;9964;1898183;1760651;73.3;68.0
59;2021-09-05;1208;3653;1899391;1764304;73.4;68.1
59;2021-09-06;2139;7320;1901530;1771624;73.4;68.4
59;2021-09-07;2252;7049;1903782;1778673;73.5;68.7
59;2021-09-08;2572;7506;1906354;1786179;73.6;69.0
59;2021-09-09;2430;6705;1908784;1792884;73.7;69.3
59;2021-09-10;3287;8102;1912071;1800986;73.9;69.6
59;2021-09-11;2595;7518;1914666;1808504;74.0;69.9
59;2021-09-12;910;2922;1915576;1811426;74.0;70.0
59;2021-09-13;1944;5505;1917520;1816931;74.1;70.2
59;2021-09-14;2319;5957;1919839;1822888;74.2;70.4
59;2021-09-15;2271;5355;1922110;1828243;74.2;70.6
59;2021-09-16;2171;4257;1924281;1832500;74.3;70.8
59;2021-09-17;2908;5446;1927189;1837946;74.4;71.0
59;2021-09-18;1778;5920;1928967;1843866;74.5;71.2
59;2021-09-19;382;1301;1929349;1845167;74.5;71.3
59;2021-09-20;1356;3300;1930705;1848467;74.6;71.4
59;2021-09-21;1335;2938;1932040;1851405;74.6;71.5
59;2021-09-22;1408;4739;1933448;1856144;74.7;71.7
59;2021-09-23;1516;2818;1934964;1858962;74.7;71.8
59;2021-09-24;1902;4240;1936866;1863202;74.8;72.0
59;2021-09-25;1158;4016;1938024;1867218;74.9;72.1
59;2021-09-26;314;1207;1938338;1868425;74.9;72.2
59;2021-09-27;1087;2531;1939425;1870956;74.9;72.3
59;2021-09-28;1069;2187;1940494;1873143;75.0;72.4
59;2021-09-29;1280;2951;1941774;1876094;75.0;72.5
59;2021-09-30;1231;2252;1943005;1878346;75.0;72.6
59;2021-10-01;1654;3373;1944659;1881719;75.1;72.7
59;2021-10-02;1454;3241;1946113;1884960;75.2;72.8
59;2021-10-03;262;630;1946375;1885590;75.2;72.8
60;2020-12-27;0;0;0;0;0.0;0.0
60;2020-12-28;0;0;0;0;0.0;0.0
60;2020-12-29;1;0;1;0;0.0;0.0
60;2020-12-30;1;0;2;0;0.0;0.0
60;2020-12-31;0;0;2;0;0.0;0.0
60;2021-01-01;0;0;2;0;0.0;0.0
60;2021-01-02;5;0;7;0;0.0;0.0
60;2021-01-03;1;0;8;0;0.0;0.0
60;2021-01-04;1;0;9;0;0.0;0.0
60;2021-01-05;37;0;46;0;0.0;0.0
60;2021-01-06;188;3;234;3;0.0;0.0
60;2021-01-07;235;4;469;7;0.1;0.0
60;2021-01-08;380;4;849;11;0.1;0.0
60;2021-01-09;3;0;852;11;0.1;0.0
60;2021-01-10;60;0;912;11;0.1;0.0
60;2021-01-11;345;2;1257;13;0.2;0.0
60;2021-01-12;537;2;1794;15;0.2;0.0
60;2021-01-13;475;5;2269;20;0.3;0.0
60;2021-01-14;508;6;2777;26;0.3;0.0
60;2021-01-15;704;7;3481;33;0.4;0.0
60;2021-01-16;124;1;3605;34;0.4;0.0
60;2021-01-17;32;0;3637;34;0.4;0.0
60;2021-01-18;860;7;4497;41;0.5;0.0
60;2021-01-19;1207;11;5704;52;0.7;0.0
60;2021-01-20;1719;11;7423;63;0.9;0.0
60;2021-01-21;2265;8;9688;71;1.2;0.0
60;2021-01-22;1547;14;11235;85;1.4;0.0
60;2021-01-23;499;4;11734;89;1.4;0.0
60;2021-01-24;61;1;11795;90;1.4;0.0
60;2021-01-25;897;14;12692;104;1.5;0.0
60;2021-01-26;950;16;13642;120;1.7;0.0
60;2021-01-27;646;6;14288;126;1.7;0.0
60;2021-01-28;396;164;14684;290;1.8;0.0
60;2021-01-29;77;98;14761;388;1.8;0.0
60;2021-01-30;0;1;14761;389;1.8;0.0
60;2021-01-31;22;57;14783;446;1.8;0.1
60;2021-02-01;39;102;14822;548;1.8;0.1
60;2021-02-02;26;143;14848;691;1.8;0.1
60;2021-02-03;165;228;15013;919;1.8;0.1
60;2021-02-04;170;331;15183;1250;1.8;0.2
60;2021-02-05;314;462;15497;1712;1.9;0.2
60;2021-02-06;65;76;15562;1788;1.9;0.2
60;2021-02-07;31;30;15593;1818;1.9;0.2
60;2021-02-08;329;486;15922;2304;1.9;0.3
60;2021-02-09;319;427;16241;2731;2.0;0.3
60;2021-02-10;557;945;16798;3676;2.0;0.4
60;2021-02-11;942;1059;17740;4735;2.2;0.6
60;2021-02-12;917;807;18657;5542;2.3;0.7
60;2021-02-13;91;289;18748;5831;2.3;0.7
60;2021-02-14;25;81;18773;5912;2.3;0.7
60;2021-02-15;614;633;19387;6545;2.3;0.8
60;2021-02-16;580;781;19967;7326;2.4;0.9
60;2021-02-17;633;757;20600;8083;2.5;1.0
60;2021-02-18;684;696;21284;8779;2.6;1.1
60;2021-02-19;641;624;21925;9403;2.7;1.1
60;2021-02-20;104;155;22029;9558;2.7;1.2
60;2021-02-21;23;99;22052;9657;2.7;1.2
60;2021-02-22;461;736;22513;10393;2.7;1.3
60;2021-02-23;535;656;23048;11049;2.8;1.3
60;2021-02-24;794;465;23842;11514;2.9;1.4
60;2021-02-25;1095;249;24937;11763;3.0;1.4
60;2021-02-26;1298;168;26235;11931;3.2;1.4
60;2021-02-27;666;35;26901;11966;3.3;1.5
60;2021-02-28;7;10;26908;11976;3.3;1.5
60;2021-03-01;894;47;27802;12023;3.4;1.5
60;2021-03-02;1012;158;28814;12181;3.5;1.5
60;2021-03-03;1320;424;30134;12605;3.7;1.5
60;2021-03-04;1725;472;31859;13077;3.9;1.6
60;2021-03-05;1822;283;33681;13360;4.1;1.6
60;2021-03-06;1919;141;35600;13501;4.3;1.6
60;2021-03-07;885;32;36485;13533;4.4;1.6
60;2021-03-08;978;292;37463;13825;4.5;1.7
60;2021-03-09;1643;327;39106;14152;4.7;1.7
60;2021-03-10;1938;396;41044;14548;5.0;1.8
60;2021-03-11;2325;363;43369;14911;5.3;1.8
60;2021-03-12;2596;526;45965;15437;5.6;1.9
60;2021-03-13;3839;207;49804;15644;6.0;1.9
60;2021-03-14;1782;63;51586;15707;6.3;1.9
60;2021-03-15;2090;484;53676;16191;6.5;2.0
60;2021-03-16;1584;616;55260;16807;6.7;2.0
60;2021-03-17;1658;600;56918;17407;6.9;2.1
60;2021-03-18;1759;728;58677;18135;7.1;2.2
60;2021-03-19;2591;521;61268;18656;7.4;2.3
60;2021-03-20;3241;191;64509;18847;7.8;2.3
60;2021-03-21;2124;97;66633;18944;8.1;2.3
60;2021-03-22;2132;704;68765;19648;8.3;2.4
60;2021-03-23;3310;712;72075;20360;8.7;2.5
60;2021-03-24;3070;863;75145;21223;9.1;2.6
60;2021-03-25;3849;842;78994;22065;9.6;2.7
60;2021-03-26;4217;869;83211;22934;10.1;2.8
60;2021-03-27;4142;321;87353;23255;10.6;2.8
60;2021-03-28;2450;83;89803;23338;10.9;2.8
60;2021-03-29;2612;1079;92415;24417;11.2;3.0
60;2021-03-30;3285;1067;95700;25484;11.6;3.1
60;2021-03-31;2668;1134;98368;26618;11.9;3.2
60;2021-04-01;2562;1102;100930;27720;12.2;3.4
60;2021-04-02;3310;1112;104240;28832;12.6;3.5
60;2021-04-03;3171;1010;107411;29842;13.0;3.6
60;2021-04-04;874;485;108285;30327;13.1;3.7
60;2021-04-05;458;81;108743;30408;13.2;3.7
60;2021-04-06;1968;1619;110711;32027;13.4;3.9
60;2021-04-07;1984;1745;112695;33772;13.7;4.1
60;2021-04-08;2611;1496;115306;35268;14.0;4.3
60;2021-04-09;2999;1522;118305;36790;14.3;4.5
60;2021-04-10;2927;1586;121232;38376;14.7;4.7
60;2021-04-11;1045;998;122277;39374;14.8;4.8
60;2021-04-12;2045;1721;124322;41095;15.1;5.0
60;2021-04-13;2749;1786;127071;42881;15.4;5.2
60;2021-04-14;3143;1822;130214;44703;15.8;5.4
60;2021-04-15;3563;1891;133777;46594;16.2;5.6
60;2021-04-16;3288;1952;137065;48546;16.6;5.9
60;2021-04-17;2848;2168;139913;50714;17.0;6.1
60;2021-04-18;573;1833;140486;52547;17.0;6.4
60;2021-04-19;1742;2213;142228;54760;17.2;6.6
60;2021-04-20;2129;2677;144357;57437;17.5;7.0
60;2021-04-21;2653;2208;147010;59645;17.8;7.2
60;2021-04-22;2628;2508;149638;62153;18.1;7.5
60;2021-04-23;2651;2499;152289;64652;18.5;7.8
60;2021-04-24;2470;3450;154759;68102;18.8;8.3
60;2021-04-25;1159;1959;155918;70061;18.9;8.5
60;2021-04-26;1890;2522;157808;72583;19.1;8.8
60;2021-04-27;2311;2836;160119;75419;19.4;9.1
60;2021-04-28;3061;2392;163180;77811;19.8;9.4
60;2021-04-29;3154;2622;166334;80433;20.2;9.7
60;2021-04-30;3459;2957;169793;83390;20.6;10.1
60;2021-05-01;2353;1124;172146;84514;20.9;10.2
60;2021-05-02;2147;846;174293;85360;21.1;10.3
60;2021-05-03;2956;1857;177249;87217;21.5;10.6
60;2021-05-04;3016;2352;180265;89569;21.8;10.9
60;2021-05-05;3260;2810;183525;92379;22.2;11.2
60;2021-05-06;3649;2478;187174;94857;22.7;11.5
60;2021-05-07;3985;2514;191159;97371;23.2;11.8
60;2021-05-08;3582;969;194741;98340;23.6;11.9
60;2021-05-09;3458;959;198199;99299;24.0;12.0
60;2021-05-10;2391;2294;200590;101593;24.3;12.3
60;2021-05-11;3671;2464;204261;104057;24.8;12.6
60;2021-05-12;4716;2554;208977;106611;25.3;12.9
60;2021-05-13;5292;1131;214269;107742;26.0;13.1
60;2021-05-14;5602;1807;219871;109549;26.6;13.3
60;2021-05-15;6172;1720;226043;111269;27.4;13.5
60;2021-05-16;4858;690;230901;111959;28.0;13.6
60;2021-05-17;3715;1674;234616;113633;28.4;13.8
60;2021-05-18;4045;2074;238661;115707;28.9;14.0
60;2021-05-19;5097;1857;243758;117564;29.5;14.2
60;2021-05-20;5460;1803;249218;119367;30.2;14.5
60;2021-05-21;5969;1970;255187;121337;30.9;14.7
60;2021-05-22;5354;1974;260541;123311;31.6;14.9
60;2021-05-23;4263;658;264804;123969;32.1;15.0
60;2021-05-24;2950;534;267754;124503;32.5;15.1
60;2021-05-25;4138;2005;271892;126508;33.0;15.3
60;2021-05-26;4466;1833;276358;128341;33.5;15.6
60;2021-05-27;4611;1995;280969;130336;34.1;15.8
60;2021-05-28;4626;2492;285595;132828;34.6;16.1
60;2021-05-29;4612;2268;290207;135096;35.2;16.4
60;2021-05-30;1086;347;291293;135443;35.3;16.4
60;2021-05-31;3831;2083;295124;137526;35.8;16.7
60;2021-06-01;4445;2844;299569;140370;36.3;17.0
60;2021-06-02;3916;2443;303485;142813;36.8;17.3
60;2021-06-03;3903;2370;307388;145183;37.3;17.6
60;2021-06-04;4651;2906;312039;148089;37.8;17.9
60;2021-06-05;4303;3418;316342;151507;38.3;18.4
60;2021-06-06;2159;795;318501;152302;38.6;18.5
60;2021-06-07;2778;2762;321279;155064;38.9;18.8
60;2021-06-08;3801;3000;325080;158064;39.4;19.2
60;2021-06-09;3249;3400;328329;161464;39.8;19.6
60;2021-06-10;3454;3365;331783;164829;40.2;20.0
60;2021-06-11;3881;4188;335664;169017;40.7;20.5
60;2021-06-12;3780;4280;339444;173297;41.1;21.0
60;2021-06-13;1154;2225;340598;175522;41.3;21.3
60;2021-06-14;1911;3307;342509;178829;41.5;21.7
60;2021-06-15;3015;4160;345524;182989;41.9;22.2
60;2021-06-16;3250;4487;348774;187476;42.3;22.7
60;2021-06-17;2978;4782;351752;192258;42.6;23.3
60;2021-06-18;2982;4603;354734;196861;43.0;23.9
60;2021-06-19;3144;4725;357878;201586;43.4;24.4
60;2021-06-20;1431;1936;359309;203522;43.5;24.7
60;2021-06-21;1408;4042;360717;207564;43.7;25.2
60;2021-06-22;1758;5286;362475;212850;43.9;25.8
60;2021-06-23;1860;5232;364335;218082;44.2;26.4
60;2021-06-24;1803;5600;366138;223682;44.4;27.1
60;2021-06-25;1906;5729;368044;229411;44.6;27.8
60;2021-06-26;1860;6972;369904;236383;44.8;28.6
60;2021-06-27;713;2593;370617;238976;44.9;29.0
60;2021-06-28;1781;4141;372398;243117;45.1;29.5
60;2021-06-29;2010;5460;374408;248577;45.4;30.1
60;2021-06-30;2296;5358;376704;253935;45.7;30.8
60;2021-07-01;1888;4919;378592;258854;45.9;31.4
60;2021-07-02;2370;5875;380962;264729;46.2;32.1
60;2021-07-03;2400;6157;383362;270886;46.5;32.8
60;2021-07-04;792;2724;384154;273610;46.6;33.2
60;2021-07-05;1659;4406;385813;278016;46.8;33.7
60;2021-07-06;2146;4494;387959;282510;47.0;34.2
60;2021-07-07;2174;5116;390133;287626;47.3;34.9
60;2021-07-08;2672;4689;392805;292315;47.6;35.4
60;2021-07-09;2640;5564;395445;297879;47.9;36.1
60;2021-07-10;2579;5874;398024;303753;48.2;36.8
60;2021-07-11;1212;1942;399236;305695;48.4;37.1
60;2021-07-12;1446;4736;400682;310431;48.6;37.6
60;2021-07-13;2912;5019;403594;315450;48.9;38.2
60;2021-07-14;2584;1408;406178;316858;49.2;38.4
60;2021-07-15;3429;4870;409607;321728;49.6;39.0
60;2021-07-16;3698;5238;413305;326966;50.1;39.6
60;2021-07-17;4079;5132;417384;332098;50.6;40.3
60;2021-07-18;2186;2130;419570;334228;50.9;40.5
60;2021-07-19;2542;3890;422112;338118;51.2;41.0
60;2021-07-20;4197;4896;426309;343014;51.7;41.6
60;2021-07-21;4352;4284;430661;347298;52.2;42.1
60;2021-07-22;4627;4331;435288;351629;52.8;42.6
60;2021-07-23;4981;4900;440269;356529;53.4;43.2
60;2021-07-24;4314;4674;444583;361203;53.9;43.8
60;2021-07-25;2604;1831;447187;363034;54.2;44.0
60;2021-07-26;3376;3756;450563;366790;54.6;44.5
60;2021-07-27;4437;4627;455000;371417;55.1;45.0
60;2021-07-28;4551;3769;459551;375186;55.7;45.5
60;2021-07-29;4901;3709;464452;378895;56.3;45.9
60;2021-07-30;5030;4260;469482;383155;56.9;46.4
60;2021-07-31;4063;3968;473545;387123;57.4;46.9
60;2021-08-01;1684;862;475229;387985;57.6;47.0
60;2021-08-02;3201;2754;478430;390739;58.0;47.4
60;2021-08-03;3605;2893;482035;393632;58.4;47.7
60;2021-08-04;3316;2796;485351;396428;58.8;48.0
60;2021-08-05;3032;2259;488383;398687;59.2;48.3
60;2021-08-06;3831;3055;492214;401742;59.7;48.7
60;2021-08-07;3369;3076;495583;404818;60.1;49.1
60;2021-08-08;1534;910;497117;405728;60.3;49.2
60;2021-08-09;2207;2872;499324;408600;60.5;49.5
60;2021-08-10;3277;3309;502601;411909;60.9;49.9
60;2021-08-11;2814;3238;505415;415147;61.3;50.3
60;2021-08-12;2355;2665;507770;417812;61.5;50.6
60;2021-08-13;2751;2998;510521;420810;61.9;51.0
60;2021-08-14;2541;2734;513062;423544;62.2;51.3
60;2021-08-15;1362;553;514424;424097;62.3;51.4
60;2021-08-16;2115;3774;516539;427871;62.6;51.9
60;2021-08-17;2346;3820;518885;431691;62.9;52.3
60;2021-08-18;1944;3284;520829;434975;63.1;52.7
60;2021-08-19;1647;3074;522476;438049;63.3;53.1
60;2021-08-20;1867;3999;524343;442048;63.6;53.6
60;2021-08-21;1612;3491;525955;445539;63.7;54.0
60;2021-08-22;578;1339;526533;446878;63.8;54.2
60;2021-08-23;1103;3223;527636;450101;63.9;54.6
60;2021-08-24;1371;4494;529007;454595;64.1;55.1
60;2021-08-25;1431;3585;530438;458180;64.3;55.5
60;2021-08-26;1433;3459;531871;461639;64.5;56.0
60;2021-08-27;1434;4173;533305;465812;64.6;56.5
60;2021-08-28;1378;4479;534683;470291;64.8;57.0
60;2021-08-29;550;2041;535233;472332;64.9;57.2
60;2021-08-30;1231;3001;536464;475333;65.0;57.6
60;2021-08-31;1641;3854;538105;479187;65.2;58.1
60;2021-09-01;1237;2796;539342;481983;65.4;58.4
60;2021-09-02;1058;2716;540400;484699;65.5;58.7
60;2021-09-03;1023;3179;541423;487878;65.6;59.1
60;2021-09-04;1520;3735;542943;491613;65.8;59.6
60;2021-09-05;365;1364;543308;492977;65.8;59.7
60;2021-09-06;796;2579;544104;495556;65.9;60.1
60;2021-09-07;839;2985;544943;498541;66.0;60.4
60;2021-09-08;888;2990;545831;501531;66.2;60.8
60;2021-09-09;680;2362;546511;503893;66.2;61.1
60;2021-09-10;1048;3009;547559;506902;66.4;61.4
60;2021-09-11;1059;3492;548618;510394;66.5;61.9
60;2021-09-12;307;1138;548925;511532;66.5;62.0
60;2021-09-13;609;1944;549534;513476;66.6;62.2
60;2021-09-14;757;1847;550291;515323;66.7;62.5
60;2021-09-15;563;1241;550854;516564;66.8;62.6
60;2021-09-16;917;1404;551771;517968;66.9;62.8
60;2021-09-17;712;1465;552483;519433;67.0;63.0
60;2021-09-18;818;2607;553301;522040;67.1;63.3
60;2021-09-19;189;497;553490;522537;67.1;63.3
60;2021-09-20;456;1097;553946;523634;67.1;63.5
60;2021-09-21;499;985;554445;524619;67.2;63.6
60;2021-09-22;442;1306;554887;525925;67.3;63.7
60;2021-09-23;626;899;555513;526824;67.3;63.9
60;2021-09-24;489;1194;556002;528018;67.4;64.0
60;2021-09-25;494;1873;556496;529891;67.4;64.2
60;2021-09-26;78;294;556574;530185;67.5;64.3
60;2021-09-27;330;763;556904;530948;67.5;64.4
60;2021-09-28;320;881;557224;531829;67.5;64.5
60;2021-09-29;389;1036;557613;532865;67.6;64.6
60;2021-09-30;364;736;557977;533601;67.6;64.7
60;2021-10-01;406;1032;558383;534633;67.7;64.8
60;2021-10-02;580;1460;558963;536093;67.7;65.0
60;2021-10-03;80;305;559043;536398;67.8;65.0
61;2020-12-27;0;0;0;0;0.0;0.0
61;2020-12-28;0;0;0;0;0.0;0.0
61;2020-12-29;0;0;0;0;0.0;0.0
61;2020-12-30;0;0;0;0;0.0;0.0
61;2020-12-31;0;0;0;0;0.0;0.0
61;2021-01-01;2;0;2;0;0.0;0.0
61;2021-01-02;1;0;3;0;0.0;0.0
61;2021-01-03;0;0;3;0;0.0;0.0
61;2021-01-04;1;0;4;0;0.0;0.0
61;2021-01-05;3;0;7;0;0.0;0.0
61;2021-01-06;77;0;84;0;0.0;0.0
61;2021-01-07;175;2;259;2;0.1;0.0
61;2021-01-08;405;1;664;3;0.2;0.0
61;2021-01-09;165;1;829;4;0.3;0.0
61;2021-01-10;49;0;878;4;0.3;0.0
61;2021-01-11;396;1;1274;5;0.5;0.0
61;2021-01-12;681;2;1955;7;0.7;0.0
61;2021-01-13;740;1;2695;8;1.0;0.0
61;2021-01-14;530;7;3225;15;1.2;0.0
61;2021-01-15;537;4;3762;19;1.4;0.0
61;2021-01-16;289;1;4051;20;1.5;0.0
61;2021-01-17;889;7;4940;27;1.8;0.0
61;2021-01-18;1915;2;6855;29;2.5;0.0
61;2021-01-19;1327;3;8182;32;3.0;0.0
61;2021-01-20;685;0;8867;32;3.2;0.0
61;2021-01-21;848;1;9715;33;3.5;0.0
61;2021-01-22;764;0;10479;33;3.8;0.0
61;2021-01-23;257;2;10736;35;3.9;0.0
61;2021-01-24;229;0;10965;35;4.0;0.0
61;2021-01-25;578;1;11543;36;4.2;0.0
61;2021-01-26;566;0;12109;36;4.4;0.0
61;2021-01-27;570;13;12679;49;4.6;0.0
61;2021-01-28;465;50;13144;99;4.7;0.0
61;2021-01-29;479;131;13623;230;4.9;0.1
61;2021-01-30;212;3;13835;233;5.0;0.1
61;2021-01-31;109;0;13944;233;5.0;0.1
61;2021-02-01;430;178;14374;411;5.2;0.1
61;2021-02-02;388;287;14762;698;5.3;0.3
61;2021-02-03;412;382;15174;1080;5.5;0.4
61;2021-02-04;390;261;15564;1341;5.6;0.5
61;2021-02-05;536;333;16100;1674;5.8;0.6
61;2021-02-06;205;78;16305;1752;5.9;0.6
61;2021-02-07;45;199;16350;1951;5.9;0.7
61;2021-02-08;541;1196;16891;3147;6.1;1.1
61;2021-02-09;404;739;17295;3886;6.2;1.4
61;2021-02-10;280;511;17575;4397;6.3;1.6
61;2021-02-11;432;449;18007;4846;6.5;1.8
61;2021-02-12;401;627;18408;5473;6.6;2.0
61;2021-02-13;133;331;18541;5804;6.7;2.1
61;2021-02-14;3;245;18544;6049;6.7;2.2
61;2021-02-15;169;605;18713;6654;6.8;2.4
61;2021-02-16;203;513;18916;7167;6.8;2.6
61;2021-02-17;44;458;18960;7625;6.8;2.8
61;2021-02-18;161;394;19121;8019;6.9;2.9
61;2021-02-19;101;303;19222;8322;6.9;3.0
61;2021-02-20;40;194;19262;8516;7.0;3.1
61;2021-02-21;2;119;19264;8635;7.0;3.1
61;2021-02-22;88;437;19352;9072;7.0;3.3
61;2021-02-23;104;379;19456;9451;7.0;3.4
61;2021-02-24;173;428;19629;9879;7.1;3.6
61;2021-02-25;265;323;19894;10202;7.2;3.7
61;2021-02-26;266;378;20160;10580;7.3;3.8
61;2021-02-27;110;182;20270;10762;7.3;3.9
61;2021-02-28;4;117;20274;10879;7.3;3.9
61;2021-03-01;216;521;20490;11400;7.4;4.1
61;2021-03-02;148;619;20638;12019;7.5;4.3
61;2021-03-03;143;376;20781;12395;7.5;4.5
61;2021-03-04;429;389;21210;12784;7.7;4.6
61;2021-03-05;702;266;21912;13050;7.9;4.7
61;2021-03-06;436;213;22348;13263;8.1;4.8
61;2021-03-07;155;2;22503;13265;8.1;4.8
61;2021-03-08;295;287;22798;13552;8.2;4.9
61;2021-03-09;622;159;23420;13711;8.5;5.0
61;2021-03-10;672;163;24092;13874;8.7;5.0
61;2021-03-11;1120;119;25212;13993;9.1;5.1
61;2021-03-12;1467;89;26679;14082;9.6;5.1
61;2021-03-13;775;53;27454;14135;9.9;5.1
61;2021-03-14;226;6;27680;14141;10.0;5.1
61;2021-03-15;814;35;28494;14176;10.3;5.1
61;2021-03-16;723;19;29217;14195;10.6;5.1
61;2021-03-17;761;13;29978;14208;10.8;5.1
61;2021-03-18;858;26;30836;14234;11.1;5.1
61;2021-03-19;1026;50;31862;14284;11.5;5.2
61;2021-03-20;472;15;32334;14299;11.7;5.2
61;2021-03-21;72;2;32406;14301;11.7;5.2
61;2021-03-22;797;92;33203;14393;12.0;5.2
61;2021-03-23;920;39;34123;14432;12.3;5.2
61;2021-03-24;1373;70;35496;14502;12.8;5.2
61;2021-03-25;1876;67;37372;14569;13.5;5.3
61;2021-03-26;1799;47;39171;14616;14.1;5.3
61;2021-03-27;1083;18;40254;14634;14.5;5.3
61;2021-03-28;359;9;40613;14643;14.7;5.3
61;2021-03-29;1273;182;41886;14825;15.1;5.4
61;2021-03-30;1470;98;43356;14923;15.7;5.4
61;2021-03-31;1687;52;45043;14975;16.3;5.4
61;2021-04-01;2051;231;47094;15206;17.0;5.5
61;2021-04-02;1519;433;48613;15639;17.6;5.6
61;2021-04-03;640;285;49253;15924;17.8;5.8
61;2021-04-04;193;1;49446;15925;17.9;5.8
61;2021-04-05;532;8;49978;15933;18.0;5.8
61;2021-04-06;1350;618;51328;16551;18.5;6.0
61;2021-04-07;1697;657;53025;17208;19.1;6.2
61;2021-04-08;2266;833;55291;18041;20.0;6.5
61;2021-04-09;2135;831;57426;18872;20.7;6.8
61;2021-04-10;1534;484;58960;19356;21.3;7.0
61;2021-04-11;238;199;59198;19555;21.4;7.1
61;2021-04-12;1284;734;60482;20289;21.8;7.3
61;2021-04-13;1740;705;62222;20994;22.5;7.6
61;2021-04-14;1734;784;63956;21778;23.1;7.9
61;2021-04-15;2268;782;66224;22560;23.9;8.1
61;2021-04-16;2227;688;68451;23248;24.7;8.4
61;2021-04-17;1487;324;69938;23572;25.3;8.5
61;2021-04-18;538;99;70476;23671;25.5;8.5
61;2021-04-19;936;750;71412;24421;25.8;8.8
61;2021-04-20;1523;786;72935;25207;26.3;9.1
61;2021-04-21;1351;1040;74286;26247;26.8;9.5
61;2021-04-22;1292;1217;75578;27464;27.3;9.9
61;2021-04-23;1214;1148;76792;28612;27.7;10.3
61;2021-04-24;1437;819;78229;29431;28.3;10.6
61;2021-04-25;361;331;78590;29762;28.4;10.7
61;2021-04-26;670;1143;79260;30905;28.6;11.2
61;2021-04-27;1465;1138;80725;32043;29.2;11.6
61;2021-04-28;1386;1390;82111;33433;29.7;12.1
61;2021-04-29;1246;1858;83357;35291;30.1;12.7
61;2021-04-30;1719;1173;85076;36464;30.7;13.2
61;2021-05-01;789;322;85865;36786;31.0;13.3
61;2021-05-02;439;226;86304;37012;31.2;13.4
61;2021-05-03;844;1250;87148;38262;31.5;13.8
61;2021-05-04;1323;1749;88471;40011;32.0;14.4
61;2021-05-05;1008;2027;89479;42038;32.3;15.2
61;2021-05-06;1772;2211;91251;44249;33.0;16.0
61;2021-05-07;1376;1971;92627;46220;33.5;16.7
61;2021-05-08;929;472;93556;46692;33.8;16.9
61;2021-05-09;394;293;93950;46985;33.9;17.0
61;2021-05-10;987;1746;94937;48731;34.3;17.6
61;2021-05-11;1377;1515;96314;50246;34.8;18.1
61;2021-05-12;1869;1592;98183;51838;35.5;18.7
61;2021-05-13;889;491;99072;52329;35.8;18.9
61;2021-05-14;1851;1186;100923;53515;36.4;19.3
61;2021-05-15;2107;1117;103030;54632;37.2;19.7
61;2021-05-16;984;300;104014;54932;37.6;19.8
61;2021-05-17;1312;914;105326;55846;38.0;20.2
61;2021-05-18;2423;894;107749;56740;38.9;20.5
61;2021-05-19;2400;804;110149;57544;39.8;20.8
61;2021-05-20;2212;815;112361;58359;40.6;21.1
61;2021-05-21;2150;861;114511;59220;41.4;21.4
61;2021-05-22;1780;718;116291;59938;42.0;21.6
61;2021-05-23;714;54;117005;59992;42.3;21.7
61;2021-05-24;914;111;117919;60103;42.6;21.7
61;2021-05-25;1991;920;119910;61023;43.3;22.0
61;2021-05-26;2046;932;121956;61955;44.0;22.4
61;2021-05-27;2041;1089;123997;63044;44.8;22.8
61;2021-05-28;2052;1374;126049;64418;45.5;23.3
61;2021-05-29;1466;556;127515;64974;46.1;23.5
61;2021-05-30;450;44;127965;65018;46.2;23.5
61;2021-05-31;1559;936;129524;65954;46.8;23.8
61;2021-06-01;1875;1387;131399;67341;47.5;24.3
61;2021-06-02;1676;1133;133075;68474;48.1;24.7
61;2021-06-03;2250;1110;135325;69584;48.9;25.1
61;2021-06-04;1897;1344;137222;70928;49.6;25.6
61;2021-06-05;1669;1240;138891;72168;50.2;26.1
61;2021-06-06;318;230;139209;72398;50.3;26.1
61;2021-06-07;2189;867;141398;73265;51.1;26.5
61;2021-06-08;1847;1566;143245;74831;51.7;27.0
61;2021-06-09;1975;1185;145220;76016;52.4;27.5
61;2021-06-10;1974;1192;147194;77208;53.2;27.9
61;2021-06-11;1823;1579;149017;78787;53.8;28.5
61;2021-06-12;1424;999;150441;79786;54.3;28.8
61;2021-06-13;340;377;150781;80163;54.5;28.9
61;2021-06-14;1107;1187;151888;81350;54.9;29.4
61;2021-06-15;1214;1694;153102;83044;55.3;30.0
61;2021-06-16;1114;1363;154216;84407;55.7;30.5
61;2021-06-17;1020;1730;155236;86137;56.1;31.1
61;2021-06-18;1523;1671;156759;87808;56.6;31.7
61;2021-06-19;1245;1302;158004;89110;57.1;32.2
61;2021-06-20;289;345;158293;89455;57.2;32.3
61;2021-06-21;807;1627;159100;91082;57.5;32.9
61;2021-06-22;1024;1679;160124;92761;57.8;33.5
61;2021-06-23;967;2436;161091;95197;58.2;34.4
61;2021-06-24;650;1361;161741;96558;58.4;34.9
61;2021-06-25;840;2166;162581;98724;58.7;35.7
61;2021-06-26;623;1955;163204;100679;58.9;36.4
61;2021-06-27;139;799;163343;101478;59.0;36.6
61;2021-06-28;478;2245;163821;103723;59.2;37.5
61;2021-06-29;699;2858;164520;106581;59.4;38.5
61;2021-06-30;771;2463;165291;109044;59.7;39.4
61;2021-07-01;633;1697;165924;110741;59.9;40.0
61;2021-07-02;842;2496;166766;113237;60.2;40.9
61;2021-07-03;417;1910;167183;115147;60.4;41.6
61;2021-07-04;75;638;167258;115785;60.4;41.8
61;2021-07-05;682;1774;167940;117559;60.6;42.5
61;2021-07-06;991;2792;168931;120351;61.0;43.5
61;2021-07-07;734;2360;169665;122711;61.3;44.3
61;2021-07-08;840;1944;170505;124655;61.6;45.0
61;2021-07-09;723;2375;171228;127030;61.8;45.9
61;2021-07-10;463;1767;171691;128797;62.0;46.5
61;2021-07-11;244;489;171935;129286;62.1;46.7
61;2021-07-12;438;2290;172373;131576;62.3;47.5
61;2021-07-13;643;2486;173016;134062;62.5;48.4
61;2021-07-14;150;334;173166;134396;62.5;48.5
61;2021-07-15;815;2814;173981;137210;62.8;49.6
61;2021-07-16;967;2569;174948;139779;63.2;50.5
61;2021-07-17;708;2232;175656;142011;63.4;51.3
61;2021-07-18;339;368;175995;142379;63.6;51.4
61;2021-07-19;934;2399;176929;144778;63.9;52.3
61;2021-07-20;1327;2354;178256;147132;64.4;53.1
61;2021-07-21;1503;2181;179759;149313;64.9;53.9
61;2021-07-22;1750;2188;181509;151501;65.5;54.7
61;2021-07-23;1793;2306;183302;153807;66.2;55.5
61;2021-07-24;1457;2008;184759;155815;66.7;56.3
61;2021-07-25;323;393;185082;156208;66.8;56.4
61;2021-07-26;1252;1933;186334;158141;67.3;57.1
61;2021-07-27;2419;1583;188753;159724;68.2;57.7
61;2021-07-28;2457;1355;191210;161079;69.1;58.2
61;2021-07-29;2563;1576;193773;162655;70.0;58.7
61;2021-07-30;2396;1388;196169;164043;70.8;59.2
61;2021-07-31;1282;1300;197451;165343;71.3;59.7
61;2021-08-01;504;259;197955;165602;71.5;59.8
61;2021-08-02;1913;1122;199868;166724;72.2;60.2
61;2021-08-03;2451;915;202319;167639;73.1;60.5
61;2021-08-04;2343;781;204662;168420;73.9;60.8
61;2021-08-05;1901;990;206563;169410;74.6;61.2
61;2021-08-06;2164;1163;208727;170573;75.4;61.6
61;2021-08-07;1422;799;210149;171372;75.9;61.9
61;2021-08-08;447;263;210596;171635;76.1;62.0
61;2021-08-09;1310;1112;211906;172747;76.5;62.4
61;2021-08-10;1315;1107;213221;173854;77.0;62.8
61;2021-08-11;1117;1257;214338;175111;77.4;63.2
61;2021-08-12;1038;1321;215376;176432;77.8;63.7
61;2021-08-13;879;1610;216255;178042;78.1;64.3
61;2021-08-14;717;862;216972;178904;78.4;64.6
61;2021-08-15;94;183;217066;179087;78.4;64.7
61;2021-08-16;913;1541;217979;180628;78.7;65.2
61;2021-08-17;1152;1700;219131;182328;79.1;65.8
61;2021-08-18;811;1479;219942;183807;79.4;66.4
61;2021-08-19;745;1570;220687;185377;79.7;66.9
61;2021-08-20;801;2131;221488;187508;80.0;67.7
61;2021-08-21;491;1344;221979;188852;80.2;68.2
61;2021-08-22;137;447;222116;189299;80.2;68.4
61;2021-08-23;415;1702;222531;191001;80.4;69.0
61;2021-08-24;528;1899;223059;192900;80.6;69.7
61;2021-08-25;412;1735;223471;194635;80.7;70.3
61;2021-08-26;429;1598;223900;196233;80.9;70.9
61;2021-08-27;515;1889;224415;198122;81.0;71.5
61;2021-08-28;285;1365;224700;199487;81.1;72.0
61;2021-08-29;50;417;224750;199904;81.2;72.2
61;2021-08-30;400;1625;225150;201529;81.3;72.8
61;2021-08-31;506;1714;225656;203243;81.5;73.4
61;2021-09-01;454;1499;226110;204742;81.7;73.9
61;2021-09-02;421;1341;226531;206083;81.8;74.4
61;2021-09-03;476;1580;227007;207663;82.0;75.0
61;2021-09-04;348;1337;227355;209000;82.1;75.5
61;2021-09-05;76;225;227431;209225;82.1;75.6
61;2021-09-06;285;1233;227716;210458;82.2;76.0
61;2021-09-07;362;1568;228078;212026;82.4;76.6
61;2021-09-08;273;1432;228351;213458;82.5;77.1
61;2021-09-09;285;1205;228636;214663;82.6;77.5
61;2021-09-10;366;1168;229002;215831;82.7;77.9
61;2021-09-11;270;1101;229272;216932;82.8;78.3
61;2021-09-12;37;127;229309;217059;82.8;78.4
61;2021-09-13;207;866;229516;217925;82.9;78.7
61;2021-09-14;195;693;229711;218618;83.0;79.0
61;2021-09-15;256;595;229967;219213;83.0;79.2
61;2021-09-16;220;269;230187;219482;83.1;79.3
61;2021-09-17;241;532;230428;220014;83.2;79.5
61;2021-09-18;217;611;230645;220625;83.3;79.7
61;2021-09-19;1;0;230646;220625;83.3;79.7
61;2021-09-20;177;267;230823;220892;83.4;79.8
61;2021-09-21;236;187;231059;221079;83.4;79.8
61;2021-09-22;158;692;231217;221771;83.5;80.1
61;2021-09-23;163;227;231380;221998;83.6;80.2
61;2021-09-24;135;378;231515;222376;83.6;80.3
61;2021-09-25;171;596;231686;222972;83.7;80.5
61;2021-09-26;9;16;231695;222988;83.7;80.5
61;2021-09-27;124;292;231819;223280;83.7;80.6
61;2021-09-28;96;247;231915;223527;83.8;80.7
61;2021-09-29;106;216;232021;223743;83.8;80.8
61;2021-09-30;199;236;232220;223979;83.9;80.9
61;2021-10-01;86;265;232306;224244;83.9;81.0
61;2021-10-02;196;564;232502;224808;84.0;81.2
61;2021-10-03;1;8;232503;224816;84.0;81.2
62;2020-12-27;2;0;2;0;0.0;0.0
62;2020-12-28;1;0;3;0;0.0;0.0
62;2020-12-29;0;0;3;0;0.0;0.0
62;2020-12-30;0;0;3;0;0.0;0.0
62;2020-12-31;0;0;3;0;0.0;0.0
62;2021-01-01;0;0;3;0;0.0;0.0
62;2021-01-02;2;0;5;0;0.0;0.0
62;2021-01-03;0;0;5;0;0.0;0.0
62;2021-01-04;3;0;8;0;0.0;0.0
62;2021-01-05;47;0;55;0;0.0;0.0
62;2021-01-06;123;0;178;0;0.0;0.0
62;2021-01-07;351;0;529;0;0.0;0.0
62;2021-01-08;713;7;1242;7;0.1;0.0
62;2021-01-09;164;1;1406;8;0.1;0.0
62;2021-01-10;84;0;1490;8;0.1;0.0
62;2021-01-11;557;1;2047;9;0.1;0.0
62;2021-01-12;1260;3;3307;12;0.2;0.0
62;2021-01-13;1139;6;4446;18;0.3;0.0
62;2021-01-14;1385;8;5831;26;0.4;0.0
62;2021-01-15;1300;8;7131;34;0.5;0.0
62;2021-01-16;309;2;7440;36;0.5;0.0
62;2021-01-17;107;0;7547;36;0.5;0.0
62;2021-01-18;1666;8;9213;44;0.6;0.0
62;2021-01-19;2104;4;11317;48;0.8;0.0
62;2021-01-20;2056;5;13373;53;0.9;0.0
62;2021-01-21;2244;5;15617;58;1.1;0.0
62;2021-01-22;1835;7;17452;65;1.2;0.0
62;2021-01-23;512;1;17964;66;1.2;0.0
62;2021-01-24;0;0;17964;66;1.2;0.0
62;2021-01-25;1286;6;19250;72;1.3;0.0
62;2021-01-26;1546;13;20796;85;1.4;0.0
62;2021-01-27;1518;139;22314;224;1.5;0.0
62;2021-01-28;4180;344;26494;568;1.8;0.0
62;2021-01-29;2047;304;28541;872;2.0;0.1
62;2021-01-30;159;128;28700;1000;2.0;0.1
62;2021-01-31;22;3;28722;1003;2.0;0.1
62;2021-02-01;46;317;28768;1320;2.0;0.1
62;2021-02-02;59;736;28827;2056;2.0;0.1
62;2021-02-03;44;574;28871;2630;2.0;0.2
62;2021-02-04;81;744;28952;3374;2.0;0.2
62;2021-02-05;81;636;29033;4010;2.0;0.3
62;2021-02-06;32;155;29065;4165;2.0;0.3
62;2021-02-07;236;30;29301;4195;2.0;0.3
62;2021-02-08;133;675;29434;4870;2.0;0.3
62;2021-02-09;227;912;29661;5782;2.0;0.4
62;2021-02-10;385;996;30046;6778;2.1;0.5
62;2021-02-11;726;846;30772;7624;2.1;0.5
62;2021-02-12;967;640;31739;8264;2.2;0.6
62;2021-02-13;162;209;31901;8473;2.2;0.6
62;2021-02-14;0;0;31901;8473;2.2;0.6
62;2021-02-15;665;926;32566;9399;2.2;0.6
62;2021-02-16;923;1376;33489;10775;2.3;0.7
62;2021-02-17;1082;1619;34571;12394;2.4;0.9
62;2021-02-18;2227;3407;36798;15801;2.5;1.1
62;2021-02-19;2312;2262;39110;18063;2.7;1.2
62;2021-02-20;616;372;39726;18435;2.7;1.3
62;2021-02-21;88;26;39814;18461;2.7;1.3
62;2021-02-22;849;713;40663;19174;2.8;1.3
62;2021-02-23;1419;995;42082;20169;2.9;1.4
62;2021-02-24;1547;537;43629;20706;3.0;1.4
62;2021-02-25;3169;371;46798;21077;3.2;1.5
62;2021-02-26;2912;302;49710;21379;3.4;1.5
62;2021-02-27;1829;85;51539;21464;3.5;1.5
62;2021-02-28;52;42;51591;21506;3.6;1.5
62;2021-03-01;1322;103;52913;21609;3.6;1.5
62;2021-03-02;3156;161;56069;21770;3.9;1.5
62;2021-03-03;3274;131;59343;21901;4.1;1.5
62;2021-03-04;3809;216;63152;22117;4.3;1.5
62;2021-03-05;4647;230;67799;22347;4.7;1.5
62;2021-03-06;9619;266;77418;22613;5.3;1.6
62;2021-03-07;8074;226;85492;22839;5.9;1.6
62;2021-03-08;2195;234;87687;23073;6.0;1.6
62;2021-03-09;3809;352;91496;23425;6.3;1.6
62;2021-03-10;4233;566;95729;23991;6.6;1.7
62;2021-03-11;5993;1484;101722;25475;7.0;1.8
62;2021-03-12;6639;1380;108361;26855;7.5;1.8
62;2021-03-13;14723;799;123084;27654;8.5;1.9
62;2021-03-14;9584;411;132668;28065;9.1;1.9
62;2021-03-15;3762;995;136430;29060;9.4;2.0
62;2021-03-16;2736;834;139166;29894;9.6;2.1
62;2021-03-17;2805;721;141971;30615;9.8;2.1
62;2021-03-18;2725;936;144696;31551;10.0;2.2
62;2021-03-19;4783;910;149479;32461;10.3;2.2
62;2021-03-20;11066;620;160545;33081;11.1;2.3
62;2021-03-21;9447;374;169992;33455;11.7;2.3
62;2021-03-22;2943;1089;172935;34544;11.9;2.4
62;2021-03-23;4997;1470;177932;36014;12.2;2.5
62;2021-03-24;4696;1364;182628;37378;12.6;2.6
62;2021-03-25;6553;1461;189181;38839;13.0;2.7
62;2021-03-26;7049;1489;196230;40328;13.5;2.8
62;2021-03-27;12594;754;208824;41082;14.4;2.8
62;2021-03-28;6941;289;215765;41371;14.9;2.8
62;2021-03-29;3470;1202;219235;42573;15.1;2.9
62;2021-03-30;4549;2204;223784;44777;15.4;3.1
62;2021-03-31;4225;2459;228009;47236;15.7;3.3
62;2021-04-01;4977;2762;232986;49998;16.0;3.4
62;2021-04-02;5067;3231;238053;53229;16.4;3.7
62;2021-04-03;8208;3347;246261;56576;17.0;3.9
62;2021-04-04;4582;1935;250843;58511;17.3;4.0
62;2021-04-05;944;461;251787;58972;17.3;4.1
62;2021-04-06;4122;3009;255909;61981;17.6;4.3
62;2021-04-07;5071;3519;260980;65500;18.0;4.5
62;2021-04-08;6492;3988;267472;69488;18.4;4.8
62;2021-04-09;7628;3478;275100;72966;18.9;5.0
62;2021-04-10;6636;8071;281736;81037;19.4;5.6
62;2021-04-11;2804;6881;284540;87918;19.6;6.1
62;2021-04-12;3419;2386;287959;90304;19.8;6.2
62;2021-04-13;6171;3164;294130;93468;20.2;6.4
62;2021-04-14;5307;3064;299437;96532;20.6;6.6
62;2021-04-15;5734;2987;305171;99519;21.0;6.9
62;2021-04-16;5418;3201;310589;102720;21.4;7.1
62;2021-04-17;4356;7355;314945;110075;21.7;7.6
62;2021-04-18;1957;6847;316902;116922;21.8;8.0
62;2021-04-19;2777;1934;319679;118856;22.0;8.2
62;2021-04-20;4148;3886;323827;122742;22.3;8.4
62;2021-04-21;3746;3986;327573;126728;22.5;8.7
62;2021-04-22;3948;5194;331521;131922;22.8;9.1
62;2021-04-23;4064;5321;335585;137243;23.1;9.4
62;2021-04-24;4401;6726;339986;143969;23.4;9.9
62;2021-04-25;1911;3498;341897;147467;23.5;10.2
62;2021-04-26;2224;2421;344121;149888;23.7;10.3
62;2021-04-27;4408;3748;348529;153636;24.0;10.6
62;2021-04-28;4591;4399;353120;158035;24.3;10.9
62;2021-04-29;4787;5849;357907;163884;24.6;11.3
62;2021-04-30;5215;5689;363122;169573;25.0;11.7
62;2021-05-01;5725;3472;368847;173045;25.4;11.9
62;2021-05-02;7826;3147;376673;176192;25.9;12.1
62;2021-05-03;4509;2337;381182;178529;26.2;12.3
62;2021-05-04;5396;4965;386578;183494;26.6;12.6
62;2021-05-05;4736;4823;391314;188317;26.9;13.0
62;2021-05-06;5619;4936;396933;193253;27.3;13.3
62;2021-05-07;7690;4657;404623;197910;27.9;13.6
62;2021-05-08;10658;2329;415281;200239;28.6;13.8
62;2021-05-09;8625;1642;423906;201881;29.2;13.9
62;2021-05-10;4867;4018;428773;205899;29.5;14.2
62;2021-05-11;6414;5039;435187;210938;30.0;14.5
62;2021-05-12;8624;4589;443811;215527;30.5;14.8
62;2021-05-13;9998;1491;453809;217018;31.2;14.9
62;2021-05-14;11880;3392;465689;220410;32.1;15.2
62;2021-05-15;19781;3295;485470;223705;33.4;15.4
62;2021-05-16;16398;1419;501868;225124;34.5;15.5
62;2021-05-17;8180;2658;510048;227782;35.1;15.7
62;2021-05-18;9325;3129;519373;230911;35.8;15.9
62;2021-05-19;8615;2927;527988;233838;36.3;16.1
62;2021-05-20;8341;3839;536329;237677;36.9;16.4
62;2021-05-21;9397;4215;545726;241892;37.6;16.7
62;2021-05-22;17874;3525;563600;245417;38.8;16.9
62;2021-05-23;12373;1162;575973;246579;39.6;17.0
62;2021-05-24;3911;586;579884;247165;39.9;17.0
62;2021-05-25;7221;4097;587105;251262;40.4;17.3
62;2021-05-26;6782;4912;593887;256174;40.9;17.6
62;2021-05-27;6382;5686;600269;261860;41.3;18.0
62;2021-05-28;6518;6729;606787;268589;41.8;18.5
62;2021-05-29;10849;5536;617636;274125;42.5;18.9
62;2021-05-30;4036;982;621672;275107;42.8;18.9
62;2021-05-31;4794;3947;626466;279054;43.1;19.2
62;2021-06-01;6520;6507;632986;285561;43.6;19.7
62;2021-06-02;7444;5810;640430;291371;44.1;20.1
62;2021-06-03;7854;5879;648284;297250;44.6;20.5
62;2021-06-04;7903;6238;656187;303488;45.2;20.9
62;2021-06-05;8273;6226;664460;309714;45.7;21.3
62;2021-06-06;3128;1290;667588;311004;46.0;21.4
62;2021-06-07;4625;3763;672213;314767;46.3;21.7
62;2021-06-08;6207;5902;678420;320669;46.7;22.1
62;2021-06-09;5498;4763;683918;325432;47.1;22.4
62;2021-06-10;5206;5863;689124;331295;47.4;22.8
62;2021-06-11;6208;8867;695332;340162;47.9;23.4
62;2021-06-12;5935;8644;701267;348806;48.3;24.0
62;2021-06-13;3225;3793;704492;352599;48.5;24.3
62;2021-06-14;2610;6771;707102;359370;48.7;24.7
62;2021-06-15;4675;8529;711777;367899;49.0;25.3
62;2021-06-16;5081;7429;716858;375328;49.3;25.8
62;2021-06-17;5235;8041;722093;383369;49.7;26.4
62;2021-06-18;4825;10490;726918;393859;50.0;27.1
62;2021-06-19;5794;13435;732712;407294;50.4;28.0
62;2021-06-20;2101;4369;734813;411663;50.6;28.3
62;2021-06-21;2976;8922;737789;420585;50.8;29.0
62;2021-06-22;3431;10169;741220;430754;51.0;29.7
62;2021-06-23;3387;10315;744607;441069;51.3;30.4
62;2021-06-24;3346;11784;747953;452853;51.5;31.2
62;2021-06-25;3724;15762;751677;468615;51.7;32.3
62;2021-06-26;3549;18423;755226;487038;52.0;33.5
62;2021-06-27;1121;9814;756347;496852;52.1;34.2
62;2021-06-28;1923;8865;758270;505717;52.2;34.8
62;2021-06-29;2973;11461;761243;517178;52.4;35.6
62;2021-06-30;4142;10809;765385;527987;52.7;36.3
62;2021-07-01;4483;10483;769868;538470;53.0;37.1
62;2021-07-02;4161;11980;774029;550450;53.3;37.9
62;2021-07-03;2997;18053;777026;568503;53.5;39.1
62;2021-07-04;1450;9196;778476;577699;53.6;39.8
62;2021-07-05;2416;6913;780892;584612;53.8;40.2
62;2021-07-06;3821;10013;784713;594625;54.0;40.9
62;2021-07-07;3917;8912;788630;603537;54.3;41.5
62;2021-07-08;5247;9081;793877;612618;54.6;42.2
62;2021-07-09;4471;10842;798348;623460;55.0;42.9
62;2021-07-10;4975;11890;803323;635350;55.3;43.7
62;2021-07-11;1337;2088;804660;637438;55.4;43.9
62;2021-07-12;2327;7133;806987;644571;55.5;44.4
62;2021-07-13;5175;12153;812162;656724;55.9;45.2
62;2021-07-14;3634;3164;815796;659888;56.2;45.4
62;2021-07-15;7587;11492;823383;671380;56.7;46.2
62;2021-07-16;7625;11044;831008;682424;57.2;47.0
62;2021-07-17;9719;10330;840727;692754;57.9;47.7
62;2021-07-18;2712;3457;843439;696211;58.1;47.9
62;2021-07-19;6012;7013;849451;703224;58.5;48.4
62;2021-07-20;7935;10721;857386;713945;59.0;49.1
62;2021-07-21;9776;9405;867162;723350;59.7;49.8
62;2021-07-22;9800;9013;876962;732363;60.4;50.4
62;2021-07-23;10629;8405;887591;740768;61.1;51.0
62;2021-07-24;9664;10318;897255;751086;61.8;51.7
62;2021-07-25;5549;1877;902804;752963;62.1;51.8
62;2021-07-26;6239;5384;909043;758347;62.6;52.2
62;2021-07-27;9851;8125;918894;766472;63.3;52.8
62;2021-07-28;10404;7488;929298;773960;64.0;53.3
62;2021-07-29;12006;7657;941304;781617;64.8;53.8
62;2021-07-30;9092;6290;950396;787907;65.4;54.2
62;2021-07-31;6639;4023;957035;791930;65.9;54.5
62;2021-08-01;2342;1103;959377;793033;66.0;54.6
62;2021-08-02;6866;4759;966243;797792;66.5;54.9
62;2021-08-03;8628;7472;974871;805264;67.1;55.4
62;2021-08-04;9491;5483;984362;810747;67.8;55.8
62;2021-08-05;8375;5630;992737;816377;68.3;56.2
62;2021-08-06;7321;5933;1000058;822310;68.8;56.6
62;2021-08-07;5493;4958;1005551;827268;69.2;56.9
62;2021-08-08;1875;1301;1007426;828569;69.3;57.0
62;2021-08-09;5262;5031;1012688;833600;69.7;57.4
62;2021-08-10;6221;7358;1018909;840958;70.1;57.9
62;2021-08-11;5413;7381;1024322;848339;70.5;58.4
62;2021-08-12;6008;7002;1030330;855341;70.9;58.9
62;2021-08-13;4522;6061;1034852;861402;71.2;59.3
62;2021-08-14;3838;6866;1038690;868268;71.5;59.8
62;2021-08-15;1141;1212;1039831;869480;71.6;59.8
62;2021-08-16;3188;5864;1043019;875344;71.8;60.3
62;2021-08-17;4172;7347;1047191;882691;72.1;60.8
62;2021-08-18;4358;7243;1051549;889934;72.4;61.3
62;2021-08-19;4392;8580;1055941;898514;72.7;61.8
62;2021-08-20;3445;8464;1059386;906978;72.9;62.4
62;2021-08-21;2459;9765;1061845;916743;73.1;63.1
62;2021-08-22;392;2816;1062237;919559;73.1;63.3
62;2021-08-23;2746;7831;1064983;927390;73.3;63.8
62;2021-08-24;3841;10407;1068824;937797;73.6;64.6
62;2021-08-25;3510;9198;1072334;946995;73.8;65.2
62;2021-08-26;3192;9773;1075526;956768;74.0;65.9
62;2021-08-27;2598;8826;1078124;965594;74.2;66.5
62;2021-08-28;2043;7997;1080167;973591;74.4;67.0
62;2021-08-29;864;2253;1081031;975844;74.4;67.2
62;2021-08-30;2047;7387;1083078;983231;74.6;67.7
62;2021-08-31;2141;8022;1085219;991253;74.7;68.2
62;2021-09-01;1827;6169;1087046;997422;74.8;68.7
62;2021-09-02;1853;6851;1088899;1004273;75.0;69.1
62;2021-09-03;2071;7443;1090970;1011716;75.1;69.6
62;2021-09-04;2122;6680;1093092;1018396;75.2;70.1
62;2021-09-05;317;1265;1093409;1019661;75.3;70.2
62;2021-09-06;1029;3808;1094438;1023469;75.3;70.4
62;2021-09-07;1232;4350;1095670;1027819;75.4;70.7
62;2021-09-08;1285;4557;1096955;1032376;75.5;71.1
62;2021-09-09;1272;4712;1098227;1037088;75.6;71.4
62;2021-09-10;1587;4967;1099814;1042055;75.7;71.7
62;2021-09-11;1269;4291;1101083;1046346;75.8;72.0
62;2021-09-12;201;547;1101284;1046893;75.8;72.1
62;2021-09-13;768;2754;1102052;1049647;75.9;72.3
62;2021-09-14;1254;4267;1103306;1053914;75.9;72.5
62;2021-09-15;1328;4219;1104634;1058133;76.0;72.8
62;2021-09-16;1372;2913;1106006;1061046;76.1;73.0
62;2021-09-17;1327;2414;1107333;1063460;76.2;73.2
62;2021-09-18;1079;2881;1108412;1066341;76.3;73.4
62;2021-09-19;136;448;1108548;1066789;76.3;73.4
62;2021-09-20;600;1473;1109148;1068262;76.3;73.5
62;2021-09-21;885;2423;1110033;1070685;76.4;73.7
62;2021-09-22;789;2671;1110822;1073356;76.5;73.9
62;2021-09-23;724;1837;1111546;1075193;76.5;74.0
62;2021-09-24;812;1984;1112358;1077177;76.6;74.1
62;2021-09-25;715;2668;1113073;1079845;76.6;74.3
62;2021-09-26;73;373;1113146;1080218;76.6;74.4
62;2021-09-27;312;1055;1113458;1081273;76.6;74.4
62;2021-09-28;584;1702;1114042;1082975;76.7;74.5
62;2021-09-29;758;1900;1114800;1084875;76.7;74.7
62;2021-09-30;446;1003;1115246;1085878;76.8;74.7
62;2021-10-01;692;1651;1115938;1087529;76.8;74.9
62;2021-10-02;682;1492;1116620;1089021;76.9;75.0
62;2021-10-03;81;236;1116701;1089257;76.9;75.0
63;2020-12-27;0;0;0;0;0.0;0.0
63;2020-12-28;1;0;1;0;0.0;0.0
63;2020-12-29;0;0;1;0;0.0;0.0
63;2020-12-30;0;0;1;0;0.0;0.0
63;2020-12-31;0;0;1;0;0.0;0.0
63;2021-01-01;1;0;2;0;0.0;0.0
63;2021-01-02;0;0;2;0;0.0;0.0
63;2021-01-03;1;0;3;0;0.0;0.0
63;2021-01-04;0;0;3;0;0.0;0.0
63;2021-01-05;1;0;4;0;0.0;0.0
63;2021-01-06;4;1;8;1;0.0;0.0
63;2021-01-07;310;0;318;1;0.0;0.0
63;2021-01-08;217;0;535;1;0.1;0.0
63;2021-01-09;91;0;626;1;0.1;0.0
63;2021-01-10;82;0;708;1;0.1;0.0
63;2021-01-11;431;2;1139;3;0.2;0.0
63;2021-01-12;661;1;1800;4;0.3;0.0
63;2021-01-13;873;2;2673;6;0.4;0.0
63;2021-01-14;547;8;3220;14;0.5;0.0
63;2021-01-15;432;3;3652;17;0.6;0.0
63;2021-01-16;157;0;3809;17;0.6;0.0
63;2021-01-17;133;0;3942;17;0.6;0.0
63;2021-01-18;634;2;4576;19;0.7;0.0
63;2021-01-19;868;2;5444;21;0.8;0.0
63;2021-01-20;1069;1;6513;22;1.0;0.0
63;2021-01-21;1018;3;7531;25;1.1;0.0
63;2021-01-22;970;3;8501;28;1.3;0.0
63;2021-01-23;192;0;8693;28;1.3;0.0
63;2021-01-24;164;1;8857;29;1.3;0.0
63;2021-01-25;829;0;9686;29;1.5;0.0
63;2021-01-26;974;2;10660;31;1.6;0.0
63;2021-01-27;1003;4;11663;35;1.8;0.0
63;2021-01-28;1322;67;12985;102;2.0;0.0
63;2021-01-29;1066;62;14051;164;2.1;0.0
63;2021-01-30;68;0;14119;164;2.1;0.0
63;2021-01-31;6;0;14125;164;2.1;0.0
63;2021-02-01;575;162;14700;326;2.2;0.0
63;2021-02-02;886;219;15586;545;2.4;0.1
63;2021-02-03;1475;269;17061;814;2.6;0.1
63;2021-02-04;2120;489;19181;1303;2.9;0.2
63;2021-02-05;1144;253;20325;1556;3.1;0.2
63;2021-02-06;116;0;20441;1556;3.1;0.2
63;2021-02-07;9;1;20450;1557;3.1;0.2
63;2021-02-08;538;345;20988;1902;3.2;0.3
63;2021-02-09;671;359;21659;2261;3.3;0.3
63;2021-02-10;609;508;22268;2769;3.4;0.4
63;2021-02-11;751;404;23019;3173;3.5;0.5
63;2021-02-12;820;732;23839;3905;3.6;0.6
63;2021-02-13;82;1;23921;3906;3.6;0.6
63;2021-02-14;0;57;23921;3963;3.6;0.6
63;2021-02-15;202;620;24123;4583;3.7;0.7
63;2021-02-16;409;951;24532;5534;3.7;0.8
63;2021-02-17;359;666;24891;6200;3.8;0.9
63;2021-02-18;607;659;25498;6859;3.9;1.0
63;2021-02-19;449;764;25947;7623;3.9;1.2
63;2021-02-20;35;17;25982;7640;3.9;1.2
63;2021-02-21;2;9;25984;7649;3.9;1.2
63;2021-02-22;291;689;26275;8338;4.0;1.3
63;2021-02-23;580;881;26855;9219;4.1;1.4
63;2021-02-24;696;1202;27551;10421;4.2;1.6
63;2021-02-25;1603;1437;29154;11858;4.4;1.8
63;2021-02-26;1623;1195;30777;13053;4.7;2.0
63;2021-02-27;641;66;31418;13119;4.8;2.0
63;2021-02-28;4;177;31422;13296;4.8;2.0
63;2021-03-01;586;403;32008;13699;4.8;2.1
63;2021-03-02;907;652;32915;14351;5.0;2.2
63;2021-03-03;1036;591;33951;14942;5.1;2.3
63;2021-03-04;1754;424;35705;15366;5.4;2.3
63;2021-03-05;2612;620;38317;15986;5.8;2.4
63;2021-03-06;1551;53;39868;16039;6.0;2.4
63;2021-03-07;514;19;40382;16058;6.1;2.4
63;2021-03-08;967;565;41349;16623;6.3;2.5
63;2021-03-09;1539;904;42888;17527;6.5;2.7
63;2021-03-10;1654;544;44542;18071;6.7;2.7
63;2021-03-11;3056;854;47598;18925;7.2;2.9
63;2021-03-12;3513;380;51111;19305;7.7;2.9
63;2021-03-13;2048;81;53159;19386;8.1;2.9
63;2021-03-14;61;21;53220;19407;8.1;2.9
63;2021-03-15;1769;359;54989;19766;8.3;3.0
63;2021-03-16;1746;390;56735;20156;8.6;3.1
63;2021-03-17;1642;652;58377;20808;8.8;3.2
63;2021-03-18;1945;730;60322;21538;9.1;3.3
63;2021-03-19;2742;482;63064;22020;9.6;3.3
63;2021-03-20;1121;67;64185;22087;9.7;3.3
63;2021-03-21;50;45;64235;22132;9.7;3.4
63;2021-03-22;1984;253;66219;22385;10.0;3.4
63;2021-03-23;2885;343;69104;22728;10.5;3.4
63;2021-03-24;3224;346;72328;23074;11.0;3.5
63;2021-03-25;4597;390;76925;23464;11.7;3.6
63;2021-03-26;4693;545;81618;24009;12.4;3.6
63;2021-03-27;2457;232;84075;24241;12.7;3.7
63;2021-03-28;1047;83;85122;24324;12.9;3.7
63;2021-03-29;2480;515;87602;24839;13.3;3.8
63;2021-03-30;3283;627;90885;25466;13.8;3.9
63;2021-03-31;2968;746;93853;26212;14.2;4.0
63;2021-04-01;3844;522;97697;26734;14.8;4.0
63;2021-04-02;3485;711;101182;27445;15.3;4.2
63;2021-04-03;1174;181;102356;27626;15.5;4.2
63;2021-04-04;877;28;103233;27654;15.6;4.2
63;2021-04-05;801;85;104034;27739;15.8;4.2
63;2021-04-06;2480;940;106514;28679;16.1;4.3
63;2021-04-07;3208;873;109722;29552;16.6;4.5
63;2021-04-08;4721;1221;114443;30773;17.3;4.7
63;2021-04-09;5314;999;119757;31772;18.1;4.8
63;2021-04-10;2221;481;121978;32253;18.5;4.9
63;2021-04-11;835;40;122813;32293;18.6;4.9
63;2021-04-12;1595;1309;124408;33602;18.8;5.1
63;2021-04-13;1986;1962;126394;35564;19.1;5.4
63;2021-04-14;2631;1438;129025;37002;19.5;5.6
63;2021-04-15;3809;1541;132834;38543;20.1;5.8
63;2021-04-16;2840;2157;135674;40700;20.5;6.2
63;2021-04-17;1233;672;136907;41372;20.7;6.3
63;2021-04-18;803;63;137710;41435;20.9;6.3
63;2021-04-19;1657;2099;139367;43534;21.1;6.6
63;2021-04-20;1702;2298;141069;45832;21.4;6.9
63;2021-04-21;1514;2407;142583;48239;21.6;7.3
63;2021-04-22;1916;2259;144499;50498;21.9;7.6
63;2021-04-23;2019;3109;146518;53607;22.2;8.1
63;2021-04-24;1192;1127;147710;54734;22.4;8.3
63;2021-04-25;554;412;148264;55146;22.5;8.4
63;2021-04-26;1438;2240;149702;57386;22.7;8.7
63;2021-04-27;2326;2607;152028;59993;23.0;9.1
63;2021-04-28;2346;3157;154374;63150;23.4;9.6
63;2021-04-29;2882;2805;157256;65955;23.8;10.0
63;2021-04-30;2862;2802;160118;68757;24.3;10.4
63;2021-05-01;1127;1051;161245;69808;24.4;10.6
63;2021-05-02;897;639;162142;70447;24.6;10.7
63;2021-05-03;2686;2233;164828;72680;25.0;11.0
63;2021-05-04;2879;2689;167707;75369;25.4;11.4
63;2021-05-05;2938;3118;170645;78487;25.8;11.9
63;2021-05-06;3673;3051;174318;81538;26.4;12.3
63;2021-05-07;4032;3525;178350;85063;27.0;12.9
63;2021-05-08;2002;654;180352;85717;27.3;13.0
63;2021-05-09;1802;606;182154;86323;27.6;13.1
63;2021-05-10;4194;2760;186348;89083;28.2;13.5
63;2021-05-11;5338;2758;191686;91841;29.0;13.9
63;2021-05-12;5274;2905;196960;94746;29.8;14.4
63;2021-05-13;4136;699;201096;95445;30.5;14.5
63;2021-05-14;4772;1509;205868;96954;31.2;14.7
63;2021-05-15;3727;986;209595;97940;31.7;14.8
63;2021-05-16;3521;447;213116;98387;32.3;14.9
63;2021-05-17;3902;1993;217018;100380;32.9;15.2
63;2021-05-18;5124;1610;222142;101990;33.6;15.4
63;2021-05-19;5228;1627;227370;103617;34.4;15.7
63;2021-05-20;6806;2090;234176;105707;35.5;16.0
63;2021-05-21;6256;2328;240432;108035;36.4;16.4
63;2021-05-22;3352;848;243784;108883;36.9;16.5
63;2021-05-23;2388;245;246172;109128;37.3;16.5
63;2021-05-24;2643;581;248815;109709;37.7;16.6
63;2021-05-25;4270;2642;253085;112351;38.3;17.0
63;2021-05-26;5452;2421;258537;114772;39.2;17.4
63;2021-05-27;6502;2799;265039;117571;40.1;17.8
63;2021-05-28;5422;3877;270461;121448;41.0;18.4
63;2021-05-29;3361;1500;273822;122948;41.5;18.6
63;2021-05-30;1579;217;275401;123165;41.7;18.7
63;2021-05-31;4157;2284;279558;125449;42.3;19.0
63;2021-06-01;3805;2946;283363;128395;42.9;19.4
63;2021-06-02;3886;2524;287249;130919;43.5;19.8
63;2021-06-03;4902;3134;292151;134053;44.2;20.3
63;2021-06-04;5100;3619;297251;137672;45.0;20.9
63;2021-06-05;2816;1742;300067;139414;45.4;21.1
63;2021-06-06;1309;698;301376;140112;45.6;21.2
63;2021-06-07;3163;2514;304539;142626;46.1;21.6
63;2021-06-08;2883;2746;307422;145372;46.6;22.0
63;2021-06-09;3025;2266;310447;147638;47.0;22.4
63;2021-06-10;3226;2688;313673;150326;47.5;22.8
63;2021-06-11;3099;4043;316772;154369;48.0;23.4
63;2021-06-12;1640;1969;318412;156338;48.2;23.7
63;2021-06-13;482;1098;318894;157436;48.3;23.8
63;2021-06-14;1824;3472;320718;160908;48.6;24.4
63;2021-06-15;2210;3477;322928;164385;48.9;24.9
63;2021-06-16;2576;3313;325504;167698;49.3;25.4
63;2021-06-17;2398;4314;327902;172012;49.7;26.1
63;2021-06-18;2480;5824;330382;177836;50.0;26.9
63;2021-06-19;1643;2835;332025;180671;50.3;27.4
63;2021-06-20;677;2441;332702;183112;50.4;27.7
63;2021-06-21;1272;5386;333974;188498;50.6;28.5
63;2021-06-22;1233;5537;335207;194035;50.8;29.4
63;2021-06-23;1532;4766;336739;198801;51.0;30.1
63;2021-06-24;1925;5383;338664;204184;51.3;30.9
63;2021-06-25;1751;5894;340415;210078;51.6;31.8
63;2021-06-26;1073;3352;341488;213430;51.7;32.3
63;2021-06-27;712;3487;342200;216917;51.8;32.9
63;2021-06-28;1136;5663;343336;222580;52.0;33.7
63;2021-06-29;1225;5159;344561;227739;52.2;34.5
63;2021-06-30;1606;5292;346167;233031;52.4;35.3
63;2021-07-01;1930;8064;348097;241095;52.7;36.5
63;2021-07-02;2061;6539;350158;247634;53.0;37.5
63;2021-07-03;965;2926;351123;250560;53.2;37.9
63;2021-07-04;1066;1885;352189;252445;53.3;38.2
63;2021-07-05;1539;6279;353728;258724;53.6;39.2
63;2021-07-06;1607;4808;355335;263532;53.8;39.9
63;2021-07-07;1975;4087;357310;267619;54.1;40.5
63;2021-07-08;2205;4579;359515;272198;54.5;41.2
63;2021-07-09;1924;5718;361439;277916;54.7;42.1
63;2021-07-10;1535;3415;362974;281331;55.0;42.6
63;2021-07-11;910;1537;363884;282868;55.1;42.8
63;2021-07-12;1597;8701;365481;291569;55.4;44.2
63;2021-07-13;3598;6131;369079;297700;55.9;45.1
63;2021-07-14;3618;1790;372697;299490;56.4;45.4
63;2021-07-15;4415;5027;377112;304517;57.1;46.1
63;2021-07-16;4694;5782;381806;310299;57.8;47.0
63;2021-07-17;3012;2473;384818;312772;58.3;47.4
63;2021-07-18;2825;1090;387643;313862;58.7;47.5
63;2021-07-19;4002;4844;391645;318706;59.3;48.3
63;2021-07-20;4737;5456;396382;324162;60.0;49.1
63;2021-07-21;4790;3975;401172;328137;60.8;49.7
63;2021-07-22;5509;4397;406681;332534;61.6;50.4
63;2021-07-23;5162;4651;411843;337185;62.4;51.1
63;2021-07-24;3677;1951;415520;339136;62.9;51.4
63;2021-07-25;3065;1438;418585;340574;63.4;51.6
63;2021-07-26;4042;3228;422627;343802;64.0;52.1
63;2021-07-27;3934;3162;426561;346964;64.6;52.6
63;2021-07-28;3854;2717;430415;349681;65.2;53.0
63;2021-07-29;4454;3157;434869;352838;65.9;53.4
63;2021-07-30;3816;3574;438685;356412;66.4;54.0
63;2021-07-31;2162;1718;440847;358130;66.8;54.2
63;2021-08-01;1197;836;442044;358966;67.0;54.4
63;2021-08-02;2238;3067;444282;362033;67.3;54.8
63;2021-08-03;2739;3252;447021;365285;67.7;55.3
63;2021-08-04;2818;3247;449839;368532;68.1;55.8
63;2021-08-05;2449;3477;452288;372009;68.5;56.3
63;2021-08-06;2360;4150;454648;376159;68.9;57.0
63;2021-08-07;1308;2807;455956;378966;69.1;57.4
63;2021-08-08;324;1205;456280;380171;69.1;57.6
63;2021-08-09;1905;4222;458185;384393;69.4;58.2
63;2021-08-10;2307;3993;460492;388386;69.7;58.8
63;2021-08-11;2142;3628;462634;392014;70.1;59.4
63;2021-08-12;1954;4621;464588;396635;70.4;60.1
63;2021-08-13;1688;4009;466276;400644;70.6;60.7
63;2021-08-14;841;3237;467117;403881;70.7;61.2
63;2021-08-15;184;1451;467301;405332;70.8;61.4
63;2021-08-16;1273;4399;468574;409731;71.0;62.1
63;2021-08-17;1655;4051;470229;413782;71.2;62.7
63;2021-08-18;1490;3305;471719;417087;71.4;63.2
63;2021-08-19;1369;3443;473088;420530;71.7;63.7
63;2021-08-20;1453;3712;474541;424242;71.9;64.3
63;2021-08-21;676;2165;475217;426407;72.0;64.6
63;2021-08-22;212;1092;475429;427499;72.0;64.7
63;2021-08-23;1137;3591;476566;431090;72.2;65.3
63;2021-08-24;1092;2991;477658;434081;72.3;65.7
63;2021-08-25;1012;2787;478670;436868;72.5;66.2
63;2021-08-26;1191;2707;479861;439575;72.7;66.6
63;2021-08-27;1279;3164;481140;442739;72.9;67.1
63;2021-08-28;713;1709;481853;444448;73.0;67.3
63;2021-08-29;107;577;481960;445025;73.0;67.4
63;2021-08-30;800;2446;482760;447471;73.1;67.8
63;2021-08-31;1000;2567;483760;450038;73.3;68.2
63;2021-09-01;1003;2138;484763;452176;73.4;68.5
63;2021-09-02;927;2200;485690;454376;73.6;68.8
63;2021-09-03;926;2663;486616;457039;73.7;69.2
63;2021-09-04;710;1537;487326;458576;73.8;69.5
63;2021-09-05;80;273;487406;458849;73.8;69.5
63;2021-09-06;565;1609;487971;460458;73.9;69.7
63;2021-09-07;680;1737;488651;462195;74.0;70.0
63;2021-09-08;717;1790;489368;463985;74.1;70.3
63;2021-09-09;612;1652;489980;465637;74.2;70.5
63;2021-09-10;741;2127;490721;467764;74.3;70.8
63;2021-09-11;460;1121;491181;468885;74.4;71.0
63;2021-09-12;50;159;491231;469044;74.4;71.0
63;2021-09-13;466;1476;491697;470520;74.5;71.3
63;2021-09-14;531;1417;492228;471937;74.6;71.5
63;2021-09-15;584;1294;492812;473231;74.6;71.7
63;2021-09-16;477;918;493289;474149;74.7;71.8
63;2021-09-17;477;1318;493766;475467;74.8;72.0
63;2021-09-18;321;1030;494087;476497;74.8;72.2
63;2021-09-19;41;97;494128;476594;74.8;72.2
63;2021-09-20;366;719;494494;477313;74.9;72.3
63;2021-09-21;411;756;494905;478069;75.0;72.4
63;2021-09-22;400;1113;495305;479182;75.0;72.6
63;2021-09-23;302;766;495607;479948;75.1;72.7
63;2021-09-24;488;1270;496095;481218;75.1;72.9
63;2021-09-25;253;827;496348;482045;75.2;73.0
63;2021-09-26;26;100;496374;482145;75.2;73.0
63;2021-09-27;318;648;496692;482793;75.2;73.1
63;2021-09-28;294;689;496986;483482;75.3;73.2
63;2021-09-29;306;807;497292;484289;75.3;73.4
63;2021-09-30;295;757;497587;485046;75.4;73.5
63;2021-10-01;471;905;498058;485951;75.4;73.6
63;2021-10-02;266;553;498324;486504;75.5;73.7
63;2021-10-03;36;69;498360;486573;75.5;73.7
64;2020-12-27;1;0;1;0;0.0;0.0
64;2020-12-28;2;0;3;0;0.0;0.0
64;2020-12-29;0;0;3;0;0.0;0.0
64;2020-12-30;1;0;4;0;0.0;0.0
64;2020-12-31;0;0;4;0;0.0;0.0
64;2021-01-01;1;0;5;0;0.0;0.0
64;2021-01-02;0;0;5;0;0.0;0.0
64;2021-01-03;0;0;5;0;0.0;0.0
64;2021-01-04;29;0;34;0;0.0;0.0
64;2021-01-05;25;0;59;0;0.0;0.0
64;2021-01-06;189;0;248;0;0.0;0.0
64;2021-01-07;842;1;1090;1;0.2;0.0
64;2021-01-08;880;2;1970;3;0.3;0.0
64;2021-01-09;54;0;2024;3;0.3;0.0
64;2021-01-10;2;0;2026;3;0.3;0.0
64;2021-01-11;543;0;2569;3;0.4;0.0
64;2021-01-12;760;3;3329;6;0.5;0.0
64;2021-01-13;866;2;4195;8;0.6;0.0
64;2021-01-14;1046;3;5241;11;0.8;0.0
64;2021-01-15;929;3;6170;14;0.9;0.0
64;2021-01-16;70;0;6240;14;0.9;0.0
64;2021-01-17;5;0;6245;14;0.9;0.0
64;2021-01-18;942;5;7187;19;1.1;0.0
64;2021-01-19;1448;2;8635;21;1.3;0.0
64;2021-01-20;1616;3;10251;24;1.5;0.0
64;2021-01-21;2603;1;12854;25;1.9;0.0
64;2021-01-22;1652;3;14506;28;2.1;0.0
64;2021-01-23;525;1;15031;29;2.2;0.0
64;2021-01-24;89;0;15120;29;2.2;0.0
64;2021-01-25;974;7;16094;36;2.4;0.0
64;2021-01-26;1358;21;17452;57;2.6;0.0
64;2021-01-27;1243;115;18695;172;2.7;0.0
64;2021-01-28;1652;603;20347;775;3.0;0.1
64;2021-01-29;974;604;21321;1379;3.1;0.2
64;2021-01-30;469;54;21790;1433;3.2;0.2
64;2021-01-31;93;0;21883;1433;3.2;0.2
64;2021-02-01;675;287;22558;1720;3.3;0.3
64;2021-02-02;1134;523;23692;2243;3.5;0.3
64;2021-02-03;1044;603;24736;2846;3.6;0.4
64;2021-02-04;1027;510;25763;3356;3.8;0.5
64;2021-02-05;869;445;26632;3801;3.9;0.6
64;2021-02-06;501;31;27133;3832;4.0;0.6
64;2021-02-07;131;3;27264;3835;4.0;0.6
64;2021-02-08;769;276;28033;4111;4.1;0.6
64;2021-02-09;949;658;28982;4769;4.2;0.7
64;2021-02-10;916;709;29898;5478;4.4;0.8
64;2021-02-11;1199;1239;31097;6717;4.6;1.0
64;2021-02-12;1076;963;32173;7680;4.7;1.1
64;2021-02-13;225;213;32398;7893;4.7;1.2
64;2021-02-14;38;26;32436;7919;4.7;1.2
64;2021-02-15;223;856;32659;8775;4.8;1.3
64;2021-02-16;261;1136;32920;9911;4.8;1.5
64;2021-02-17;291;992;33211;10903;4.9;1.6
64;2021-02-18;508;1461;33719;12364;4.9;1.8
64;2021-02-19;413;1037;34132;13401;5.0;2.0
64;2021-02-20;119;317;34251;13718;5.0;2.0
64;2021-02-21;20;66;34271;13784;5.0;2.0
64;2021-02-22;479;773;34750;14557;5.1;2.1
64;2021-02-23;722;906;35472;15463;5.2;2.3
64;2021-02-24;731;821;36203;16284;5.3;2.4
64;2021-02-25;1094;772;37297;17056;5.5;2.5
64;2021-02-26;1217;742;38514;17798;5.6;2.6
64;2021-02-27;864;303;39378;18101;5.8;2.6
64;2021-02-28;42;58;39420;18159;5.8;2.7
64;2021-03-01;767;631;40187;18790;5.9;2.8
64;2021-03-02;1077;755;41264;19545;6.0;2.9
64;2021-03-03;1250;861;42514;20406;6.2;3.0
64;2021-03-04;1882;1065;44396;21471;6.5;3.1
64;2021-03-05;2199;923;46595;22394;6.8;3.3
64;2021-03-06;1543;457;48138;22851;7.0;3.3
64;2021-03-07;595;86;48733;22937;7.1;3.4
64;2021-03-08;1534;678;50267;23615;7.4;3.5
64;2021-03-09;2069;760;52336;24375;7.7;3.6
64;2021-03-10;2082;690;54418;25065;8.0;3.7
64;2021-03-11;2976;994;57394;26059;8.4;3.8
64;2021-03-12;3487;565;60881;26624;8.9;3.9
64;2021-03-13;2258;159;63139;26783;9.2;3.9
64;2021-03-14;233;15;63372;26798;9.3;3.9
64;2021-03-15;2337;226;65709;27024;9.6;4.0
64;2021-03-16;2001;259;67710;27283;9.9;4.0
64;2021-03-17;2072;236;69782;27519;10.2;4.0
64;2021-03-18;2463;203;72245;27722;10.6;4.1
64;2021-03-19;3014;277;75259;27999;11.0;4.1
64;2021-03-20;2469;93;77728;28092;11.4;4.1
64;2021-03-21;1282;27;79010;28119;11.6;4.1
64;2021-03-22;2588;540;81598;28659;11.9;4.2
64;2021-03-23;3197;644;84795;29303;12.4;4.3
64;2021-03-24;3564;696;88359;29999;12.9;4.4
64;2021-03-25;4350;792;92709;30791;13.6;4.5
64;2021-03-26;4429;696;97138;31487;14.2;4.6
64;2021-03-27;2974;429;100112;31916;14.7;4.7
64;2021-03-28;521;55;100633;31971;14.7;4.7
64;2021-03-29;3028;873;103661;32844;15.2;4.8
64;2021-03-30;4135;862;107796;33706;15.8;4.9
64;2021-03-31;3594;787;111390;34493;16.3;5.0
64;2021-04-01;4786;935;116176;35428;17.0;5.2
64;2021-04-02;4444;743;120620;36171;17.7;5.3
64;2021-04-03;2061;584;122681;36755;18.0;5.4
64;2021-04-04;309;48;122990;36803;18.0;5.4
64;2021-04-05;1689;144;124679;36947;18.3;5.4
64;2021-04-06;3647;1387;128326;38334;18.8;5.6
64;2021-04-07;3947;1508;132273;39842;19.4;5.8
64;2021-04-08;5192;1592;137465;41434;20.1;6.1
64;2021-04-09;5899;1636;143364;43070;21.0;6.3
64;2021-04-10;3222;1048;146586;44118;21.5;6.5
64;2021-04-11;448;250;147034;44368;21.5;6.5
64;2021-04-12;4047;1864;151081;46232;22.1;6.8
64;2021-04-13;4466;2158;155547;48390;22.8;7.1
64;2021-04-14;4088;2134;159635;50524;23.4;7.4
64;2021-04-15;4394;2292;164029;52816;24.0;7.7
64;2021-04-16;4300;2253;168329;55069;24.6;8.1
64;2021-04-17;2479;1498;170808;56567;25.0;8.3
64;2021-04-18;1096;1181;171904;57748;25.2;8.5
64;2021-04-19;2736;2440;174640;60188;25.6;8.8
64;2021-04-20;3208;2425;177848;62613;26.0;9.2
64;2021-04-21;3224;2559;181072;65172;26.5;9.5
64;2021-04-22;3389;2775;184461;67947;27.0;9.9
64;2021-04-23;3434;2613;187895;70560;27.5;10.3
64;2021-04-24;2068;1586;189963;72146;27.8;10.6
64;2021-04-25;290;235;190253;72381;27.8;10.6
64;2021-04-26;2661;2645;192914;75026;28.2;11.0
64;2021-04-27;3060;3127;195974;78153;28.7;11.4
64;2021-04-28;3604;3053;199578;81206;29.2;11.9
64;2021-04-29;4650;3454;204228;84660;29.9;12.4
64;2021-04-30;4085;3598;208313;88258;30.5;12.9
64;2021-05-01;1486;1030;209799;89288;30.7;13.1
64;2021-05-02;446;325;210245;89613;30.8;13.1
64;2021-05-03;2910;3520;213155;93133;31.2;13.6
64;2021-05-04;3646;3982;216801;97115;31.7;14.2
64;2021-05-05;3358;4007;220159;101122;32.2;14.8
64;2021-05-06;4110;3988;224269;105110;32.8;15.4
64;2021-05-07;3921;4185;228190;109295;33.4;16.0
64;2021-05-08;2623;1235;230813;110530;33.8;16.2
64;2021-05-09;722;305;231535;110835;33.9;16.2
64;2021-05-10;2862;4232;234397;115067;34.3;16.8
64;2021-05-11;4183;4140;238580;119207;34.9;17.4
64;2021-05-12;4489;3942;243069;123149;35.6;18.0
64;2021-05-13;3198;885;246267;124034;36.0;18.2
64;2021-05-14;5153;3150;251420;127184;36.8;18.6
64;2021-05-15;3525;1865;254945;129049;37.3;18.9
64;2021-05-16;498;225;255443;129274;37.4;18.9
64;2021-05-17;4190;2389;259633;131663;38.0;19.3
64;2021-05-18;5163;2298;264796;133961;38.8;19.6
64;2021-05-19;4979;2166;269775;136127;39.5;19.9
64;2021-05-20;5567;2158;275342;138285;40.3;20.2
64;2021-05-21;5268;2246;280610;140531;41.1;20.6
64;2021-05-22;3581;1508;284191;142039;41.6;20.8
64;2021-05-23;431;206;284622;142245;41.7;20.8
64;2021-05-24;2996;1232;287618;143477;42.1;21.0
64;2021-05-25;4332;2851;291950;146328;42.7;21.4
64;2021-05-26;4357;2713;296307;149041;43.4;21.8
64;2021-05-27;5283;3156;301590;152197;44.1;22.3
64;2021-05-28;4619;3432;306209;155629;44.8;22.8
64;2021-05-29;2810;2112;309019;157741;45.2;23.1
64;2021-05-30;439;203;309458;157944;45.3;23.1
64;2021-05-31;3889;3659;313347;161603;45.9;23.7
64;2021-06-01;5333;3565;318680;165168;46.6;24.2
64;2021-06-02;4931;3174;323611;168342;47.4;24.6
64;2021-06-03;6365;3254;329976;171596;48.3;25.1
64;2021-06-04;5149;4551;335125;176147;49.1;25.8
64;2021-06-05;3482;2520;338607;178667;49.6;26.2
64;2021-06-06;2014;328;340621;178995;49.9;26.2
64;2021-06-07;4128;4332;344749;183327;50.5;26.8
64;2021-06-08;5151;4118;349900;187445;51.2;27.4
64;2021-06-09;5150;3656;355050;191101;52.0;28.0
64;2021-06-10;6180;3144;361230;194245;52.9;28.4
64;2021-06-11;5584;4874;366814;199119;53.7;29.1
64;2021-06-12;3949;2332;370763;201451;54.3;29.5
64;2021-06-13;1555;392;372318;201843;54.5;29.5
64;2021-06-14;3669;4792;375987;206635;55.0;30.2
64;2021-06-15;4570;4708;380557;211343;55.7;30.9
64;2021-06-16;4470;4664;385027;216007;56.4;31.6
64;2021-06-17;3641;4306;388668;220313;56.9;32.2
64;2021-06-18;4421;5167;393089;225480;57.5;33.0
64;2021-06-19;2984;3279;396073;228759;58.0;33.5
64;2021-06-20;881;539;396954;229298;58.1;33.6
64;2021-06-21;2314;5125;399268;234423;58.4;34.3
64;2021-06-22;2555;5726;401823;240149;58.8;35.2
64;2021-06-23;3104;5480;404927;245629;59.3;36.0
64;2021-06-24;2719;3810;407646;249439;59.7;36.5
64;2021-06-25;2900;6436;410546;255875;60.1;37.5
64;2021-06-26;1798;3835;412344;259710;60.4;38.0
64;2021-06-27;493;713;412837;260423;60.4;38.1
64;2021-06-28;1935;6070;414772;266493;60.7;39.0
64;2021-06-29;1967;6265;416739;272758;61.0;39.9
64;2021-06-30;2255;6000;418994;278758;61.3;40.8
64;2021-07-01;2407;5341;421401;284099;61.7;41.6
64;2021-07-02;2306;6403;423707;290502;62.0;42.5
64;2021-07-03;1263;3782;424970;294284;62.2;43.1
64;2021-07-04;411;847;425381;295131;62.3;43.2
64;2021-07-05;1376;5403;426757;300534;62.5;44.0
64;2021-07-06;1994;6151;428751;306685;62.8;44.9
64;2021-07-07;2063;5751;430814;312436;63.1;45.7
64;2021-07-08;1803;4397;432617;316833;63.3;46.4
64;2021-07-09;1825;6536;434442;323369;63.6;47.3
64;2021-07-10;1171;3879;435613;327248;63.8;47.9
64;2021-07-11;253;860;435866;328108;63.8;48.0
64;2021-07-12;1500;6086;437366;334194;64.0;48.9
64;2021-07-13;2366;7247;439732;341441;64.4;50.0
64;2021-07-14;2368;3405;442100;344846;64.7;50.5
64;2021-07-15;2104;5480;444204;350326;65.0;51.3
64;2021-07-16;2848;6770;447052;357096;65.4;52.3
64;2021-07-17;2338;4585;449390;361681;65.8;52.9
64;2021-07-18;716;2051;450106;363732;65.9;53.2
64;2021-07-19;2348;6121;452454;369853;66.2;54.1
64;2021-07-20;3129;6560;455583;376413;66.7;55.1
64;2021-07-21;3345;6044;458928;382457;67.2;56.0
64;2021-07-22;3809;5716;462737;388173;67.7;56.8
64;2021-07-23;3725;5618;466462;393791;68.3;57.6
64;2021-07-24;2553;4428;469015;398219;68.7;58.3
64;2021-07-25;753;1062;469768;399281;68.8;58.4
64;2021-07-26;3086;5131;472854;404412;69.2;59.2
64;2021-07-27;4261;5144;477115;409556;69.8;59.9
64;2021-07-28;4315;4597;481430;414153;70.5;60.6
64;2021-07-29;5518;3904;486948;418057;71.3;61.2
64;2021-07-30;5146;4227;492094;422284;72.0;61.8
64;2021-07-31;3171;3346;495265;425630;72.5;62.3
64;2021-08-01;1145;589;496410;426219;72.7;62.4
64;2021-08-02;4369;2631;500779;428850;73.3;62.8
64;2021-08-03;4556;3176;505335;432026;74.0;63.2
64;2021-08-04;4132;2999;509467;435025;74.6;63.7
64;2021-08-05;4036;2612;513503;437637;75.2;64.1
64;2021-08-06;3843;3334;517346;440971;75.7;64.5
64;2021-08-07;2481;2701;519827;443672;76.1;64.9
64;2021-08-08;492;609;520319;444281;76.2;65.0
64;2021-08-09;2739;3201;523058;447482;76.6;65.5
64;2021-08-10;3352;3436;526410;450918;77.1;66.0
64;2021-08-11;3067;3264;529477;454182;77.5;66.5
64;2021-08-12;3189;3307;532666;457489;78.0;67.0
64;2021-08-13;2575;3660;535241;461149;78.3;67.5
64;2021-08-14;1632;2683;536873;463832;78.6;67.9
64;2021-08-15;207;691;537080;464523;78.6;68.0
64;2021-08-16;2102;3236;539182;467759;78.9;68.5
64;2021-08-17;2299;3709;541481;471468;79.3;69.0
64;2021-08-18;2044;3520;543525;474988;79.6;69.5
64;2021-08-19;1938;3525;545463;478513;79.8;70.0
64;2021-08-20;1578;3975;547041;482488;80.1;70.6
64;2021-08-21;975;2882;548016;485370;80.2;71.0
64;2021-08-22;160;895;548176;486265;80.2;71.2
64;2021-08-23;1268;3238;549444;489503;80.4;71.7
64;2021-08-24;1378;4596;550822;494099;80.6;72.3
64;2021-08-25;1260;3747;552082;497846;80.8;72.9
64;2021-08-26;1111;3532;553193;501378;81.0;73.4
64;2021-08-27;1188;4229;554381;505607;81.1;74.0
64;2021-08-28;734;2496;555115;508103;81.3;74.4
64;2021-08-29;90;533;555205;508636;81.3;74.5
64;2021-08-30;989;3615;556194;512251;81.4;75.0
64;2021-08-31;990;3973;557184;516224;81.6;75.6
64;2021-09-01;924;3196;558108;519420;81.7;76.0
64;2021-09-02;897;3260;559005;522680;81.8;76.5
64;2021-09-03;872;3202;559877;525882;82.0;77.0
64;2021-09-04;697;2245;560574;528127;82.1;77.3
64;2021-09-05;74;267;560648;528394;82.1;77.3
64;2021-09-06;532;2582;561180;530976;82.1;77.7
64;2021-09-07;710;2337;561890;533313;82.2;78.1
64;2021-09-08;734;2832;562624;536145;82.4;78.5
64;2021-09-09;475;2166;563099;538311;82.4;78.8
64;2021-09-10;743;2473;563842;540784;82.5;79.2
64;2021-09-11;591;2135;564433;542919;82.6;79.5
64;2021-09-12;60;211;564493;543130;82.6;79.5
64;2021-09-13;439;1916;564932;545046;82.7;79.8
64;2021-09-14;487;1927;565419;546973;82.8;80.1
64;2021-09-15;688;1747;566107;548720;82.9;80.3
64;2021-09-16;484;843;566591;549563;82.9;80.4
64;2021-09-17;564;1354;567155;550917;83.0;80.6
64;2021-09-18;331;1257;567486;552174;83.1;80.8
64;2021-09-19;18;42;567504;552216;83.1;80.8
64;2021-09-20;248;480;567752;552696;83.1;80.9
64;2021-09-21;430;951;568182;553647;83.2;81.0
64;2021-09-22;380;1426;568562;555073;83.2;81.2
64;2021-09-23;278;730;568840;555803;83.3;81.4
64;2021-09-24;398;986;569238;556789;83.3;81.5
64;2021-09-25;298;1033;569536;557822;83.4;81.7
64;2021-09-26;0;4;569536;557826;83.4;81.7
64;2021-09-27;234;565;569770;558391;83.4;81.7
64;2021-09-28;261;671;570031;559062;83.4;81.8
64;2021-09-29;341;983;570372;560045;83.5;82.0
64;2021-09-30;257;441;570629;560486;83.5;82.0
64;2021-10-01;305;726;570934;561212;83.6;82.1
64;2021-10-02;218;565;571152;561777;83.6;82.2
64;2021-10-03;0;2;571152;561779;83.6;82.2
65;2020-12-27;0;0;0;0;0.0;0.0
65;2020-12-28;1;0;1;0;0.0;0.0
65;2020-12-29;0;0;1;0;0.0;0.0
65;2020-12-30;0;0;1;0;0.0;0.0
65;2020-12-31;0;0;1;0;0.0;0.0
65;2021-01-01;1;0;2;0;0.0;0.0
65;2021-01-02;0;0;2;0;0.0;0.0
65;2021-01-03;0;0;2;0;0.0;0.0
65;2021-01-04;0;0;2;0;0.0;0.0
65;2021-01-05;1;0;3;0;0.0;0.0
65;2021-01-06;3;0;6;0;0.0;0.0
65;2021-01-07;168;0;174;0;0.1;0.0
65;2021-01-08;253;1;427;1;0.2;0.0
65;2021-01-09;177;1;604;2;0.3;0.0
65;2021-01-10;1;0;605;2;0.3;0.0
65;2021-01-11;275;3;880;5;0.4;0.0
65;2021-01-12;271;1;1151;6;0.5;0.0
65;2021-01-13;587;1;1738;7;0.8;0.0
65;2021-01-14;580;5;2318;12;1.0;0.0
65;2021-01-15;527;2;2845;14;1.3;0.0
65;2021-01-16;221;2;3066;16;1.4;0.0
65;2021-01-17;0;0;3066;16;1.4;0.0
65;2021-01-18;554;4;3620;20;1.6;0.0
65;2021-01-19;571;2;4191;22;1.8;0.0
65;2021-01-20;585;5;4776;27;2.1;0.0
65;2021-01-21;585;0;5361;27;2.4;0.0
65;2021-01-22;598;0;5959;27;2.6;0.0
65;2021-01-23;174;1;6133;28;2.7;0.0
65;2021-01-24;3;1;6136;29;2.7;0.0
65;2021-01-25;551;4;6687;33;2.9;0.0
65;2021-01-26;883;2;7570;35;3.3;0.0
65;2021-01-27;592;10;8162;45;3.6;0.0
65;2021-01-28;509;70;8671;115;3.8;0.1
65;2021-01-29;426;135;9097;250;4.0;0.1
65;2021-01-30;182;42;9279;292;4.1;0.1
65;2021-01-31;15;0;9294;292;4.1;0.1
65;2021-02-01;350;78;9644;370;4.3;0.2
65;2021-02-02;432;146;10076;516;4.4;0.2
65;2021-02-03;463;207;10539;723;4.6;0.3
65;2021-02-04;310;267;10849;990;4.8;0.4
65;2021-02-05;284;311;11133;1301;4.9;0.6
65;2021-02-06;99;72;11232;1373;5.0;0.6
65;2021-02-07;10;0;11242;1373;5.0;0.6
65;2021-02-08;426;184;11668;1557;5.1;0.7
65;2021-02-09;272;308;11940;1865;5.3;0.8
65;2021-02-10;298;202;12238;2067;5.4;0.9
65;2021-02-11;320;226;12558;2293;5.5;1.0
65;2021-02-12;277;175;12835;2468;5.7;1.1
65;2021-02-13;125;78;12960;2546;5.7;1.1
65;2021-02-14;3;15;12963;2561;5.7;1.1
65;2021-02-15;203;314;13166;2875;5.8;1.3
65;2021-02-16;488;449;13654;3324;6.0;1.5
65;2021-02-17;231;405;13885;3729;6.1;1.6
65;2021-02-18;284;467;14169;4196;6.2;1.8
65;2021-02-19;156;365;14325;4561;6.3;2.0
65;2021-02-20;53;140;14378;4701;6.3;2.1
65;2021-02-21;3;48;14381;4749;6.3;2.1
65;2021-02-22;166;437;14547;5186;6.4;2.3
65;2021-02-23;249;426;14796;5612;6.5;2.5
65;2021-02-24;231;536;15027;6148;6.6;2.7
65;2021-02-25;215;157;15242;6305;6.7;2.8
65;2021-02-26;349;636;15591;6941;6.9;3.1
65;2021-02-27;109;166;15700;7107;6.9;3.1
65;2021-02-28;1;0;15701;7107;6.9;3.1
65;2021-03-01;379;316;16080;7423;7.1;3.3
65;2021-03-02;455;281;16535;7704;7.3;3.4
65;2021-03-03;381;334;16916;8038;7.5;3.5
65;2021-03-04;696;286;17612;8324;7.8;3.7
65;2021-03-05;679;261;18291;8585;8.1;3.8
65;2021-03-06;1187;78;19478;8663;8.6;3.8
65;2021-03-07;257;12;19735;8675;8.7;3.8
65;2021-03-08;412;315;20147;8990;8.9;4.0
65;2021-03-09;670;309;20817;9299;9.2;4.1
65;2021-03-10;624;347;21441;9646;9.5;4.3
65;2021-03-11;778;337;22219;9983;9.8;4.4
65;2021-03-12;1060;184;23279;10167;10.3;4.5
65;2021-03-13;356;88;23635;10255;10.4;4.5
65;2021-03-14;3;30;23638;10285;10.4;4.5
65;2021-03-15;816;182;24454;10467;10.8;4.6
65;2021-03-16;694;212;25148;10679;11.1;4.7
65;2021-03-17;712;201;25860;10880;11.4;4.8
65;2021-03-18;537;228;26397;11108;11.6;4.9
65;2021-03-19;878;158;27275;11266;12.0;5.0
65;2021-03-20;245;42;27520;11308;12.1;5.0
65;2021-03-21;12;2;27532;11310;12.1;5.0
65;2021-03-22;734;147;28266;11457;12.5;5.1
65;2021-03-23;838;359;29104;11816;12.8;5.2
65;2021-03-24;868;248;29972;12064;13.2;5.3
65;2021-03-25;1253;188;31225;12252;13.8;5.4
65;2021-03-26;1225;141;32450;12393;14.3;5.5
65;2021-03-27;1357;92;33807;12485;14.9;5.5
65;2021-03-28;1;1;33808;12486;14.9;5.5
65;2021-03-29;1490;357;35298;12843;15.6;5.7
65;2021-03-30;1357;405;36655;13248;16.2;5.8
65;2021-03-31;1208;366;37863;13614;16.7;6.0
65;2021-04-01;1509;393;39372;14007;17.4;6.2
65;2021-04-02;1685;286;41057;14293;18.1;6.3
65;2021-04-03;247;45;41304;14338;18.2;6.3
65;2021-04-04;4;2;41308;14340;18.2;6.3
65;2021-04-05;158;44;41466;14384;18.3;6.3
65;2021-04-06;1294;493;42760;14877;18.9;6.6
65;2021-04-07;1958;456;44718;15333;19.7;6.8
65;2021-04-08;1643;415;46361;15748;20.4;6.9
65;2021-04-09;1642;471;48003;16219;21.2;7.2
65;2021-04-10;1591;150;49594;16369;21.9;7.2
65;2021-04-11;3;0;49597;16369;21.9;7.2
65;2021-04-12;1351;732;50948;17101;22.5;7.5
65;2021-04-13;1584;589;52532;17690;23.2;7.8
65;2021-04-14;1905;744;54437;18434;24.0;8.1
65;2021-04-15;1701;669;56138;19103;24.7;8.4
65;2021-04-16;1824;527;57962;19630;25.6;8.7
65;2021-04-17;2156;131;60118;19761;26.5;8.7
65;2021-04-18;7;27;60125;19788;26.5;8.7
65;2021-04-19;1337;767;61462;20555;27.1;9.1
65;2021-04-20;1530;706;62992;21261;27.8;9.4
65;2021-04-21;1052;1041;64044;22302;28.2;9.8
65;2021-04-22;1647;725;65691;23027;29.0;10.2
65;2021-04-23;1160;1146;66851;24173;29.5;10.7
65;2021-04-24;1265;610;68116;24783;30.0;10.9
65;2021-04-25;31;15;68147;24798;30.0;10.9
65;2021-04-26;1610;1289;69757;26087;30.8;11.5
65;2021-04-27;1423;1336;71180;27423;31.4;12.1
65;2021-04-28;1731;1021;72911;28444;32.1;12.5
65;2021-04-29;1959;1032;74870;29476;33.0;13.0
65;2021-04-30;1782;922;76652;30398;33.8;13.4
65;2021-05-01;1574;230;78226;30628;34.5;13.5
65;2021-05-02;671;25;78897;30653;34.8;13.5
65;2021-05-03;1280;1618;80177;32271;35.3;14.2
65;2021-05-04;1535;1240;81712;33511;36.0;14.8
65;2021-05-05;1374;1640;83086;35151;36.6;15.5
65;2021-05-06;1558;1171;84644;36322;37.3;16.0
65;2021-05-07;1275;1566;85919;37888;37.9;16.7
65;2021-05-08;1647;442;87566;38330;38.6;16.9
65;2021-05-09;0;87;87566;38417;38.6;16.9
65;2021-05-10;954;1883;88520;40300;39.0;17.8
65;2021-05-11;1061;1808;89581;42108;39.5;18.6
65;2021-05-12;1235;1636;90816;43744;40.0;19.3
65;2021-05-13;1345;171;92161;43915;40.6;19.4
65;2021-05-14;1575;1094;93736;45009;41.3;19.8
65;2021-05-15;1402;509;95138;45518;41.9;20.1
65;2021-05-16;1444;69;96582;45587;42.6;20.1
65;2021-05-17;1036;1614;97618;47201;43.0;20.8
65;2021-05-18;1612;1207;99230;48408;43.7;21.3
65;2021-05-19;1684;1010;100914;49418;44.5;21.8
65;2021-05-20;1845;1054;102759;50472;45.3;22.3
65;2021-05-21;1791;1230;104550;51702;46.1;22.8
65;2021-05-22;1287;638;105837;52340;46.7;23.1
65;2021-05-23;689;32;106526;52372;47.0;23.1
65;2021-05-24;703;77;107229;52449;47.3;23.1
65;2021-05-25;1359;1547;108588;53996;47.9;23.8
65;2021-05-26;1471;1352;110059;55348;48.5;24.4
65;2021-05-27;1622;1461;111681;56809;49.2;25.0
65;2021-05-28;1598;1671;113279;58480;49.9;25.8
65;2021-05-29;1188;1515;114467;59995;50.5;26.4
65;2021-05-30;7;10;114474;60005;50.5;26.5
65;2021-05-31;1323;1297;115797;61302;51.0;27.0
65;2021-06-01;1832;938;117629;62240;51.9;27.4
65;2021-06-02;1574;950;119203;63190;52.5;27.9
65;2021-06-03;1343;1105;120546;64295;53.1;28.3
65;2021-06-04;1790;1559;122336;65854;53.9;29.0
65;2021-06-05;432;1240;122768;67094;54.1;29.6
65;2021-06-06;3;13;122771;67107;54.1;29.6
65;2021-06-07;675;1984;123446;69091;54.4;30.5
65;2021-06-08;956;1533;124402;70624;54.8;31.1
65;2021-06-09;827;1546;125229;72170;55.2;31.8
65;2021-06-10;739;1153;125968;73323;55.5;32.3
65;2021-06-11;909;1801;126877;75124;55.9;33.1
65;2021-06-12;150;640;127027;75764;56.0;33.4
65;2021-06-13;5;7;127032;75771;56.0;33.4
65;2021-06-14;501;2421;127533;78192;56.2;34.5
65;2021-06-15;942;1801;128475;79993;56.6;35.3
65;2021-06-16;1063;1365;129538;81358;57.1;35.9
65;2021-06-17;814;1046;130352;82404;57.5;36.3
65;2021-06-18;1019;1633;131371;84037;57.9;37.0
65;2021-06-19;690;1689;132061;85726;58.2;37.8
65;2021-06-20;2;2;132063;85728;58.2;37.8
65;2021-06-21;735;1940;132798;87668;58.5;38.6
65;2021-06-22;1045;1479;133843;89147;59.0;39.3
65;2021-06-23;1063;1234;134906;90381;59.5;39.8
65;2021-06-24;960;1143;135866;91524;59.9;40.3
65;2021-06-25;831;1967;136697;93491;60.3;41.2
65;2021-06-26;168;1658;136865;95149;60.3;41.9
65;2021-06-27;15;1100;136880;96249;60.3;42.4
65;2021-06-28;444;2301;137324;98550;60.5;43.4
65;2021-06-29;683;1921;138007;100471;60.8;44.3
65;2021-06-30;933;1678;138940;102149;61.3;45.0
65;2021-07-01;605;750;139545;102899;61.5;45.4
65;2021-07-02;1166;1732;140711;104631;62.0;46.1
65;2021-07-03;197;1915;140908;106546;62.1;47.0
65;2021-07-04;416;186;141324;106732;62.3;47.1
65;2021-07-05;641;1992;141965;108724;62.6;47.9
65;2021-07-06;897;2127;142862;110851;63.0;48.9
65;2021-07-07;976;1516;143838;112367;63.4;49.5
65;2021-07-08;328;664;144166;113031;63.6;49.8
65;2021-07-09;550;1592;144716;114623;63.8;50.5
65;2021-07-10;303;956;145019;115579;63.9;51.0
65;2021-07-11;0;0;145019;115579;63.9;51.0
65;2021-07-12;480;2220;145499;117799;64.1;51.9
65;2021-07-13;700;2148;146199;119947;64.5;52.9
65;2021-07-14;214;52;146413;119999;64.5;52.9
65;2021-07-15;1095;1662;147508;121661;65.0;53.6
65;2021-07-16;1186;1885;148694;123546;65.6;54.5
65;2021-07-17;431;541;149125;124087;65.7;54.7
65;2021-07-18;22;11;149147;124098;65.8;54.7
65;2021-07-19;635;1494;149782;125592;66.0;55.4
65;2021-07-20;1447;1703;151229;127295;66.7;56.1
65;2021-07-21;1419;1662;152648;128957;67.3;56.8
65;2021-07-22;2197;1289;154845;130246;68.3;57.4
65;2021-07-23;1623;1789;156468;132035;69.0;58.2
65;2021-07-24;1042;649;157510;132684;69.4;58.5
65;2021-07-25;24;21;157534;132705;69.4;58.5
65;2021-07-26;1142;1246;158676;133951;70.0;59.1
65;2021-07-27;1792;1954;160468;135905;70.7;59.9
65;2021-07-28;1603;1321;162071;137226;71.4;60.5
65;2021-07-29;2898;1136;164969;138362;72.7;61.0
65;2021-07-30;2449;1398;167418;139760;73.8;61.6
65;2021-07-31;2305;355;169723;140115;74.8;61.8
65;2021-08-01;14;16;169737;140131;74.8;61.8
65;2021-08-02;994;835;170731;140966;75.3;62.1
65;2021-08-03;2103;1070;172834;142036;76.2;62.6
65;2021-08-04;1802;642;174636;142678;77.0;62.9
65;2021-08-05;1820;833;176456;143511;77.8;63.3
65;2021-08-06;1666;971;178122;144482;78.5;63.7
65;2021-08-07;730;487;178852;144969;78.8;63.9
65;2021-08-08;2;9;178854;144978;78.8;63.9
65;2021-08-09;705;944;179559;145922;79.2;64.3
65;2021-08-10;1193;1544;180752;147466;79.7;65.0
65;2021-08-11;731;1264;181483;148730;80.0;65.6
65;2021-08-12;776;1084;182259;149814;80.3;66.0
65;2021-08-13;427;1010;182686;150824;80.5;66.5
65;2021-08-14;602;567;183288;151391;80.8;66.7
65;2021-08-15;8;19;183296;151410;80.8;66.7
65;2021-08-16;403;1537;183699;152947;81.0;67.4
65;2021-08-17;739;2177;184438;155124;81.3;68.4
65;2021-08-18;604;1545;185042;156669;81.6;69.1
65;2021-08-19;731;1316;185773;157985;81.9;69.6
65;2021-08-20;459;1336;186232;159321;82.1;70.2
65;2021-08-21;44;105;186276;159426;82.1;70.3
65;2021-08-22;11;13;186287;159439;82.1;70.3
65;2021-08-23;273;1681;186560;161120;82.2;71.0
65;2021-08-24;550;2445;187110;163565;82.5;72.1
65;2021-08-25;417;1959;187527;165524;82.7;73.0
65;2021-08-26;465;2307;187992;167831;82.9;74.0
65;2021-08-27;447;1947;188439;169778;83.1;74.8
65;2021-08-28;163;195;188602;169973;83.1;74.9
65;2021-08-29;9;18;188611;169991;83.1;74.9
65;2021-08-30;260;1056;188871;171047;83.3;75.4
65;2021-08-31;468;1588;189339;172635;83.5;76.1
65;2021-09-01;459;1161;189798;173796;83.7;76.6
65;2021-09-02;371;1009;190169;174805;83.8;77.1
65;2021-09-03;452;1245;190621;176050;84.0;77.6
65;2021-09-04;166;909;190787;176959;84.1;78.0
65;2021-09-05;18;35;190805;176994;84.1;78.0
65;2021-09-06;278;794;191083;177788;84.2;78.4
65;2021-09-07;322;1194;191405;178982;84.4;78.9
65;2021-09-08;351;1038;191756;180020;84.5;79.4
65;2021-09-09;259;785;192015;180805;84.6;79.7
65;2021-09-10;379;925;192394;181730;84.8;80.1
65;2021-09-11;54;167;192448;181897;84.8;80.2
65;2021-09-12;1;2;192449;181899;84.8;80.2
65;2021-09-13;201;490;192650;182389;84.9;80.4
65;2021-09-14;186;593;192836;182982;85.0;80.7
65;2021-09-15;249;638;193085;183620;85.1;80.9
65;2021-09-16;139;213;193224;183833;85.2;81.0
65;2021-09-17;275;524;193499;184357;85.3;81.3
65;2021-09-18;98;269;193597;184626;85.3;81.4
65;2021-09-19;2;13;193599;184639;85.3;81.4
65;2021-09-20;109;234;193708;184873;85.4;81.5
65;2021-09-21;110;258;193818;185131;85.4;81.6
65;2021-09-22;153;680;193971;185811;85.5;81.9
65;2021-09-23;65;158;194036;185969;85.5;82.0
65;2021-09-24;170;556;194206;186525;85.6;82.2
65;2021-09-25;73;218;194279;186743;85.6;82.3
65;2021-09-26;3;0;194282;186743;85.6;82.3
65;2021-09-27;62;263;194344;187006;85.7;82.4
65;2021-09-28;83;279;194427;187285;85.7;82.6
65;2021-09-29;130;418;194557;187703;85.8;82.7
65;2021-09-30;44;123;194601;187826;85.8;82.8
65;2021-10-01;165;399;194766;188225;85.9;83.0
65;2021-10-02;19;66;194785;188291;85.9;83.0
65;2021-10-03;0;7;194785;188298;85.9;83.0
66;2020-12-27;0;0;0;0;0.0;0.0
66;2020-12-28;2;0;2;0;0.0;0.0
66;2020-12-29;0;0;2;0;0.0;0.0
66;2020-12-30;0;0;2;0;0.0;0.0
66;2020-12-31;1;0;3;0;0.0;0.0
66;2021-01-01;3;0;6;0;0.0;0.0
66;2021-01-02;0;0;6;0;0.0;0.0
66;2021-01-03;0;0;6;0;0.0;0.0
66;2021-01-04;30;0;36;0;0.0;0.0
66;2021-01-05;135;0;171;0;0.0;0.0
66;2021-01-06;194;0;365;0;0.1;0.0
66;2021-01-07;182;0;547;0;0.1;0.0
66;2021-01-08;212;0;759;0;0.2;0.0
66;2021-01-09;233;0;992;0;0.2;0.0
66;2021-01-10;11;0;1003;0;0.2;0.0
66;2021-01-11;404;2;1407;2;0.3;0.0
66;2021-01-12;588;2;1995;4;0.4;0.0
66;2021-01-13;877;7;2872;11;0.6;0.0
66;2021-01-14;892;11;3764;22;0.8;0.0
66;2021-01-15;588;1;4352;23;0.9;0.0
66;2021-01-16;106;3;4458;26;0.9;0.0
66;2021-01-17;46;1;4504;27;0.9;0.0
66;2021-01-18;654;3;5158;30;1.1;0.0
66;2021-01-19;720;3;5878;33;1.2;0.0
66;2021-01-20;1169;3;7047;36;1.5;0.0
66;2021-01-21;2401;5;9448;41;2.0;0.0
66;2021-01-22;1438;6;10886;47;2.3;0.0
66;2021-01-23;399;4;11285;51;2.4;0.0
66;2021-01-24;225;9;11510;60;2.4;0.0
66;2021-01-25;739;31;12249;91;2.6;0.0
66;2021-01-26;787;56;13036;147;2.7;0.0
66;2021-01-27;867;75;13903;222;2.9;0.0
66;2021-01-28;878;116;14781;338;3.1;0.1
66;2021-01-29;819;110;15600;448;3.3;0.1
66;2021-01-30;481;50;16081;498;3.4;0.1
66;2021-01-31;202;17;16283;515;3.4;0.1
66;2021-02-01;562;151;16845;666;3.5;0.1
66;2021-02-02;622;266;17467;932;3.6;0.2
66;2021-02-03;734;545;18201;1477;3.8;0.3
66;2021-02-04;688;508;18889;1985;3.9;0.4
66;2021-02-05;778;369;19667;2354;4.1;0.5
66;2021-02-06;420;129;20087;2483;4.2;0.5
66;2021-02-07;170;124;20257;2607;4.2;0.5
66;2021-02-08;502;296;20759;2903;4.3;0.6
66;2021-02-09;533;295;21292;3198;4.4;0.7
66;2021-02-10;620;614;21912;3812;4.6;0.8
66;2021-02-11;1104;1384;23016;5196;4.8;1.1
66;2021-02-12;1122;1061;24138;6257;5.0;1.3
66;2021-02-13;366;221;24504;6478;5.1;1.4
66;2021-02-14;111;154;24615;6632;5.1;1.4
66;2021-02-15;425;519;25040;7151;5.2;1.5
66;2021-02-16;304;578;25344;7729;5.3;1.6
66;2021-02-17;377;558;25721;8287;5.4;1.7
66;2021-02-18;366;620;26087;8907;5.4;1.9
66;2021-02-19;400;574;26487;9481;5.5;2.0
66;2021-02-20;184;317;26671;9798;5.6;2.0
66;2021-02-21;41;123;26712;9921;5.6;2.1
66;2021-02-22;415;479;27127;10400;5.7;2.2
66;2021-02-23;509;501;27636;10901;5.8;2.3
66;2021-02-24;347;575;27983;11476;5.8;2.4
66;2021-02-25;717;537;28700;12013;6.0;2.5
66;2021-02-26;953;599;29653;12612;6.2;2.6
66;2021-02-27;363;321;30016;12933;6.3;2.7
66;2021-02-28;59;105;30075;13038;6.3;2.7
66;2021-03-01;378;512;30453;13550;6.4;2.8
66;2021-03-02;335;537;30788;14087;6.4;2.9
66;2021-03-03;530;515;31318;14602;6.5;3.0
66;2021-03-04;991;913;32309;15515;6.7;3.2
66;2021-03-05;1528;697;33837;16212;7.1;3.4
66;2021-03-06;1147;303;34984;16515;7.3;3.4
66;2021-03-07;1098;77;36082;16592;7.5;3.5
66;2021-03-08;696;471;36778;17063;7.7;3.6
66;2021-03-09;1228;526;38006;17589;7.9;3.7
66;2021-03-10;1302;445;39308;18034;8.2;3.8
66;2021-03-11;1474;539;40782;18573;8.5;3.9
66;2021-03-12;2396;543;43178;19116;9.0;4.0
66;2021-03-13;1081;287;44259;19403;9.2;4.1
66;2021-03-14;192;78;44451;19481;9.3;4.1
66;2021-03-15;1109;383;45560;19864;9.5;4.1
66;2021-03-16;953;253;46513;20117;9.7;4.2
66;2021-03-17;866;383;47379;20500;9.9;4.3
66;2021-03-18;969;338;48348;20838;10.1;4.4
66;2021-03-19;1293;314;49641;21152;10.4;4.4
66;2021-03-20;837;121;50478;21273;10.5;4.4
66;2021-03-21;186;43;50664;21316;10.6;4.5
66;2021-03-22;1115;379;51779;21695;10.8;4.5
66;2021-03-23;1757;389;53536;22084;11.2;4.6
66;2021-03-24;1797;511;55333;22595;11.6;4.7
66;2021-03-25;2537;461;57870;23056;12.1;4.8
66;2021-03-26;2577;363;60447;23419;12.6;4.9
66;2021-03-27;1211;292;61658;23711;12.9;5.0
66;2021-03-28;321;3;61979;23714;12.9;5.0
66;2021-03-29;1831;253;63810;23967;13.3;5.0
66;2021-03-30;2241;172;66051;24139;13.8;5.0
66;2021-03-31;1987;250;68038;24389;14.2;5.1
66;2021-04-01;2674;301;70712;24690;14.8;5.2
66;2021-04-02;2421;258;73133;24948;15.3;5.2
66;2021-04-03;1148;331;74281;25279;15.5;5.3
66;2021-04-04;107;124;74388;25403;15.5;5.3
66;2021-04-05;197;140;74585;25543;15.6;5.3
66;2021-04-06;1334;647;75919;26190;15.8;5.5
66;2021-04-07;1399;597;77318;26787;16.1;5.6
66;2021-04-08;2070;548;79388;27335;16.6;5.7
66;2021-04-09;3507;662;82895;27997;17.3;5.8
66;2021-04-10;2308;524;85203;28521;17.8;6.0
66;2021-04-11;1201;169;86404;28690;18.0;6.0
66;2021-04-12;2703;1021;89107;29711;18.6;6.2
66;2021-04-13;3609;1055;92716;30766;19.4;6.4
66;2021-04-14;3292;921;96008;31687;20.0;6.6
66;2021-04-15;3557;1048;99565;32735;20.8;6.8
66;2021-04-16;3592;1034;103157;33769;21.5;7.0
66;2021-04-17;2263;592;105420;34361;22.0;7.2
66;2021-04-18;1445;132;106865;34493;22.3;7.2
66;2021-04-19;2256;1120;109121;35613;22.8;7.4
66;2021-04-20;2373;1075;111494;36688;23.3;7.7
66;2021-04-21;2871;1175;114365;37863;23.9;7.9
66;2021-04-22;2662;1232;117027;39095;24.4;8.2
66;2021-04-23;2380;1234;119407;40329;24.9;8.4
66;2021-04-24;2743;882;122150;41211;25.5;8.6
66;2021-04-25;1206;266;123356;41477;25.8;8.7
66;2021-04-26;1998;1251;125354;42728;26.2;8.9
66;2021-04-27;2748;1302;128102;44030;26.7;9.2
66;2021-04-28;2420;1654;130522;45684;27.2;9.5
66;2021-04-29;2704;2126;133226;47810;27.8;10.0
66;2021-04-30;3053;1551;136279;49361;28.5;10.3
66;2021-05-01;2000;470;138279;49831;28.9;10.4
66;2021-05-02;1529;264;139808;50095;29.2;10.5
66;2021-05-03;2940;1109;142748;51204;29.8;10.7
66;2021-05-04;3169;1339;145917;52543;30.5;11.0
66;2021-05-05;3055;1548;148972;54091;31.1;11.3
66;2021-05-06;3755;2084;152727;56175;31.9;11.7
66;2021-05-07;2968;3064;155695;59239;32.5;12.4
66;2021-05-08;1730;1169;157425;60408;32.9;12.6
66;2021-05-09;886;1369;158311;61777;33.1;12.9
66;2021-05-10;1802;2967;160113;64744;33.4;13.5
66;2021-05-11;2741;3126;162854;67870;34.0;14.2
66;2021-05-12;2432;2569;165286;70439;34.5;14.7
66;2021-05-13;2259;1386;167545;71825;35.0;15.0
66;2021-05-14;2770;2118;170315;73943;35.6;15.4
66;2021-05-15;2326;1574;172641;75517;36.0;15.8
66;2021-05-16;2286;1246;174927;76763;36.5;16.0
66;2021-05-17;2051;1826;176978;78589;36.9;16.4
66;2021-05-18;3237;1808;180215;80397;37.6;16.8
66;2021-05-19;2876;1341;183091;81738;38.2;17.1
66;2021-05-20;4372;1444;187463;83182;39.1;17.4
66;2021-05-21;3268;1463;190731;84645;39.8;17.7
66;2021-05-22;3065;779;193796;85424;40.5;17.8
66;2021-05-23;1509;236;195305;85660;40.8;17.9
66;2021-05-24;1953;427;197258;86087;41.2;18.0
66;2021-05-25;2796;1688;200054;87775;41.8;18.3
66;2021-05-26;2779;1491;202833;89266;42.3;18.6
66;2021-05-27;3384;2247;206217;91513;43.1;19.1
66;2021-05-28;2683;3034;208900;94547;43.6;19.7
66;2021-05-29;2145;1518;211045;96065;44.1;20.1
66;2021-05-30;786;988;211831;97053;44.2;20.3
66;2021-05-31;2124;1771;213955;98824;44.7;20.6
66;2021-06-01;2636;2002;216591;100826;45.2;21.0
66;2021-06-02;2806;2334;219397;103160;45.8;21.5
66;2021-06-03;2488;2957;221885;106117;46.3;22.2
66;2021-06-04;1958;3351;223843;109468;46.7;22.9
66;2021-06-05;1409;2599;225252;112067;47.0;23.4
66;2021-06-06;294;1228;225546;113295;47.1;23.7
66;2021-06-07;1335;2955;226881;116250;47.4;24.3
66;2021-06-08;1736;3019;228617;119269;47.7;24.9
66;2021-06-09;2066;2787;230683;122056;48.2;25.5
66;2021-06-10;2086;2962;232769;125018;48.6;26.1
66;2021-06-11;2098;3856;234867;128874;49.0;26.9
66;2021-06-12;871;2411;235738;131285;49.2;27.4
66;2021-06-13;516;1333;236254;132618;49.3;27.7
66;2021-06-14;1361;3495;237615;136113;49.6;28.4
66;2021-06-15;2131;3572;239746;139685;50.1;29.2
66;2021-06-16;1792;3568;241538;143253;50.4;29.9
66;2021-06-17;2441;3604;243979;146857;50.9;30.7
66;2021-06-18;2225;3822;246204;150679;51.4;31.5
66;2021-06-19;1542;2319;247746;152998;51.7;31.9
66;2021-06-20;998;1267;248744;154265;51.9;32.2
66;2021-06-21;1163;2879;249907;157144;52.2;32.8
66;2021-06-22;1510;3761;251417;160905;52.5;33.6
66;2021-06-23;1325;3027;252742;163932;52.8;34.2
66;2021-06-24;1527;3226;254269;167158;53.1;34.9
66;2021-06-25;1404;3534;255673;170692;53.4;35.6
66;2021-06-26;962;2680;256635;173372;53.6;36.2
66;2021-06-27;677;1557;257312;174929;53.7;36.5
66;2021-06-28;980;2975;258292;177904;53.9;37.1
66;2021-06-29;1148;3797;259440;181701;54.2;37.9
66;2021-06-30;1278;3306;260718;185007;54.4;38.6
66;2021-07-01;1453;4047;262171;189054;54.7;39.5
66;2021-07-02;1349;3599;263520;192653;55.0;40.2
66;2021-07-03;1152;3898;264672;196551;55.3;41.0
66;2021-07-04;715;1789;265387;198340;55.4;41.4
66;2021-07-05;1293;3005;266680;201345;55.7;42.0
66;2021-07-06;1458;3785;268138;205130;56.0;42.8
66;2021-07-07;1430;3247;269568;208377;56.3;43.5
66;2021-07-08;1388;3384;270956;211761;56.6;44.2
66;2021-07-09;1450;3464;272406;215225;56.9;44.9
66;2021-07-10;1004;2403;273410;217628;57.1;45.4
66;2021-07-11;540;1540;273950;219168;57.2;45.8
66;2021-07-12;1021;3645;274971;222813;57.4;46.5
66;2021-07-13;2223;4261;277194;227074;57.9;47.4
66;2021-07-14;1953;1243;279147;228317;58.3;47.7
66;2021-07-15;2801;3110;281948;231427;58.9;48.3
66;2021-07-16;3410;3211;285358;234638;59.6;49.0
66;2021-07-17;2123;2033;287481;236671;60.0;49.4
66;2021-07-18;1197;1062;288678;237733;60.3;49.6
66;2021-07-19;2793;3083;291471;240816;60.8;50.3
66;2021-07-20;3654;2883;295125;243699;61.6;50.9
66;2021-07-21;3962;2952;299087;246651;62.4;51.5
66;2021-07-22;3917;2820;303004;249471;63.3;52.1
66;2021-07-23;3914;3029;306918;252500;64.1;52.7
66;2021-07-24;2584;1923;309502;254423;64.6;53.1
66;2021-07-25;2020;1241;311522;255664;65.0;53.4
66;2021-07-26;2865;2627;314387;258291;65.6;53.9
66;2021-07-27;3230;2888;317617;261179;66.3;54.5
66;2021-07-28;3354;2581;320971;263760;67.0;55.1
66;2021-07-29;3864;2537;324835;266297;67.8;55.6
66;2021-07-30;4233;2472;329068;268769;68.7;56.1
66;2021-07-31;2231;1716;331299;270485;69.2;56.5
66;2021-08-01;1820;900;333119;271385;69.5;56.7
66;2021-08-02;2390;1919;335509;273304;70.0;57.1
66;2021-08-03;2624;2071;338133;275375;70.6;57.5
66;2021-08-04;2645;1994;340778;277369;71.1;57.9
66;2021-08-05;2444;2438;343222;279807;71.7;58.4
66;2021-08-06;2339;2647;345561;282454;72.1;59.0
66;2021-08-07;1506;2098;347067;284552;72.5;59.4
66;2021-08-08;613;1456;347680;286008;72.6;59.7
66;2021-08-09;1356;2800;349036;288808;72.9;60.3
66;2021-08-10;1648;3074;350684;291882;73.2;60.9
66;2021-08-11;1628;3021;352312;294903;73.6;61.6
66;2021-08-12;1678;2991;353990;297894;73.9;62.2
66;2021-08-13;1473;2984;355463;300878;74.2;62.8
66;2021-08-14;658;2508;356121;303386;74.3;63.3
66;2021-08-15;136;1629;356257;305015;74.4;63.7
66;2021-08-16;1278;2594;357535;307609;74.6;64.2
66;2021-08-17;1496;2980;359031;310589;75.0;64.8
66;2021-08-18;1348;3073;360379;313662;75.2;65.5
66;2021-08-19;1113;2925;361492;316587;75.5;66.1
66;2021-08-20;1001;3322;362493;319909;75.7;66.8
66;2021-08-21;594;2013;363087;321922;75.8;67.2
66;2021-08-22;233;1352;363320;323274;75.8;67.5
66;2021-08-23;1149;2764;364469;326038;76.1;68.1
66;2021-08-24;1064;2950;365533;328988;76.3;68.7
66;2021-08-25;914;2301;366447;331289;76.5;69.2
66;2021-08-26;960;2186;367407;333475;76.7;69.6
66;2021-08-27;914;2366;368321;335841;76.9;70.1
66;2021-08-28;514;1137;368835;336978;77.0;70.4
66;2021-08-29;244;333;369079;337311;77.1;70.4
66;2021-08-30;837;2593;369916;339904;77.2;71.0
66;2021-08-31;835;2726;370751;342630;77.4;71.5
66;2021-09-01;726;2161;371477;344791;77.6;72.0
66;2021-09-02;666;1768;372143;346559;77.7;72.4
66;2021-09-03;714;2043;372857;348602;77.8;72.8
66;2021-09-04;721;1749;373578;350351;78.0;73.1
66;2021-09-05;203;311;373781;350662;78.0;73.2
66;2021-09-06;427;1877;374208;352539;78.1;73.6
66;2021-09-07;375;1636;374583;354175;78.2;73.9
66;2021-09-08;553;1768;375136;355943;78.3;74.3
66;2021-09-09;465;1594;375601;357537;78.4;74.6
66;2021-09-10;490;1531;376091;359068;78.5;75.0
66;2021-09-11;515;1308;376606;360376;78.6;75.2
66;2021-09-12;94;178;376700;360554;78.6;75.3
66;2021-09-13;338;1693;377038;362247;78.7;75.6
66;2021-09-14;383;1459;377421;363706;78.8;75.9
66;2021-09-15;473;957;377894;364663;78.9;76.1
66;2021-09-16;382;795;378276;365458;79.0;76.3
66;2021-09-17;325;770;378601;366228;79.0;76.5
66;2021-09-18;356;1098;378957;367326;79.1;76.7
66;2021-09-19;77;241;379034;367567;79.1;76.7
66;2021-09-20;288;672;379322;368239;79.2;76.9
66;2021-09-21;306;585;379628;368824;79.3;77.0
66;2021-09-22;316;792;379944;369616;79.3;77.2
66;2021-09-23;236;509;380180;370125;79.4;77.3
66;2021-09-24;360;772;380540;370897;79.4;77.4
66;2021-09-25;217;940;380757;371837;79.5;77.6
66;2021-09-26;63;213;380820;372050;79.5;77.7
66;2021-09-27;186;498;381006;372548;79.5;77.8
66;2021-09-28;244;543;381250;373091;79.6;77.9
66;2021-09-29;230;576;381480;373667;79.6;78.0
66;2021-09-30;335;452;381815;374119;79.7;78.1
66;2021-10-01;290;518;382105;374637;79.8;78.2
66;2021-10-02;265;616;382370;375253;79.8;78.3
66;2021-10-03;81;125;382451;375378;79.8;78.4
67;2020-12-27;13;0;13;0;0.0;0.0
67;2020-12-28;4;0;17;0;0.0;0.0
67;2020-12-29;2;0;19;0;0.0;0.0
67;2020-12-30;0;0;19;0;0.0;0.0
67;2020-12-31;0;0;19;0;0.0;0.0
67;2021-01-01;6;0;25;0;0.0;0.0
67;2021-01-02;1;0;26;0;0.0;0.0
67;2021-01-03;1;0;27;0;0.0;0.0
67;2021-01-04;41;0;68;0;0.0;0.0
67;2021-01-05;167;0;235;0;0.0;0.0
67;2021-01-06;121;0;356;0;0.0;0.0
67;2021-01-07;235;1;591;1;0.1;0.0
67;2021-01-08;235;1;826;2;0.1;0.0
67;2021-01-09;113;1;939;3;0.1;0.0
67;2021-01-10;67;0;1006;3;0.1;0.0
67;2021-01-11;184;1;1190;4;0.1;0.0
67;2021-01-12;511;1;1701;5;0.2;0.0
67;2021-01-13;660;2;2361;7;0.2;0.0
67;2021-01-14;1092;7;3453;14;0.3;0.0
67;2021-01-15;942;6;4395;20;0.4;0.0
67;2021-01-16;199;3;4594;23;0.4;0.0
67;2021-01-17;101;0;4695;23;0.4;0.0
67;2021-01-18;903;3;5598;26;0.5;0.0
67;2021-01-19;1423;5;7021;31;0.6;0.0
67;2021-01-20;1854;12;8875;43;0.8;0.0
67;2021-01-21;2216;10;11091;53;1.0;0.0
67;2021-01-22;1993;7;13084;60;1.2;0.0
67;2021-01-23;814;5;13898;65;1.2;0.0
67;2021-01-24;380;1;14278;66;1.3;0.0
67;2021-01-25;526;29;14804;95;1.3;0.0
67;2021-01-26;160;101;14964;196;1.3;0.0
67;2021-01-27;1403;79;16367;275;1.4;0.0
67;2021-01-28;3058;205;19425;480;1.7;0.0
67;2021-01-29;2033;139;21458;619;1.9;0.1
67;2021-01-30;1098;65;22556;684;2.0;0.1
67;2021-01-31;1163;24;23719;708;2.1;0.1
67;2021-02-01;3397;235;27116;943;2.4;0.1
67;2021-02-02;2695;390;29811;1333;2.6;0.1
67;2021-02-03;1577;371;31388;1704;2.8;0.2
67;2021-02-04;1196;713;32584;2417;2.9;0.2
67;2021-02-05;1195;588;33779;3005;3.0;0.3
67;2021-02-06;799;122;34578;3127;3.1;0.3
67;2021-02-07;292;37;34870;3164;3.1;0.3
67;2021-02-08;839;383;35709;3547;3.2;0.3
67;2021-02-09;963;652;36672;4199;3.2;0.4
67;2021-02-10;934;699;37606;4898;3.3;0.4
67;2021-02-11;1151;1059;38757;5957;3.4;0.5
67;2021-02-12;1245;671;40002;6628;3.5;0.6
67;2021-02-13;767;240;40769;6868;3.6;0.6
67;2021-02-14;244;91;41013;6959;3.6;0.6
67;2021-02-15;782;655;41795;7614;3.7;0.7
67;2021-02-16;931;865;42726;8479;3.8;0.7
67;2021-02-17;785;936;43511;9415;3.8;0.8
67;2021-02-18;1401;2332;44912;11747;4.0;1.0
67;2021-02-19;1376;1789;46288;13536;4.1;1.2
67;2021-02-20;634;747;46922;14283;4.1;1.3
67;2021-02-21;209;1074;47131;15357;4.2;1.4
67;2021-02-22;1401;1959;48532;17316;4.3;1.5
67;2021-02-23;1461;1308;49993;18624;4.4;1.6
67;2021-02-24;1439;894;51432;19518;4.5;1.7
67;2021-02-25;1618;1208;53050;20726;4.7;1.8
67;2021-02-26;2227;1162;55277;21888;4.9;1.9
67;2021-02-27;1260;620;56537;22508;5.0;2.0
67;2021-02-28;147;261;56684;22769;5.0;2.0
67;2021-03-01;640;843;57324;23612;5.1;2.1
67;2021-03-02;897;1039;58221;24651;5.1;2.2
67;2021-03-03;1409;1110;59630;25761;5.3;2.3
67;2021-03-04;1962;931;61592;26692;5.4;2.4
67;2021-03-05;3258;998;64850;27690;5.7;2.4
67;2021-03-06;2337;679;67187;28369;5.9;2.5
67;2021-03-07;468;239;67655;28608;6.0;2.5
67;2021-03-08;1188;719;68843;29327;6.1;2.6
67;2021-03-09;2227;821;71070;30148;6.3;2.7
67;2021-03-10;2455;1095;73525;31243;6.5;2.8
67;2021-03-11;3208;1297;76733;32540;6.8;2.9
67;2021-03-12;5260;1309;81993;33849;7.2;3.0
67;2021-03-13;3998;862;85991;34711;7.6;3.1
67;2021-03-14;483;369;86474;35080;7.6;3.1
67;2021-03-15;2192;1123;88666;36203;7.8;3.2
67;2021-03-16;1552;1199;90218;37402;8.0;3.3
67;2021-03-17;2071;893;92289;38295;8.1;3.4
67;2021-03-18;2390;720;94679;39015;8.4;3.4
67;2021-03-19;3673;739;98352;39754;8.7;3.5
67;2021-03-20;3064;503;101416;40257;9.0;3.6
67;2021-03-21;336;17;101752;40274;9.0;3.6
67;2021-03-22;2332;756;104084;41030;9.2;3.6
67;2021-03-23;3401;768;107485;41798;9.5;3.7
67;2021-03-24;3909;796;111394;42594;9.8;3.8
67;2021-03-25;5315;535;116709;43129;10.3;3.8
67;2021-03-26;6869;466;123578;43595;10.9;3.8
67;2021-03-27;3926;344;127504;43939;11.3;3.9
67;2021-03-28;579;98;128083;44037;11.3;3.9
67;2021-03-29;3824;422;131907;44459;11.6;3.9
67;2021-03-30;4848;665;136755;45124;12.1;4.0
67;2021-03-31;4848;692;141603;45816;12.5;4.0
67;2021-04-01;5147;923;146750;46739;13.0;4.1
67;2021-04-02;1009;171;147759;46910;13.0;4.1
67;2021-04-03;1689;282;149448;47192;13.2;4.2
67;2021-04-04;328;5;149776;47197;13.2;4.2
67;2021-04-05;371;5;150147;47202;13.3;4.2
67;2021-04-06;3483;1176;153630;48378;13.6;4.3
67;2021-04-07;4533;1281;158163;49659;14.0;4.4
67;2021-04-08;5664;1405;163827;51064;14.5;4.5
67;2021-04-09;7110;1345;170937;52409;15.1;4.6
67;2021-04-10;4332;886;175269;53295;15.5;4.7
67;2021-04-11;857;425;176126;53720;15.6;4.7
67;2021-04-12;3885;1402;180011;55122;15.9;4.9
67;2021-04-13;4890;1575;184901;56697;16.3;5.0
67;2021-04-14;5297;1898;190198;58595;16.8;5.2
67;2021-04-15;6082;2107;196280;60702;17.3;5.4
67;2021-04-16;7836;2420;204116;63122;18.0;5.6
67;2021-04-17;4010;1575;208126;64697;18.4;5.7
67;2021-04-18;1111;644;209237;65341;18.5;5.8
67;2021-04-19;3630;2139;212867;67480;18.8;6.0
67;2021-04-20;4257;1919;217124;69399;19.2;6.1
67;2021-04-21;4071;2514;221195;71913;19.5;6.3
67;2021-04-22;4478;2917;225673;74830;19.9;6.6
67;2021-04-23;5253;3003;230926;77833;20.4;6.9
67;2021-04-24;3101;2022;234027;79855;20.7;7.1
67;2021-04-25;1027;449;235054;80304;20.8;7.1
67;2021-04-26;3191;2614;238245;82918;21.0;7.3
67;2021-04-27;4023;2903;242268;85821;21.4;7.6
67;2021-04-28;4253;3407;246521;89228;21.8;7.9
67;2021-04-29;5125;3491;251646;92719;22.2;8.2
67;2021-04-30;7182;2458;258828;95177;22.9;8.4
67;2021-05-01;2685;780;261513;95957;23.1;8.5
67;2021-05-02;2181;677;263694;96634;23.3;8.5
67;2021-05-03;5561;2615;269255;99249;23.8;8.8
67;2021-05-04;5852;3601;275107;102850;24.3;9.1
67;2021-05-05;5219;4189;280326;107039;24.8;9.5
67;2021-05-06;6714;4915;287040;111954;25.3;9.9
67;2021-05-07;6434;6896;293474;118850;25.9;10.5
67;2021-05-08;3574;1018;297048;119868;26.2;10.6
67;2021-05-09;3366;592;300414;120460;26.5;10.6
67;2021-05-10;4698;4525;305112;124985;26.9;11.0
67;2021-05-11;5647;4909;310759;129894;27.4;11.5
67;2021-05-12;6598;4833;317357;134727;28.0;11.9
67;2021-05-13;7310;1668;324667;136395;28.7;12.0
67;2021-05-14;8878;5353;333545;141748;29.4;12.5
67;2021-05-15;8198;3655;341743;145403;30.2;12.8
67;2021-05-16;6176;969;347919;146372;30.7;12.9
67;2021-05-17;5689;3878;353608;150250;31.2;13.3
67;2021-05-18;6894;3975;360502;154225;31.8;13.6
67;2021-05-19;7376;4165;367878;158390;32.5;14.0
67;2021-05-20;8681;4229;376559;162619;33.2;14.4
67;2021-05-21;8156;5848;384715;168467;34.0;14.9
67;2021-05-22;5933;3416;390648;171883;34.5;15.2
67;2021-05-23;2656;593;393304;172476;34.7;15.2
67;2021-05-24;4414;863;397718;173339;35.1;15.3
67;2021-05-25;5412;4766;403130;178105;35.6;15.7
67;2021-05-26;6063;4868;409193;182973;36.1;16.2
67;2021-05-27;7310;4885;416503;187858;36.8;16.6
67;2021-05-28;7964;6487;424467;194345;37.5;17.2
67;2021-05-29;6646;3860;431113;198205;38.1;17.5
67;2021-05-30;1147;809;432260;199014;38.2;17.6
67;2021-05-31;6405;4054;438665;203068;38.7;17.9
67;2021-06-01;7326;4393;445991;207461;39.4;18.3
67;2021-06-02;8066;4176;454057;211637;40.1;18.7
67;2021-06-03;8841;4858;462898;216495;40.9;19.1
67;2021-06-04;8594;6119;471492;222614;41.6;19.7
67;2021-06-05;6548;3981;478040;226595;42.2;20.0
67;2021-06-06;3468;875;481508;227470;42.5;20.1
67;2021-06-07;7407;4252;488915;231722;43.2;20.5
67;2021-06-08;8616;4928;497531;236650;43.9;20.9
67;2021-06-09;9258;4784;506789;241434;44.7;21.3
67;2021-06-10;9769;5011;516558;246445;45.6;21.8
67;2021-06-11;8065;8307;524623;254752;46.3;22.5
67;2021-06-12;6789;5199;531412;259951;46.9;23.0
67;2021-06-13;3105;1044;534517;260995;47.2;23.0
67;2021-06-14;5503;6454;540020;267449;47.7;23.6
67;2021-06-15;6688;6749;546708;274198;48.3;24.2
67;2021-06-16;6948;6694;553656;280892;48.9;24.8
67;2021-06-17;7274;9039;560930;289931;49.5;25.6
67;2021-06-18;7601;8499;568531;298430;50.2;26.3
67;2021-06-19;6386;5959;574917;304389;50.8;26.9
67;2021-06-20;1446;1411;576363;305800;50.9;27.0
67;2021-06-21;4264;6773;580627;312573;51.3;27.6
67;2021-06-22;4240;9091;584867;321664;51.6;28.4
67;2021-06-23;5292;8181;590159;329845;52.1;29.1
67;2021-06-24;4521;9098;594680;338943;52.5;29.9
67;2021-06-25;5333;9949;600013;348892;53.0;30.8
67;2021-06-26;3463;9100;603476;357992;53.3;31.6
67;2021-06-27;1023;3523;604499;361515;53.4;31.9
67;2021-06-28;2845;8723;607344;370238;53.6;32.7
67;2021-06-29;2896;8609;610240;378847;53.9;33.4
67;2021-06-30;3380;8742;613620;387589;54.2;34.2
67;2021-07-01;3668;8419;617288;396008;54.5;35.0
67;2021-07-02;3735;10933;621023;406941;54.8;35.9
67;2021-07-03;2981;7742;624004;414683;55.1;36.6
67;2021-07-04;764;1869;624768;416552;55.2;36.8
67;2021-07-05;2625;8251;627393;424803;55.4;37.5
67;2021-07-06;3107;8437;630500;433240;55.7;38.3
67;2021-07-07;3925;8742;634425;441982;56.0;39.0
67;2021-07-08;4200;7785;638625;449767;56.4;39.7
67;2021-07-09;3767;11367;642392;461134;56.7;40.7
67;2021-07-10;2859;8204;645251;469338;57.0;41.4
67;2021-07-11;943;1994;646194;471332;57.1;41.6
67;2021-07-12;2478;9723;648672;481055;57.3;42.5
67;2021-07-13;4119;9886;652791;490941;57.6;43.3
67;2021-07-14;3491;4405;656282;495346;57.9;43.7
67;2021-07-15;5140;12226;661422;507572;58.4;44.8
67;2021-07-16;4867;12290;666289;519862;58.8;45.9
67;2021-07-17;3734;8820;670023;528682;59.2;46.7
67;2021-07-18;1464;2550;671487;531232;59.3;46.9
67;2021-07-19;4648;9739;676135;540971;59.7;47.8
67;2021-07-20;5775;9823;681910;550794;60.2;48.6
67;2021-07-21;5869;10649;687779;561443;60.7;49.6
67;2021-07-22;6439;10222;694218;571665;61.3;50.5
67;2021-07-23;7395;11185;701613;582850;61.9;51.5
67;2021-07-24;5423;7578;707036;590428;62.4;52.1
67;2021-07-25;2316;1971;709352;592399;62.6;52.3
67;2021-07-26;5003;7247;714355;599646;63.1;52.9
67;2021-07-27;6623;7325;720978;606971;63.7;53.6
67;2021-07-28;7541;7208;728519;614179;64.3;54.2
67;2021-07-29;8394;6432;736913;620611;65.1;54.8
67;2021-07-30;8667;7312;745580;627923;65.8;55.4
67;2021-07-31;5112;4878;750692;632801;66.3;55.9
67;2021-08-01;2486;1434;753178;634235;66.5;56.0
67;2021-08-02;6416;5093;759594;639328;67.1;56.4
67;2021-08-03;7321;4714;766915;644042;67.7;56.9
67;2021-08-04;6899;4602;773814;648644;68.3;57.3
67;2021-08-05;5746;4230;779560;652874;68.8;57.6
67;2021-08-06;6329;5425;785889;658299;69.4;58.1
67;2021-08-07;4691;4278;790580;662577;69.8;58.5
67;2021-08-08;1310;1440;791890;664017;69.9;58.6
67;2021-08-09;3142;4480;795032;668497;70.2;59.0
67;2021-08-10;3251;4782;798283;673279;70.5;59.4
67;2021-08-11;3424;4675;801707;677954;70.8;59.9
67;2021-08-12;3141;4887;804848;682841;71.1;60.3
67;2021-08-13;3208;5384;808056;688225;71.3;60.8
67;2021-08-14;2198;5084;810254;693309;71.5;61.2
67;2021-08-15;713;1605;810967;694914;71.6;61.4
67;2021-08-16;2094;5241;813061;700155;71.8;61.8
67;2021-08-17;2107;5278;815168;705433;72.0;62.3
67;2021-08-18;2384;6345;817552;711778;72.2;62.8
67;2021-08-19;1902;6152;819454;717930;72.4;63.4
67;2021-08-20;2359;7458;821813;725388;72.6;64.0
67;2021-08-21;1530;5572;823343;730960;72.7;64.5
67;2021-08-22;389;2050;823732;733010;72.7;64.7
67;2021-08-23;1945;6849;825677;739859;72.9;65.3
67;2021-08-24;1998;6613;827675;746472;73.1;65.9
67;2021-08-25;2127;7217;829802;753689;73.3;66.5
67;2021-08-26;1854;5550;831656;759239;73.4;67.0
67;2021-08-27;2216;7054;833872;766293;73.6;67.7
67;2021-08-28;1705;6105;835577;772398;73.8;68.2
67;2021-08-29;439;1600;836016;773998;73.8;68.3
67;2021-08-30;1424;4444;837440;778442;73.9;68.7
67;2021-08-31;1439;4207;838879;782649;74.1;69.1
67;2021-09-01;1824;4558;840703;787207;74.2;69.5
67;2021-09-02;1083;3132;841786;790339;74.3;69.8
67;2021-09-03;1561;4439;843347;794778;74.5;70.2
67;2021-09-04;1479;4094;844826;798872;74.6;70.5
67;2021-09-05;259;936;845085;799808;74.6;70.6
67;2021-09-06;968;2344;846053;802152;74.7;70.8
67;2021-09-07;888;2238;846941;804390;74.8;71.0
67;2021-09-08;1201;2997;848142;807387;74.9;71.3
67;2021-09-09;1107;2287;849249;809674;75.0;71.5
67;2021-09-10;1431;2892;850680;812566;75.1;71.7
67;2021-09-11;1062;3104;851742;815670;75.2;72.0
67;2021-09-12;250;612;851992;816282;75.2;72.1
67;2021-09-13;698;2047;852690;818329;75.3;72.3
67;2021-09-14;937;2011;853627;820340;75.4;72.4
67;2021-09-15;1015;2108;854642;822448;75.5;72.6
67;2021-09-16;749;1303;855391;823751;75.5;72.7
67;2021-09-17;969;2228;856360;825979;75.6;72.9
67;2021-09-18;806;2422;857166;828401;75.7;73.1
67;2021-09-19;103;411;857269;828812;75.7;73.2
67;2021-09-20;601;1131;857870;829943;75.7;73.3
67;2021-09-21;490;1064;858360;831007;75.8;73.4
67;2021-09-22;669;1950;859029;832957;75.8;73.5
67;2021-09-23;566;941;859595;833898;75.9;73.6
67;2021-09-24;679;1663;860274;835561;76.0;73.8
67;2021-09-25;601;1868;860875;837429;76.0;73.9
67;2021-09-26;73;327;860948;837756;76.0;74.0
67;2021-09-27;395;948;861343;838704;76.0;74.1
67;2021-09-28;403;859;861746;839563;76.1;74.1
67;2021-09-29;617;1356;862363;840919;76.1;74.2
67;2021-09-30;421;932;862784;841851;76.2;74.3
67;2021-10-01;646;1431;863430;843282;76.2;74.5
67;2021-10-02;623;1286;864053;844568;76.3;74.6
67;2021-10-03;90;216;864143;844784;76.3;74.6
68;2020-12-27;0;0;0;0;0.0;0.0
68;2020-12-28;0;0;0;0;0.0;0.0
68;2020-12-29;0;0;0;0;0.0;0.0
68;2020-12-30;2;0;2;0;0.0;0.0
68;2020-12-31;0;0;2;0;0.0;0.0
68;2021-01-01;0;0;2;0;0.0;0.0
68;2021-01-02;0;0;2;0;0.0;0.0
68;2021-01-03;1;0;3;0;0.0;0.0
68;2021-01-04;2;0;5;0;0.0;0.0
68;2021-01-05;11;0;16;0;0.0;0.0
68;2021-01-06;245;1;261;1;0.0;0.0
68;2021-01-07;75;0;336;1;0.0;0.0
68;2021-01-08;118;1;454;2;0.1;0.0
68;2021-01-09;20;0;474;2;0.1;0.0
68;2021-01-10;1;0;475;2;0.1;0.0
68;2021-01-11;82;0;557;2;0.1;0.0
68;2021-01-12;388;1;945;3;0.1;0.0
68;2021-01-13;704;2;1649;5;0.2;0.0
68;2021-01-14;372;2;2021;7;0.3;0.0
68;2021-01-15;204;1;2225;8;0.3;0.0
68;2021-01-16;1;0;2226;8;0.3;0.0
68;2021-01-17;0;0;2226;8;0.3;0.0
68;2021-01-18;379;5;2605;13;0.3;0.0
68;2021-01-19;559;5;3164;18;0.4;0.0
68;2021-01-20;707;10;3871;28;0.5;0.0
68;2021-01-21;1394;13;5265;41;0.7;0.0
68;2021-01-22;1497;12;6762;53;0.9;0.0
68;2021-01-23;215;3;6977;56;0.9;0.0
68;2021-01-24;698;1;7675;57;1.0;0.0
68;2021-01-25;1390;41;9065;98;1.2;0.0
68;2021-01-26;1555;79;10620;177;1.4;0.0
68;2021-01-27;2774;151;13394;328;1.8;0.0
68;2021-01-28;2358;58;15752;386;2.1;0.1
68;2021-01-29;1509;116;17261;502;2.3;0.1
68;2021-01-30;165;3;17426;505;2.3;0.1
68;2021-01-31;0;0;17426;505;2.3;0.1
68;2021-02-01;737;106;18163;611;2.4;0.1
68;2021-02-02;869;293;19032;904;2.5;0.1
68;2021-02-03;1001;596;20033;1500;2.6;0.2
68;2021-02-04;1001;307;21034;1807;2.8;0.2
68;2021-02-05;947;220;21981;2027;2.9;0.3
68;2021-02-06;140;2;22121;2029;2.9;0.3
68;2021-02-07;2;16;22123;2045;2.9;0.3
68;2021-02-08;893;23;23016;2068;3.0;0.3
68;2021-02-09;1357;42;24373;2110;3.2;0.3
68;2021-02-10;1453;64;25826;2174;3.4;0.3
68;2021-02-11;1486;461;27312;2635;3.6;0.3
68;2021-02-12;1551;435;28863;3070;3.8;0.4
68;2021-02-13;131;1;28994;3071;3.8;0.4
68;2021-02-14;58;232;29052;3303;3.8;0.4
68;2021-02-15;662;969;29714;4272;3.9;0.6
68;2021-02-16;864;1197;30578;5469;4.0;0.7
68;2021-02-17;1288;2010;31866;7479;4.2;1.0
68;2021-02-18;1668;1930;33534;9409;4.4;1.2
68;2021-02-19;988;1247;34522;10656;4.5;1.4
68;2021-02-20;93;118;34615;10774;4.5;1.4
68;2021-02-21;1;38;34616;10812;4.5;1.4
68;2021-02-22;447;683;35063;11495;4.6;1.5
68;2021-02-23;639;968;35702;12463;4.7;1.6
68;2021-02-24;854;1042;36556;13505;4.8;1.8
68;2021-02-25;1208;1135;37764;14640;4.9;1.9
68;2021-02-26;1199;847;38963;15487;5.1;2.0
68;2021-02-27;550;158;39513;15645;5.2;2.0
68;2021-02-28;12;1;39525;15646;5.2;2.1
68;2021-03-01;942;678;40467;16324;5.3;2.1
68;2021-03-02;1215;857;41682;17181;5.5;2.3
68;2021-03-03;1593;896;43275;18077;5.7;2.4
68;2021-03-04;1995;943;45270;19020;5.9;2.5
68;2021-03-05;2355;952;47625;19972;6.2;2.6
68;2021-03-06;2286;237;49911;20209;6.5;2.6
68;2021-03-07;838;104;50749;20313;6.6;2.7
68;2021-03-08;1476;886;52225;21199;6.8;2.8
68;2021-03-09;1698;1236;53923;22435;7.1;2.9
68;2021-03-10;1966;1713;55889;24148;7.3;3.2
68;2021-03-11;2637;1833;58526;25981;7.7;3.4
68;2021-03-12;2631;1350;61157;27331;8.0;3.6
68;2021-03-13;3342;257;64499;27588;8.5;3.6
68;2021-03-14;1541;65;66040;27653;8.7;3.6
68;2021-03-15;1796;607;67836;28260;8.9;3.7
68;2021-03-16;1998;590;69834;28850;9.2;3.8
68;2021-03-17;1957;719;71791;29569;9.4;3.9
68;2021-03-18;2220;934;74011;30503;9.7;4.0
68;2021-03-19;3084;720;77095;31223;10.1;4.1
68;2021-03-20;973;122;78068;31345;10.2;4.1
68;2021-03-21;68;2;78136;31347;10.2;4.1
68;2021-03-22;1964;588;80100;31935;10.5;4.2
68;2021-03-23;2861;614;82961;32549;10.9;4.3
68;2021-03-24;3177;808;86138;33357;11.3;4.4
68;2021-03-25;3502;781;89640;34138;11.7;4.5
68;2021-03-26;3894;723;93534;34861;12.3;4.6
68;2021-03-27;1102;168;94636;35029;12.4;4.6
68;2021-03-28;56;3;94692;35032;12.4;4.6
68;2021-03-29;2260;1354;96952;36386;12.7;4.8
68;2021-03-30;2933;1289;99885;37675;13.1;4.9
68;2021-03-31;2643;1348;102528;39023;13.4;5.1
68;2021-04-01;2748;1540;105276;40563;13.8;5.3
68;2021-04-02;244;88;105520;40651;13.8;5.3
68;2021-04-03;241;123;105761;40774;13.9;5.3
68;2021-04-04;5;0;105766;40774;13.9;5.3
68;2021-04-05;49;3;105815;40777;13.9;5.3
68;2021-04-06;1793;1321;107608;42098;14.1;5.5
68;2021-04-07;2585;1535;110193;43633;14.4;5.7
68;2021-04-08;3234;1503;113427;45136;14.9;5.9
68;2021-04-09;4200;1528;117627;46664;15.4;6.1
68;2021-04-10;1204;1968;118831;48632;15.6;6.4
68;2021-04-11;126;1317;118957;49949;15.6;6.5
68;2021-04-12;2665;1631;121622;51580;15.9;6.8
68;2021-04-13;2760;2108;124382;53688;16.3;7.0
68;2021-04-14;3606;2266;127988;55954;16.8;7.3
68;2021-04-15;4055;2160;132043;58114;17.3;7.6
68;2021-04-16;3942;2080;135985;60194;17.8;7.9
68;2021-04-17;1075;440;137060;60634;18.0;7.9
68;2021-04-18;85;9;137145;60643;18.0;7.9
68;2021-04-19;2358;1829;139503;62472;18.3;8.2
68;2021-04-20;2442;2323;141945;64795;18.6;8.5
68;2021-04-21;2829;2473;144774;67268;19.0;8.8
68;2021-04-22;3287;1973;148061;69241;19.4;9.1
68;2021-04-23;3412;2073;151473;71314;19.8;9.3
68;2021-04-24;842;487;152315;71801;20.0;9.4
68;2021-04-25;214;20;152529;71821;20.0;9.4
68;2021-04-26;2328;2103;154857;73924;20.3;9.7
68;2021-04-27;2599;2212;157456;76136;20.6;10.0
68;2021-04-28;3572;1760;161028;77896;21.1;10.2
68;2021-04-29;4164;1747;165192;79643;21.6;10.4
68;2021-04-30;4834;1368;170026;81011;22.3;10.6
68;2021-05-01;948;119;170974;81130;22.4;10.6
68;2021-05-02;732;69;171706;81199;22.5;10.6
68;2021-05-03;3620;1819;175326;83018;23.0;10.9
68;2021-05-04;3937;2357;179263;85375;23.5;11.2
68;2021-05-05;3632;3240;182895;88615;24.0;11.6
68;2021-05-06;4804;2858;187699;91473;24.6;12.0
68;2021-05-07;4518;2900;192217;94373;25.2;12.4
68;2021-05-08;1672;210;193889;94583;25.4;12.4
68;2021-05-09;1075;107;194964;94690;25.5;12.4
68;2021-05-10;3159;3719;198123;98409;26.0;12.9
68;2021-05-11;4715;3614;202838;102023;26.6;13.4
68;2021-05-12;5785;3292;208623;105315;27.3;13.8
68;2021-05-13;4766;840;213389;106155;28.0;13.9
68;2021-05-14;5959;2131;219348;108286;28.7;14.2
68;2021-05-15;3558;909;222906;109195;29.2;14.3
68;2021-05-16;670;118;223576;109313;29.3;14.3
68;2021-05-17;4449;2498;228025;111811;29.9;14.7
68;2021-05-18;6139;2306;234164;114117;30.7;15.0
68;2021-05-19;5867;2882;240031;116999;31.5;15.3
68;2021-05-20;5928;2410;245959;119409;32.2;15.6
68;2021-05-21;5774;2866;251733;122275;33.0;16.0
68;2021-05-22;2576;925;254309;123200;33.3;16.1
68;2021-05-23;15;16;254324;123216;33.3;16.1
68;2021-05-24;2303;970;256627;124186;33.6;16.3
68;2021-05-25;4343;3435;260970;127621;34.2;16.7
68;2021-05-26;4883;3383;265853;131004;34.8;17.2
68;2021-05-27;5400;3401;271253;134405;35.5;17.6
68;2021-05-28;5623;3717;276876;138122;36.3;18.1
68;2021-05-29;1540;1185;278416;139307;36.5;18.3
68;2021-05-30;41;46;278457;139353;36.5;18.3
68;2021-05-31;5158;2363;283615;141716;37.2;18.6
68;2021-06-01;5989;2792;289604;144508;37.9;18.9
68;2021-06-02;4886;3006;294490;147514;38.6;19.3
68;2021-06-03;5938;3097;300428;150611;39.4;19.7
68;2021-06-04;4896;3298;305324;153909;40.0;20.2
68;2021-06-05;781;1168;306105;155077;40.1;20.3
68;2021-06-06;69;114;306174;155191;40.1;20.3
68;2021-06-07;4753;3035;310927;158226;40.7;20.7
68;2021-06-08;4934;3554;315861;161780;41.4;21.2
68;2021-06-09;4994;3446;320855;165226;42.0;21.6
68;2021-06-10;5200;3144;326055;168370;42.7;22.1
68;2021-06-11;5055;4145;331110;172515;43.4;22.6
68;2021-06-12;3036;1770;334146;174285;43.8;22.8
68;2021-06-13;514;682;334660;174967;43.8;22.9
68;2021-06-14;2516;4390;337176;179357;44.2;23.5
68;2021-06-15;3112;4718;340288;184075;44.6;24.1
68;2021-06-16;3387;4441;343675;188516;45.0;24.7
68;2021-06-17;2358;4453;346033;192969;45.3;25.3
68;2021-06-18;3358;5171;349391;198140;45.8;26.0
68;2021-06-19;2253;2170;351644;200310;46.1;26.2
68;2021-06-20;258;891;351902;201201;46.1;26.4
68;2021-06-21;2059;5149;353961;206350;46.4;27.0
68;2021-06-22;1900;5174;355861;211524;46.6;27.7
68;2021-06-23;2318;5740;358179;217264;46.9;28.5
68;2021-06-24;2153;4897;360332;222161;47.2;29.1
68;2021-06-25;2287;6656;362619;228817;47.5;30.0
68;2021-06-26;1303;2608;363922;231425;47.7;30.3
68;2021-06-27;151;880;364073;232305;47.7;30.4
68;2021-06-28;1601;6444;365674;238749;47.9;31.3
68;2021-06-29;1539;6631;367213;245380;48.1;32.2
68;2021-06-30;1797;6554;369010;251934;48.4;33.0
68;2021-07-01;2105;5350;371115;257284;48.6;33.7
68;2021-07-02;2098;6482;373213;263766;48.9;34.6
68;2021-07-03;989;1934;374202;265700;49.0;34.8
68;2021-07-04;242;200;374444;265900;49.1;34.8
68;2021-07-05;1456;5513;375900;271413;49.3;35.6
68;2021-07-06;2001;5883;377901;277296;49.5;36.3
68;2021-07-07;2455;4974;380356;282270;49.8;37.0
68;2021-07-08;2434;4746;382790;287016;50.2;37.6
68;2021-07-09;2092;7364;384882;294380;50.4;38.6
68;2021-07-10;1028;2002;385910;296382;50.6;38.8
68;2021-07-11;147;156;386057;296538;50.6;38.9
68;2021-07-12;1646;6771;387703;303309;50.8;39.7
68;2021-07-13;2909;6549;390612;309858;51.2;40.6
68;2021-07-14;1840;984;392452;310842;51.4;40.7
68;2021-07-15;3188;6651;395640;317493;51.8;41.6
68;2021-07-16;3817;6761;399457;324254;52.3;42.5
68;2021-07-17;3360;2301;402817;326555;52.8;42.8
68;2021-07-18;1054;230;403871;326785;52.9;42.8
68;2021-07-19;3050;6079;406921;332864;53.3;43.6
68;2021-07-20;4002;5666;410923;338530;53.8;44.4
68;2021-07-21;4339;5831;415262;344361;54.4;45.1
68;2021-07-22;4187;4846;419449;349207;55.0;45.8
68;2021-07-23;5041;5759;424490;354966;55.6;46.5
68;2021-07-24;3349;2131;427839;357097;56.1;46.8
68;2021-07-25;825;537;428664;357634;56.2;46.9
68;2021-07-26;4835;4449;433499;362083;56.8;47.4
68;2021-07-27;6364;3754;439863;365837;57.6;47.9
68;2021-07-28;6848;3882;446711;369719;58.5;48.4
68;2021-07-29;6398;3426;453109;373145;59.4;48.9
68;2021-07-30;6342;4376;459451;377521;60.2;49.5
68;2021-07-31;3917;1426;463368;378947;60.7;49.7
68;2021-08-01;1651;494;465019;379441;60.9;49.7
68;2021-08-02;4606;3149;469625;382590;61.5;50.1
68;2021-08-03;3550;2448;473175;385038;62.0;50.5
68;2021-08-04;3135;2689;476310;387727;62.4;50.8
68;2021-08-05;2753;2639;479063;390366;62.8;51.1
68;2021-08-06;3995;4326;483058;394692;63.3;51.7
68;2021-08-07;1227;1305;484285;395997;63.5;51.9
68;2021-08-08;364;813;484649;396810;63.5;52.0
68;2021-08-09;2574;3683;487223;400493;63.8;52.5
68;2021-08-10;2216;2784;489439;403277;64.1;52.8
68;2021-08-11;1896;2728;491335;406005;64.4;53.2
68;2021-08-12;1752;2667;493087;408672;64.6;53.5
68;2021-08-13;2715;4757;495802;413429;65.0;54.2
68;2021-08-14;714;1443;496516;414872;65.1;54.4
68;2021-08-15;45;445;496561;415317;65.1;54.4
68;2021-08-16;2003;5062;498564;420379;65.3;55.1
68;2021-08-17;1802;4848;500366;425227;65.6;55.7
68;2021-08-18;1182;3697;501548;428924;65.7;56.2
68;2021-08-19;1367;3741;502915;432665;65.9;56.7
68;2021-08-20;2229;6065;505144;438730;66.2;57.5
68;2021-08-21;492;1382;505636;440112;66.3;57.7
68;2021-08-22;116;457;505752;440569;66.3;57.7
68;2021-08-23;1192;5425;506944;445994;66.4;58.4
68;2021-08-24;1407;5953;508351;451947;66.6;59.2
68;2021-08-25;1659;3752;510010;455699;66.8;59.7
68;2021-08-26;1990;4505;512000;460204;67.1;60.3
68;2021-08-27;1850;6281;513850;466485;67.3;61.1
68;2021-08-28;422;1070;514272;467555;67.4;61.3
68;2021-08-29;36;418;514308;467973;67.4;61.3
68;2021-08-30;1346;4554;515654;472527;67.6;61.9
68;2021-08-31;1304;4239;516958;476766;67.7;62.5
68;2021-09-01;881;2281;517839;479047;67.9;62.8
68;2021-09-02;878;1982;518717;481029;68.0;63.0
68;2021-09-03;1305;4621;520022;485650;68.1;63.6
68;2021-09-04;493;955;520515;486605;68.2;63.8
68;2021-09-05;209;176;520724;486781;68.2;63.8
68;2021-09-06;691;2386;521415;489167;68.3;64.1
68;2021-09-07;607;1452;522022;490619;68.4;64.3
68;2021-09-08;617;1487;522639;492106;68.5;64.5
68;2021-09-09;900;1572;523539;493678;68.6;64.7
68;2021-09-10;1482;3346;525021;497024;68.8;65.1
68;2021-09-11;470;675;525491;497699;68.9;65.2
68;2021-09-12;73;63;525564;497762;68.9;65.2
68;2021-09-13;810;1389;526374;499151;69.0;65.4
68;2021-09-14;972;1727;527346;500878;69.1;65.6
68;2021-09-15;692;1583;528038;502461;69.2;65.8
68;2021-09-16;630;1076;528668;503537;69.3;66.0
68;2021-09-17;981;2329;529649;505866;69.4;66.3
68;2021-09-18;435;762;530084;506628;69.5;66.4
68;2021-09-19;16;48;530100;506676;69.5;66.4
68;2021-09-20;546;966;530646;507642;69.5;66.5
68;2021-09-21;583;1327;531229;508969;69.6;66.7
68;2021-09-22;632;1154;531861;510123;69.7;66.8
68;2021-09-23;367;679;532228;510802;69.7;66.9
68;2021-09-24;644;1605;532872;512407;69.8;67.1
68;2021-09-25;276;668;533148;513075;69.9;67.2
68;2021-09-26;19;56;533167;513131;69.9;67.2
68;2021-09-27;338;686;533505;513817;69.9;67.3
68;2021-09-28;335;543;533840;514360;69.9;67.4
68;2021-09-29;537;874;534377;515234;70.0;67.5
68;2021-09-30;384;787;534761;516021;70.1;67.6
68;2021-10-01;498;1533;535259;517554;70.1;67.8
68;2021-10-02;239;566;535498;518120;70.2;67.9
68;2021-10-03;36;89;535534;518209;70.2;67.9
69;2020-12-27;5;0;5;0;0.0;0.0
69;2020-12-28;13;0;18;0;0.0;0.0
69;2020-12-29;5;0;23;0;0.0;0.0
69;2020-12-30;6;0;29;0;0.0;0.0
69;2020-12-31;12;0;41;0;0.0;0.0
69;2021-01-01;2;0;43;0;0.0;0.0
69;2021-01-02;2;0;45;0;0.0;0.0
69;2021-01-03;3;0;48;0;0.0;0.0
69;2021-01-04;13;0;61;0;0.0;0.0
69;2021-01-05;218;0;279;0;0.0;0.0
69;2021-01-06;518;0;797;0;0.0;0.0
69;2021-01-07;813;0;1610;0;0.1;0.0
69;2021-01-08;828;1;2438;1;0.1;0.0
69;2021-01-09;41;1;2479;2;0.1;0.0
69;2021-01-10;3;1;2482;3;0.1;0.0
69;2021-01-11;1135;2;3617;5;0.2;0.0
69;2021-01-12;1398;8;5015;13;0.3;0.0
69;2021-01-13;1395;3;6410;16;0.3;0.0
69;2021-01-14;2285;17;8695;33;0.5;0.0
69;2021-01-15;1829;8;10524;41;0.6;0.0
69;2021-01-16;930;3;11454;44;0.6;0.0
69;2021-01-17;260;2;11714;46;0.6;0.0
69;2021-01-18;1695;18;13409;64;0.7;0.0
69;2021-01-19;3511;36;16920;100;0.9;0.0
69;2021-01-20;4456;29;21376;129;1.1;0.0
69;2021-01-21;4078;26;25454;155;1.4;0.0
69;2021-01-22;3183;19;28637;174;1.5;0.0
69;2021-01-23;1287;5;29924;179;1.6;0.0
69;2021-01-24;102;1;30026;180;1.6;0.0
69;2021-01-25;2245;36;32271;216;1.7;0.0
69;2021-01-26;2563;88;34834;304;1.9;0.0
69;2021-01-27;2358;169;37192;473;2.0;0.0
69;2021-01-28;2238;351;39430;824;2.1;0.0
69;2021-01-29;2111;273;41541;1097;2.2;0.1
69;2021-01-30;889;3;42430;1100;2.3;0.1
69;2021-01-31;65;0;42495;1100;2.3;0.1
69;2021-02-01;1112;383;43607;1483;2.3;0.1
69;2021-02-02;1559;382;45166;1865;2.4;0.1
69;2021-02-03;1444;518;46610;2383;2.5;0.1
69;2021-02-04;1795;898;48405;3281;2.6;0.2
69;2021-02-05;821;797;49226;4078;2.6;0.2
69;2021-02-06;370;41;49596;4119;2.6;0.2
69;2021-02-07;0;0;49596;4119;2.6;0.2
69;2021-02-08;1133;938;50729;5057;2.7;0.3
69;2021-02-09;2052;1795;52781;6852;2.8;0.4
69;2021-02-10;1855;2407;54636;9259;2.9;0.5
69;2021-02-11;1860;2960;56496;12219;3.0;0.7
69;2021-02-12;1905;1797;58401;14016;3.1;0.7
69;2021-02-13;459;564;58860;14580;3.1;0.8
69;2021-02-14;89;32;58949;14612;3.1;0.8
69;2021-02-15;1016;1407;59965;16019;3.2;0.9
69;2021-02-16;984;1860;60949;17879;3.2;1.0
69;2021-02-17;1027;1896;61976;19775;3.3;1.1
69;2021-02-18;968;1834;62944;21609;3.4;1.2
69;2021-02-19;890;1485;63834;23094;3.4;1.2
69;2021-02-20;321;672;64155;23766;3.4;1.3
69;2021-02-21;53;53;64208;23819;3.4;1.3
69;2021-02-22;609;1697;64817;25516;3.5;1.4
69;2021-02-23;741;1834;65558;27350;3.5;1.5
69;2021-02-24;973;1857;66531;29207;3.5;1.6
69;2021-02-25;2214;2314;68745;31521;3.7;1.7
69;2021-02-26;2772;1652;71517;33173;3.8;1.8
69;2021-02-27;925;496;72442;33669;3.9;1.8
69;2021-02-28;148;98;72590;33767;3.9;1.8
69;2021-03-01;2166;748;74756;34515;4.0;1.8
69;2021-03-02;3298;1184;78054;35699;4.2;1.9
69;2021-03-03;3670;1134;81724;36833;4.4;2.0
69;2021-03-04;4887;1210;86611;38043;4.6;2.0
69;2021-03-05;5875;1117;92486;39160;4.9;2.1
69;2021-03-06;3417;368;95903;39528;5.1;2.1
69;2021-03-07;640;44;96543;39572;5.1;2.1
69;2021-03-08;2960;992;99503;40564;5.3;2.2
69;2021-03-09;4607;1108;104110;41672;5.5;2.2
69;2021-03-10;5072;967;109182;42639;5.8;2.3
69;2021-03-11;6601;981;115783;43620;6.2;2.3
69;2021-03-12;8856;1112;124639;44732;6.6;2.4
69;2021-03-13;4928;242;129567;44974;6.9;2.4
69;2021-03-14;2741;150;132308;45124;7.1;2.4
69;2021-03-15;4803;673;137111;45797;7.3;2.4
69;2021-03-16;3819;656;140930;46453;7.5;2.5
69;2021-03-17;3953;866;144883;47319;7.7;2.5
69;2021-03-18;4965;1535;149848;48854;8.0;2.6
69;2021-03-19;6685;971;156533;49825;8.3;2.7
69;2021-03-20;3593;278;160126;50103;8.5;2.7
69;2021-03-21;1975;101;162101;50204;8.6;2.7
69;2021-03-22;4550;742;166651;50946;8.9;2.7
69;2021-03-23;7364;806;174015;51752;9.3;2.8
69;2021-03-24;6456;994;180471;52746;9.6;2.8
69;2021-03-25;8591;1123;189062;53869;10.1;2.9
69;2021-03-26;8814;1246;197876;55115;10.5;2.9
69;2021-03-27;3157;789;201033;55904;10.7;3.0
69;2021-03-28;2218;186;203251;56090;10.8;3.0
69;2021-03-29;4098;2167;207349;58257;11.1;3.1
69;2021-03-30;7641;2531;214990;60788;11.5;3.2
69;2021-03-31;6356;3099;221346;63887;11.8;3.4
69;2021-04-01;8462;2721;229808;66608;12.2;3.6
69;2021-04-02;8314;3106;238122;69714;12.7;3.7
69;2021-04-03;5424;2115;243546;71829;13.0;3.8
69;2021-04-04;6610;543;250156;72372;13.3;3.9
69;2021-04-05;6190;816;256346;73188;13.7;3.9
69;2021-04-06;5114;3466;261460;76654;13.9;4.1
69;2021-04-07;5167;3865;266627;80519;14.2;4.3
69;2021-04-08;6429;3998;273056;84517;14.6;4.5
69;2021-04-09;9165;3735;282221;88252;15.0;4.7
69;2021-04-10;3053;2492;285274;90744;15.2;4.8
69;2021-04-11;2036;1895;287310;92639;15.3;4.9
69;2021-04-12;5474;3556;292784;96195;15.6;5.1
69;2021-04-13;7068;4113;299852;100308;16.0;5.3
69;2021-04-14;6718;4157;306570;104465;16.3;5.6
69;2021-04-15;7943;4594;314513;109059;16.8;5.8
69;2021-04-16;7868;4488;322381;113547;17.2;6.1
69;2021-04-17;5036;2311;327417;115858;17.5;6.2
69;2021-04-18;1715;1790;329132;117648;17.5;6.3
69;2021-04-19;7021;3774;336153;121422;17.9;6.5
69;2021-04-20;6485;4761;342638;126183;18.3;6.7
69;2021-04-21;5688;4415;348326;130598;18.6;7.0
69;2021-04-22;6427;5438;354753;136036;18.9;7.3
69;2021-04-23;6735;4900;361488;140936;19.3;7.5
69;2021-04-24;3160;2030;364648;142966;19.4;7.6
69;2021-04-25;2120;1544;366768;144510;19.6;7.7
69;2021-04-26;4495;3869;371263;148379;19.8;7.9
69;2021-04-27;6516;5305;377779;153684;20.1;8.2
69;2021-04-28;6273;4860;384052;158544;20.5;8.5
69;2021-04-29;6707;5363;390759;163907;20.8;8.7
69;2021-04-30;6931;6142;397690;170049;21.2;9.1
69;2021-05-01;3301;644;400991;170693;21.4;9.1
69;2021-05-02;1628;5880;402619;176573;21.5;9.4
69;2021-05-03;5859;8240;408478;184813;21.8;9.9
69;2021-05-04;7608;8152;416086;192965;22.2;10.3
69;2021-05-05;11210;5657;427296;198622;22.8;10.6
69;2021-05-06;12470;6297;439766;204919;23.4;10.9
69;2021-05-07;11685;7134;451451;212053;24.1;11.3
69;2021-05-08;4303;1651;455754;213704;24.3;11.4
69;2021-05-09;6634;2679;462388;216383;24.6;11.5
69;2021-05-10;6935;6066;469323;222449;25.0;11.9
69;2021-05-11;9829;7032;479152;229481;25.5;12.2
69;2021-05-12;12450;6783;491602;236264;26.2;12.6
69;2021-05-13;10839;2561;502441;238825;26.8;12.7
69;2021-05-14;12598;5208;515039;244033;27.5;13.0
69;2021-05-15;9135;2591;524174;246624;27.9;13.1
69;2021-05-16;8403;1875;532577;248499;28.4;13.2
69;2021-05-17;11306;5648;543883;254147;29.0;13.5
69;2021-05-18;13226;6398;557109;260545;29.7;13.9
69;2021-05-19;13696;5888;570805;266433;30.4;14.2
69;2021-05-20;11387;6076;582192;272509;31.0;14.5
69;2021-05-21;11037;6547;593229;279056;31.6;14.9
69;2021-05-22;5574;2575;598803;281631;31.9;15.0
69;2021-05-23;4573;1544;603376;283175;32.2;15.1
69;2021-05-24;8420;1864;611796;285039;32.6;15.2
69;2021-05-25;9741;6174;621537;291213;33.1;15.5
69;2021-05-26;10282;6105;631819;297318;33.7;15.8
69;2021-05-27;10429;6781;642248;304099;34.2;16.2
69;2021-05-28;11611;8735;653859;312834;34.9;16.7
69;2021-05-29;7387;6045;661246;318879;35.2;17.0
69;2021-05-30;7386;3170;668632;322049;35.6;17.2
69;2021-05-31;10956;6374;679588;328423;36.2;17.5
69;2021-06-01;12842;7499;692430;335922;36.9;17.9
69;2021-06-02;14885;6721;707315;342643;37.7;18.3
69;2021-06-03;16641;7423;723956;350066;38.6;18.7
69;2021-06-04;16199;8550;740155;358616;39.5;19.1
69;2021-06-05;10106;3416;750261;362032;40.0;19.3
69;2021-06-06;7488;1719;757749;363751;40.4;19.4
69;2021-06-07;12816;7019;770565;370770;41.1;19.8
69;2021-06-08;16309;8276;786874;379046;41.9;20.2
69;2021-06-09;15212;7351;802086;386397;42.8;20.6
69;2021-06-10;16274;7327;818360;393724;43.6;21.0
69;2021-06-11;16635;9676;834995;403400;44.5;21.5
69;2021-06-12;8528;4188;843523;407588;45.0;21.7
69;2021-06-13;5620;2146;849143;409734;45.3;21.8
69;2021-06-14;8573;9081;857716;418815;45.7;22.3
69;2021-06-15;10933;11014;868649;429829;46.3;22.9
69;2021-06-16;11332;12316;879981;442145;46.9;23.6
69;2021-06-17;11454;13255;891435;455400;47.5;24.3
69;2021-06-18;12044;14769;903479;470169;48.2;25.1
69;2021-06-19;6813;8354;910292;478523;48.5;25.5
69;2021-06-20;5274;4769;915566;483292;48.8;25.8
69;2021-06-21;6536;12118;922102;495410;49.2;26.4
69;2021-06-22;7210;13824;929312;509234;49.5;27.1
69;2021-06-23;8348;13026;937660;522260;50.0;27.8
69;2021-06-24;9294;13741;946954;536001;50.5;28.6
69;2021-06-25;7079;16306;954033;552307;50.9;29.4
69;2021-06-26;3871;9070;957904;561377;51.1;29.9
69;2021-06-27;3291;7420;961195;568797;51.2;30.3
69;2021-06-28;4550;14891;965745;583688;51.5;31.1
69;2021-06-29;5369;15666;971114;599354;51.8;31.9
69;2021-06-30;6387;14447;977501;613801;52.1;32.7
69;2021-07-01;9012;11978;986513;625779;52.6;33.4
69;2021-07-02;10686;14127;997199;639906;53.2;34.1
69;2021-07-03;5993;7770;1003192;647676;53.5;34.5
69;2021-07-04;4126;5550;1007318;653226;53.7;34.8
69;2021-07-05;6229;13020;1013547;666246;54.0;35.5
69;2021-07-06;5914;14276;1019461;680522;54.3;36.3
69;2021-07-07;7316;13560;1026777;694082;54.7;37.0
69;2021-07-08;7587;13409;1034364;707491;55.1;37.7
69;2021-07-09;7583;16470;1041947;723961;55.5;38.6
69;2021-07-10;3124;10312;1045071;734273;55.7;39.1
69;2021-07-11;4331;5830;1049402;740103;55.9;39.5
69;2021-07-12;4212;16969;1053614;757072;56.2;40.4
69;2021-07-13;6451;20717;1060065;777789;56.5;41.5
69;2021-07-14;5056;8483;1065121;786272;56.8;41.9
69;2021-07-15;7494;22575;1072615;808847;57.2;43.1
69;2021-07-16;9962;20109;1082577;828956;57.7;44.2
69;2021-07-17;4882;12237;1087459;841193;58.0;44.8
69;2021-07-18;3411;8894;1090870;850087;58.1;45.3
69;2021-07-19;7067;16456;1097937;866543;58.5;46.2
69;2021-07-20;9578;19305;1107515;885848;59.0;47.2
69;2021-07-21;9386;17420;1116901;903268;59.5;48.1
69;2021-07-22;11469;16393;1128370;919661;60.1;49.0
69;2021-07-23;11138;17685;1139508;937346;60.7;50.0
69;2021-07-24;5705;11049;1145213;948395;61.0;50.6
69;2021-07-25;4706;6631;1149919;955026;61.3;50.9
69;2021-07-26;8927;12949;1158846;967975;61.8;51.6
69;2021-07-27;12938;12093;1171784;980068;62.5;52.2
69;2021-07-28;12090;12155;1183874;992223;63.1;52.9
69;2021-07-29;14760;12264;1198634;1004487;63.9;53.5
69;2021-07-30;14367;12242;1213001;1016729;64.7;54.2
69;2021-07-31;8269;7254;1221270;1023983;65.1;54.6
69;2021-08-01;5183;5878;1226453;1029861;65.4;54.9
69;2021-08-02;13233;9637;1239686;1039498;66.1;55.4
69;2021-08-03;13284;8983;1252970;1048481;66.8;55.9
69;2021-08-04;14344;8138;1267314;1056619;67.6;56.3
69;2021-08-05;11522;7538;1278836;1064157;68.2;56.7
69;2021-08-06;10590;7798;1289426;1071955;68.7;57.1
69;2021-08-07;5004;4811;1294430;1076766;69.0;57.4
69;2021-08-08;4370;3564;1298800;1080330;69.2;57.6
69;2021-08-09;7776;9219;1306576;1089549;69.6;58.1
69;2021-08-10;8081;7036;1314657;1096585;70.1;58.5
69;2021-08-11;7898;8113;1322555;1104698;70.5;58.9
69;2021-08-12;7313;7331;1329868;1112029;70.9;59.3
69;2021-08-13;6738;8358;1336606;1120387;71.2;59.7
69;2021-08-14;4511;5210;1341117;1125597;71.5;60.0
69;2021-08-15;2489;2522;1343606;1128119;71.6;60.1
69;2021-08-16;5931;8881;1349537;1137000;71.9;60.6
69;2021-08-17;6418;8274;1355955;1145274;72.3;61.0
69;2021-08-18;6248;9472;1362203;1154746;72.6;61.6
69;2021-08-19;6334;9335;1368537;1164081;72.9;62.0
69;2021-08-20;6147;8843;1374684;1172924;73.3;62.5
69;2021-08-21;2861;3956;1377545;1176880;73.4;62.7
69;2021-08-22;1963;2420;1379508;1179300;73.5;62.9
69;2021-08-23;3940;12384;1383448;1191684;73.7;63.5
69;2021-08-24;5183;13641;1388631;1205325;74.0;64.2
69;2021-08-25;4551;12907;1393182;1218232;74.3;64.9
69;2021-08-26;4548;11736;1397730;1229968;74.5;65.6
69;2021-08-27;4296;14451;1402026;1244419;74.7;66.3
69;2021-08-28;1961;8632;1403987;1253051;74.8;66.8
69;2021-08-29;1327;6527;1405314;1259578;74.9;67.1
69;2021-08-30;3254;11814;1408568;1271392;75.1;67.8
69;2021-08-31;4173;10192;1412741;1281584;75.3;68.3
69;2021-09-01;4033;9790;1416774;1291374;75.5;68.8
69;2021-09-02;4249;9244;1421023;1300618;75.7;69.3
69;2021-09-03;3947;11256;1424970;1311874;76.0;69.9
69;2021-09-04;2211;8716;1427181;1320590;76.1;70.4
69;2021-09-05;1418;3854;1428599;1324444;76.1;70.6
69;2021-09-06;2209;6915;1430808;1331359;76.3;71.0
69;2021-09-07;2317;6982;1433125;1338341;76.4;71.3
69;2021-09-08;2642;7510;1435767;1345851;76.5;71.7
69;2021-09-09;2361;6770;1438128;1352621;76.7;72.1
69;2021-09-10;2572;7622;1440700;1360243;76.8;72.5
69;2021-09-11;1619;5279;1442319;1365522;76.9;72.8
69;2021-09-12;508;2339;1442827;1367861;76.9;72.9
69;2021-09-13;1609;5469;1444436;1373330;77.0;73.2
69;2021-09-14;1791;5517;1446227;1378847;77.1;73.5
69;2021-09-15;1834;5048;1448061;1383895;77.2;73.8
69;2021-09-16;1506;3484;1449567;1387379;77.3;74.0
69;2021-09-17;1767;4882;1451334;1392261;77.4;74.2
69;2021-09-18;1094;4087;1452428;1396348;77.4;74.4
69;2021-09-19;478;1524;1452906;1397872;77.4;74.5
69;2021-09-20;936;2986;1453842;1400858;77.5;74.7
69;2021-09-21;974;3513;1454816;1404371;77.5;74.9
69;2021-09-22;1143;4068;1455959;1408439;77.6;75.1
69;2021-09-23;899;3063;1456858;1411502;77.7;75.2
69;2021-09-24;1238;4179;1458096;1415681;77.7;75.5
69;2021-09-25;707;2723;1458803;1418404;77.8;75.6
69;2021-09-26;291;1212;1459094;1419616;77.8;75.7
69;2021-09-27;657;2032;1459751;1421648;77.8;75.8
69;2021-09-28;913;2096;1460664;1423744;77.9;75.9
69;2021-09-29;1133;3285;1461797;1427029;77.9;76.1
69;2021-09-30;927;2356;1462724;1429385;78.0;76.2
69;2021-10-01;1475;3511;1464199;1432896;78.0;76.4
69;2021-10-02;935;2256;1465134;1435152;78.1;76.5
69;2021-10-03;316;646;1465450;1435798;78.1;76.5
70;2020-12-27;0;0;0;0;0.0;0.0
70;2020-12-28;0;0;0;0;0.0;0.0
70;2020-12-29;0;0;0;0;0.0;0.0
70;2020-12-30;0;0;0;0;0.0;0.0
70;2020-12-31;0;0;0;0;0.0;0.0
70;2021-01-01;0;0;0;0;0.0;0.0
70;2021-01-02;0;0;0;0;0.0;0.0
70;2021-01-03;0;0;0;0;0.0;0.0
70;2021-01-04;0;0;0;0;0.0;0.0
70;2021-01-05;1;0;1;0;0.0;0.0
70;2021-01-06;24;0;25;0;0.0;0.0
70;2021-01-07;121;0;146;0;0.1;0.0
70;2021-01-08;22;0;168;0;0.1;0.0
70;2021-01-09;0;0;168;0;0.1;0.0
70;2021-01-10;0;0;168;0;0.1;0.0
70;2021-01-11;148;1;316;1;0.1;0.0
70;2021-01-12;201;1;517;2;0.2;0.0
70;2021-01-13;172;2;689;4;0.3;0.0
70;2021-01-14;148;5;837;9;0.4;0.0
70;2021-01-15;153;1;990;10;0.4;0.0
70;2021-01-16;65;0;1055;10;0.5;0.0
70;2021-01-17;0;0;1055;10;0.5;0.0
70;2021-01-18;398;0;1453;10;0.6;0.0
70;2021-01-19;503;2;1956;12;0.8;0.0
70;2021-01-20;494;2;2450;14;1.1;0.0
70;2021-01-21;675;2;3125;16;1.3;0.0
70;2021-01-22;458;2;3583;18;1.5;0.0
70;2021-01-23;261;2;3844;20;1.6;0.0
70;2021-01-24;4;0;3848;20;1.7;0.0
70;2021-01-25;369;1;4217;21;1.8;0.0
70;2021-01-26;335;1;4552;22;2.0;0.0
70;2021-01-27;331;10;4883;32;2.1;0.0
70;2021-01-28;366;35;5249;67;2.3;0.0
70;2021-01-29;329;52;5578;119;2.4;0.1
70;2021-01-30;228;0;5806;119;2.5;0.1
70;2021-01-31;0;0;5806;119;2.5;0.1
70;2021-02-01;261;32;6067;151;2.6;0.1
70;2021-02-02;272;92;6339;243;2.7;0.1
70;2021-02-03;251;54;6590;297;2.8;0.1
70;2021-02-04;265;120;6855;417;2.9;0.2
70;2021-02-05;254;72;7109;489;3.0;0.2
70;2021-02-06;209;37;7318;526;3.1;0.2
70;2021-02-07;0;0;7318;526;3.1;0.2
70;2021-02-08;179;150;7497;676;3.2;0.3
70;2021-02-09;206;140;7703;816;3.3;0.3
70;2021-02-10;196;216;7899;1032;3.4;0.4
70;2021-02-11;351;270;8250;1302;3.5;0.6
70;2021-02-12;239;406;8489;1708;3.6;0.7
70;2021-02-13;75;145;8564;1853;3.7;0.8
70;2021-02-14;0;29;8564;1882;3.7;0.8
70;2021-02-15;70;271;8634;2153;3.7;0.9
70;2021-02-16;113;279;8747;2432;3.8;1.0
70;2021-02-17;164;272;8911;2704;3.8;1.2
70;2021-02-18;205;225;9116;2929;3.9;1.3
70;2021-02-19;197;180;9313;3109;4.0;1.3
70;2021-02-20;192;56;9505;3165;4.1;1.4
70;2021-02-21;1;0;9506;3165;4.1;1.4
70;2021-02-22;106;181;9612;3346;4.1;1.4
70;2021-02-23;125;206;9737;3552;4.2;1.5
70;2021-02-24;132;178;9869;3730;4.2;1.6
70;2021-02-25;315;199;10184;3929;4.4;1.7
70;2021-02-26;395;122;10579;4051;4.5;1.7
70;2021-02-27;147;146;10726;4197;4.6;1.8
70;2021-02-28;0;0;10726;4197;4.6;1.8
70;2021-03-01;249;206;10975;4403;4.7;1.9
70;2021-03-02;487;232;11462;4635;4.9;2.0
70;2021-03-03;468;219;11930;4854;5.1;2.1
70;2021-03-04;693;236;12623;5090;5.4;2.2
70;2021-03-05;767;225;13390;5315;5.7;2.3
70;2021-03-06;539;99;13929;5414;6.0;2.3
70;2021-03-07;216;23;14145;5437;6.1;2.3
70;2021-03-08;554;194;14699;5631;6.3;2.4
70;2021-03-09;864;165;15563;5796;6.7;2.5
70;2021-03-10;659;171;16222;5967;7.0;2.6
70;2021-03-11;698;244;16920;6211;7.3;2.7
70;2021-03-12;985;173;17905;6384;7.7;2.7
70;2021-03-13;583;117;18488;6501;7.9;2.8
70;2021-03-14;20;1;18508;6502;7.9;2.8
70;2021-03-15;774;104;19282;6606;8.3;2.8
70;2021-03-16;655;97;19937;6703;8.5;2.9
70;2021-03-17;595;179;20532;6882;8.8;3.0
70;2021-03-18;633;138;21165;7020;9.1;3.0
70;2021-03-19;1019;139;22184;7159;9.5;3.1
70;2021-03-20;641;186;22825;7345;9.8;3.1
70;2021-03-21;9;0;22834;7345;9.8;3.1
70;2021-03-22;757;98;23591;7443;10.1;3.2
70;2021-03-23;1310;155;24901;7598;10.7;3.3
70;2021-03-24;1270;106;26171;7704;11.2;3.3
70;2021-03-25;1247;198;27418;7902;11.8;3.4
70;2021-03-26;1485;300;28903;8202;12.4;3.5
70;2021-03-27;957;128;29860;8330;12.8;3.6
70;2021-03-28;0;10;29860;8340;12.8;3.6
70;2021-03-29;721;413;30581;8753;13.1;3.8
70;2021-03-30;1093;315;31674;9068;13.6;3.9
70;2021-03-31;878;317;32552;9385;14.0;4.0
70;2021-04-01;1153;428;33705;9813;14.5;4.2
70;2021-04-02;1310;345;35015;10158;15.0;4.4
70;2021-04-03;639;320;35654;10478;15.3;4.5
70;2021-04-04;11;0;35665;10478;15.3;4.5
70;2021-04-05;4;2;35669;10480;15.3;4.5
70;2021-04-06;831;555;36500;11035;15.7;4.7
70;2021-04-07;858;588;37358;11623;16.0;5.0
70;2021-04-08;1319;561;38677;12184;16.6;5.2
70;2021-04-09;1402;537;40079;12721;17.2;5.5
70;2021-04-10;859;346;40938;13067;17.6;5.6
70;2021-04-11;23;1;40961;13068;17.6;5.6
70;2021-04-12;696;660;41657;13728;17.9;5.9
70;2021-04-13;921;769;42578;14497;18.3;6.2
70;2021-04-14;816;576;43394;15073;18.6;6.5
70;2021-04-15;1079;604;44473;15677;19.1;6.7
70;2021-04-16;1242;551;45715;16228;19.6;7.0
70;2021-04-17;689;468;46404;16696;19.9;7.2
70;2021-04-18;62;4;46466;16700;19.9;7.2
70;2021-04-19;540;809;47006;17509;20.2;7.5
70;2021-04-20;663;852;47669;18361;20.4;7.9
70;2021-04-21;483;926;48152;19287;20.6;8.3
70;2021-04-22;775;801;48927;20088;21.0;8.6
70;2021-04-23;875;740;49802;20828;21.4;8.9
70;2021-04-24;432;642;50234;21470;21.5;9.2
70;2021-04-25;11;0;50245;21470;21.5;9.2
70;2021-04-26;923;604;51168;22074;21.9;9.5
70;2021-04-27;1208;753;52376;22827;22.5;9.8
70;2021-04-28;889;811;53265;23638;22.8;10.1
70;2021-04-29;1342;927;54607;24565;23.4;10.5
70;2021-04-30;1533;871;56140;25436;24.1;10.9
70;2021-05-01;1694;120;57834;25556;24.8;11.0
70;2021-05-02;2;0;57836;25556;24.8;11.0
70;2021-05-03;1189;580;59025;26136;25.3;11.2
70;2021-05-04;1353;754;60378;26890;25.9;11.5
70;2021-05-05;1188;879;61566;27769;26.4;11.9
70;2021-05-06;1845;1270;63411;29039;27.2;12.5
70;2021-05-07;2127;1239;65538;30278;28.1;13.0
70;2021-05-08;1342;194;66880;30472;28.7;13.1
70;2021-05-09;9;57;66889;30529;28.7;13.1
70;2021-05-10;961;946;67850;31475;29.1;13.5
70;2021-05-11;1240;1076;69090;32551;29.6;14.0
70;2021-05-12;1175;862;70265;33413;30.1;14.3
70;2021-05-13;1544;147;71809;33560;30.8;14.4
70;2021-05-14;2062;754;73871;34314;31.7;14.7
70;2021-05-15;2657;531;76528;34845;32.8;14.9
70;2021-05-16;999;72;77527;34917;33.2;15.0
70;2021-05-17;1237;386;78764;35303;33.8;15.1
70;2021-05-18;1296;591;80060;35894;34.3;15.4
70;2021-05-19;1476;480;81536;36374;35.0;15.6
70;2021-05-20;1779;630;83315;37004;35.7;15.9
70;2021-05-21;1692;817;85007;37821;36.5;16.2
70;2021-05-22;1219;666;86226;38487;37.0;16.5
70;2021-05-23;8;14;86234;38501;37.0;16.5
70;2021-05-24;227;27;86461;38528;37.1;16.5
70;2021-05-25;837;926;87298;39454;37.4;16.9
70;2021-05-26;1048;946;88346;40400;37.9;17.3
70;2021-05-27;1263;996;89609;41396;38.4;17.8
70;2021-05-28;1546;1158;91155;42554;39.1;18.2
70;2021-05-29;1370;587;92525;43141;39.7;18.5
70;2021-05-30;1;8;92526;43149;39.7;18.5
70;2021-05-31;969;679;93495;43828;40.1;18.8
70;2021-06-01;1213;848;94708;44676;40.6;19.2
70;2021-06-02;1265;678;95973;45354;41.2;19.4
70;2021-06-03;1429;837;97402;46191;41.8;19.8
70;2021-06-04;1335;1111;98737;47302;42.3;20.3
70;2021-06-05;1024;663;99761;47965;42.8;20.6
70;2021-06-06;599;79;100360;48044;43.0;20.6
70;2021-06-07;941;848;101301;48892;43.4;21.0
70;2021-06-08;1216;1187;102517;50079;44.0;21.5
70;2021-06-09;1156;988;103673;51067;44.5;21.9
70;2021-06-10;1567;831;105240;51898;45.1;22.3
70;2021-06-11;1585;1957;106825;53855;45.8;23.1
70;2021-06-12;829;1970;107654;55825;46.2;23.9
70;2021-06-13;143;15;107797;55840;46.2;23.9
70;2021-06-14;559;1243;108356;57083;46.5;24.5
70;2021-06-15;451;1506;108807;58589;46.7;25.1
70;2021-06-16;798;1391;109605;59980;47.0;25.7
70;2021-06-17;1154;2097;110759;62077;47.5;26.6
70;2021-06-18;995;2254;111754;64331;47.9;27.6
70;2021-06-19;1091;1639;112845;65970;48.4;28.3
70;2021-06-20;1;3;112846;65973;48.4;28.3
70;2021-06-21;691;1451;113537;67424;48.7;28.9
70;2021-06-22;655;1513;114192;68937;49.0;29.6
70;2021-06-23;662;1569;114854;70506;49.3;30.2
70;2021-06-24;877;2049;115731;72555;49.6;31.1
70;2021-06-25;681;2648;116412;75203;49.9;32.2
70;2021-06-26;942;2134;117354;77337;50.3;33.2
70;2021-06-27;141;763;117495;78100;50.4;33.5
70;2021-06-28;335;1352;117830;79452;50.5;34.1
70;2021-06-29;411;1610;118241;81062;50.7;34.8
70;2021-06-30;390;1633;118631;82695;50.9;35.5
70;2021-07-01;642;1751;119273;84446;51.1;36.2
70;2021-07-02;815;1576;120088;86022;51.5;36.9
70;2021-07-03;841;1084;120929;87106;51.9;37.4
70;2021-07-04;29;70;120958;87176;51.9;37.4
70;2021-07-05;610;1037;121568;88213;52.1;37.8
70;2021-07-06;681;1273;122249;89486;52.4;38.4
70;2021-07-07;508;1425;122757;90911;52.6;39.0
70;2021-07-08;817;1574;123574;92485;53.0;39.7
70;2021-07-09;872;1662;124446;94147;53.4;40.4
70;2021-07-10;831;1033;125277;95180;53.7;40.8
70;2021-07-11;7;20;125284;95200;53.7;40.8
70;2021-07-12;432;1391;125716;96591;53.9;41.4
70;2021-07-13;907;1867;126623;98458;54.3;42.2
70;2021-07-14;33;6;126656;98464;54.3;42.2
70;2021-07-15;1382;1690;128038;100154;54.9;42.9
70;2021-07-16;1632;2056;129670;102210;55.6;43.8
70;2021-07-17;1501;1454;131171;103664;56.2;44.5
70;2021-07-18;1145;641;132316;104305;56.7;44.7
70;2021-07-19;883;976;133199;105281;57.1;45.1
70;2021-07-20;1349;1352;134548;106633;57.7;45.7
70;2021-07-21;1286;1402;135834;108035;58.2;46.3
70;2021-07-22;1867;1827;137701;109862;59.0;47.1
70;2021-07-23;1826;2491;139527;112353;59.8;48.2
70;2021-07-24;1364;1806;140891;114159;60.4;49.0
70;2021-07-25;27;3;140918;114162;60.4;49.0
70;2021-07-26;1055;975;141973;115137;60.9;49.4
70;2021-07-27;1398;976;143371;116113;61.5;49.8
70;2021-07-28;1404;1162;144775;117275;62.1;50.3
70;2021-07-29;1873;1387;146648;118662;62.9;50.9
70;2021-07-30;1974;1347;148622;120009;63.7;51.5
70;2021-07-31;1751;1166;150373;121175;64.5;52.0
70;2021-08-01;2;4;150375;121179;64.5;52.0
70;2021-08-02;775;737;151150;121916;64.8;52.3
70;2021-08-03;1296;1037;152446;122953;65.4;52.7
70;2021-08-04;1210;922;153656;123875;65.9;53.1
70;2021-08-05;1657;1191;155313;125066;66.6;53.6
70;2021-08-06;1796;1335;157109;126401;67.4;54.2
70;2021-08-07;1192;1030;158301;127431;67.9;54.6
70;2021-08-08;35;28;158336;127459;67.9;54.7
70;2021-08-09;533;704;158869;128163;68.1;55.0
70;2021-08-10;898;1131;159767;129294;68.5;55.4
70;2021-08-11;808;722;160575;130016;68.9;55.8
70;2021-08-12;906;1271;161481;131287;69.2;56.3
70;2021-08-13;1040;1622;162521;132909;69.7;57.0
70;2021-08-14;771;976;163292;133885;70.0;57.4
70;2021-08-15;36;28;163328;133913;70.0;57.4
70;2021-08-16;545;909;163873;134822;70.3;57.8
70;2021-08-17;680;1194;164553;136016;70.6;58.3
70;2021-08-18;536;939;165089;136955;70.8;58.7
70;2021-08-19;565;1385;165654;138340;71.0;59.3
70;2021-08-20;510;1899;166164;140239;71.3;60.1
70;2021-08-21;447;1163;166611;141402;71.4;60.6
70;2021-08-22;2;6;166613;141408;71.4;60.6
70;2021-08-23;283;879;166896;142287;71.6;61.0
70;2021-08-24;386;1373;167282;143660;71.7;61.6
70;2021-08-25;354;1343;167636;145003;71.9;62.2
70;2021-08-26;439;1560;168075;146563;72.1;62.9
70;2021-08-27;392;2127;168467;148690;72.2;63.8
70;2021-08-28;367;1706;168834;150396;72.4;64.5
70;2021-08-29;12;6;168846;150402;72.4;64.5
70;2021-08-30;298;835;169144;151237;72.5;64.9
70;2021-08-31;360;1130;169504;152367;72.7;65.3
70;2021-09-01;314;1195;169818;153562;72.8;65.9
70;2021-09-02;303;1296;170121;154858;73.0;66.4
70;2021-09-03;280;1245;170401;156103;73.1;66.9
70;2021-09-04;454;1263;170855;157366;73.3;67.5
70;2021-09-05;21;31;170876;157397;73.3;67.5
70;2021-09-06;167;702;171043;158099;73.3;67.8
70;2021-09-07;186;880;171229;158979;73.4;68.2
70;2021-09-08;193;877;171422;159856;73.5;68.6
70;2021-09-09;180;862;171602;160718;73.6;68.9
70;2021-09-10;254;914;171856;161632;73.7;69.3
70;2021-09-11;292;975;172148;162607;73.8;69.7
70;2021-09-12;7;37;172155;162644;73.8;69.7
70;2021-09-13;153;442;172308;163086;73.9;69.9
70;2021-09-14;314;565;172622;163651;74.0;70.2
70;2021-09-15;171;532;172793;164183;74.1;70.4
70;2021-09-16;250;391;173043;164574;74.2;70.6
70;2021-09-17;194;456;173237;165030;74.3;70.8
70;2021-09-18;177;459;173414;165489;74.4;71.0
70;2021-09-19;3;14;173417;165503;74.4;71.0
70;2021-09-20;82;215;173499;165718;74.4;71.1
70;2021-09-21;163;279;173662;165997;74.5;71.2
70;2021-09-22;113;383;173775;166380;74.5;71.3
70;2021-09-23;66;229;173841;166609;74.5;71.4
70;2021-09-24;196;389;174037;166998;74.6;71.6
70;2021-09-25;139;504;174176;167502;74.7;71.8
70;2021-09-26;0;1;174176;167503;74.7;71.8
70;2021-09-27;51;201;174227;167704;74.7;71.9
70;2021-09-28;77;196;174304;167900;74.7;72.0
70;2021-09-29;91;240;174395;168140;74.8;72.1
70;2021-09-30;81;158;174476;168298;74.8;72.2
70;2021-10-01;118;249;174594;168547;74.9;72.3
70;2021-10-02;115;326;174709;168873;74.9;72.4
70;2021-10-03;1;1;174710;168874;74.9;72.4
71;2020-12-27;0;0;0;0;0.0;0.0
71;2020-12-28;1;0;1;0;0.0;0.0
71;2020-12-29;0;0;1;0;0.0;0.0
71;2020-12-30;0;0;1;0;0.0;0.0
71;2020-12-31;0;0;1;0;0.0;0.0
71;2021-01-01;1;0;2;0;0.0;0.0
71;2021-01-02;0;0;2;0;0.0;0.0
71;2021-01-03;2;0;4;0;0.0;0.0
71;2021-01-04;1;0;5;0;0.0;0.0
71;2021-01-05;13;0;18;0;0.0;0.0
71;2021-01-06;72;0;90;0;0.0;0.0
71;2021-01-07;67;0;157;0;0.0;0.0
71;2021-01-08;146;0;303;0;0.1;0.0
71;2021-01-09;117;0;420;0;0.1;0.0
71;2021-01-10;1;0;421;0;0.1;0.0
71;2021-01-11;245;1;666;1;0.1;0.0
71;2021-01-12;845;1;1511;2;0.3;0.0
71;2021-01-13;564;2;2075;4;0.4;0.0
71;2021-01-14;591;9;2666;13;0.5;0.0
71;2021-01-15;665;2;3331;15;0.6;0.0
71;2021-01-16;10;0;3341;15;0.6;0.0
71;2021-01-17;0;0;3341;15;0.6;0.0
71;2021-01-18;1095;7;4436;22;0.8;0.0
71;2021-01-19;1694;7;6130;29;1.1;0.0
71;2021-01-20;1517;6;7647;35;1.4;0.0
71;2021-01-21;2061;15;9708;50;1.8;0.0
71;2021-01-22;1414;6;11122;56;2.0;0.0
71;2021-01-23;815;6;11937;62;2.2;0.0
71;2021-01-24;1;0;11938;62;2.2;0.0
71;2021-01-25;1065;6;13003;68;2.4;0.0
71;2021-01-26;1505;25;14508;93;2.6;0.0
71;2021-01-27;1249;33;15757;126;2.9;0.0
71;2021-01-28;1083;78;16840;204;3.1;0.0
71;2021-01-29;1016;132;17856;336;3.3;0.1
71;2021-01-30;604;1;18460;337;3.4;0.1
71;2021-01-31;1;14;18461;351;3.4;0.1
71;2021-02-01;752;226;19213;577;3.5;0.1
71;2021-02-02;754;337;19967;914;3.6;0.2
71;2021-02-03;817;395;20784;1309;3.8;0.2
71;2021-02-04;784;540;21568;1849;3.9;0.3
71;2021-02-05;704;477;22272;2326;4.1;0.4
71;2021-02-06;539;8;22811;2334;4.2;0.4
71;2021-02-07;4;49;22815;2383;4.2;0.4
71;2021-02-08;603;501;23418;2884;4.3;0.5
71;2021-02-09;370;805;23788;3689;4.3;0.7
71;2021-02-10;411;781;24199;4470;4.4;0.8
71;2021-02-11;475;943;24674;5413;4.5;1.0
71;2021-02-12;535;843;25209;6256;4.6;1.1
71;2021-02-13;124;353;25333;6609;4.6;1.2
71;2021-02-14;2;7;25335;6616;4.6;1.2
71;2021-02-15;322;701;25657;7317;4.7;1.3
71;2021-02-16;445;1085;26102;8402;4.8;1.5
71;2021-02-17;427;968;26529;9370;4.8;1.7
71;2021-02-18;548;755;27077;10125;4.9;1.8
71;2021-02-19;571;662;27648;10787;5.0;2.0
71;2021-02-20;224;283;27872;11070;5.1;2.0
71;2021-02-21;4;13;27876;11083;5.1;2.0
71;2021-02-22;237;731;28113;11814;5.1;2.2
71;2021-02-23;452;783;28565;12597;5.2;2.3
71;2021-02-24;446;572;29011;13169;5.3;2.4
71;2021-02-25;533;596;29544;13765;5.4;2.5
71;2021-02-26;831;476;30375;14241;5.5;2.6
71;2021-02-27;456;262;30831;14503;5.6;2.6
71;2021-02-28;54;14;30885;14517;5.6;2.6
71;2021-03-01;1187;558;32072;15075;5.9;2.8
71;2021-03-02;1574;541;33646;15616;6.1;2.9
71;2021-03-03;1819;684;35465;16300;6.5;3.0
71;2021-03-04;2001;721;37466;17021;6.8;3.1
71;2021-03-05;2288;610;39754;17631;7.3;3.2
71;2021-03-06;754;61;40508;17692;7.4;3.2
71;2021-03-07;40;20;40548;17712;7.4;3.2
71;2021-03-08;1454;712;42002;18424;7.7;3.4
71;2021-03-09;2160;485;44162;18909;8.1;3.5
71;2021-03-10;2173;449;46335;19358;8.5;3.5
71;2021-03-11;2630;643;48965;20001;8.9;3.7
71;2021-03-12;2603;591;51568;20592;9.4;3.8
71;2021-03-13;995;94;52563;20686;9.6;3.8
71;2021-03-14;36;0;52599;20686;9.6;3.8
71;2021-03-15;1797;489;54396;21175;9.9;3.9
71;2021-03-16;1821;201;56217;21376;10.3;3.9
71;2021-03-17;2135;248;58352;21624;10.7;3.9
71;2021-03-18;1954;430;60306;22054;11.0;4.0
71;2021-03-19;2370;334;62676;22388;11.4;4.1
71;2021-03-20;1083;40;63759;22428;11.6;4.1
71;2021-03-21;17;5;63776;22433;11.6;4.1
71;2021-03-22;2576;381;66352;22814;12.1;4.2
71;2021-03-23;3346;502;69698;23316;12.7;4.3
71;2021-03-24;3349;469;73047;23785;13.3;4.3
71;2021-03-25;4029;597;77076;24382;14.1;4.5
71;2021-03-26;4057;339;81133;24721;14.8;4.5
71;2021-03-27;997;107;82130;24828;15.0;4.5
71;2021-03-28;57;8;82187;24836;15.0;4.5
71;2021-03-29;2409;1161;84596;25997;15.4;4.7
71;2021-03-30;2948;1351;87544;27348;16.0;5.0
71;2021-03-31;2546;1519;90090;28867;16.4;5.3
71;2021-04-01;2717;1298;92807;30165;16.9;5.5
71;2021-04-02;2501;1415;95308;31580;17.4;5.8
71;2021-04-03;268;34;95576;31614;17.4;5.8
71;2021-04-04;6;0;95582;31614;17.4;5.8
71;2021-04-05;61;2;95643;31616;17.5;5.8
71;2021-04-06;2257;1877;97900;33493;17.9;6.1
71;2021-04-07;2388;1782;100288;35275;18.3;6.4
71;2021-04-08;3283;1801;103571;37076;18.9;6.8
71;2021-04-09;4040;1662;107611;38738;19.6;7.1
71;2021-04-10;769;47;108380;38785;19.8;7.1
71;2021-04-11;97;4;108477;38789;19.8;7.1
71;2021-04-12;2352;1694;110829;40483;20.2;7.4
71;2021-04-13;2583;1882;113412;42365;20.7;7.7
71;2021-04-14;2375;1918;115787;44283;21.1;8.1
71;2021-04-15;2779;1690;118566;45973;21.6;8.4
71;2021-04-16;2628;1647;121194;47620;22.1;8.7
71;2021-04-17;952;344;122146;47964;22.3;8.8
71;2021-04-18;106;6;122252;47970;22.3;8.8
71;2021-04-19;1758;2564;124010;50534;22.6;9.2
71;2021-04-20;2220;2599;126230;53133;23.0;9.7
71;2021-04-21;2123;2590;128353;55723;23.4;10.2
71;2021-04-22;2511;2441;130864;58164;23.9;10.6
71;2021-04-23;2922;2265;133786;60429;24.4;11.0
71;2021-04-24;517;52;134303;60481;24.5;11.0
71;2021-04-25;26;0;134329;60481;24.5;11.0
71;2021-04-26;2565;2136;136894;62617;25.0;11.4
71;2021-04-27;2990;2266;139884;64883;25.5;11.8
71;2021-04-28;3073;2123;142957;67006;26.1;12.2
71;2021-04-29;3780;2203;146737;69209;26.8;12.6
71;2021-04-30;3926;1714;150663;70923;27.5;12.9
71;2021-05-01;39;53;150702;70976;27.5;13.0
71;2021-05-02;23;18;150725;70994;27.5;13.0
71;2021-05-03;4289;1381;155014;72375;28.3;13.2
71;2021-05-04;2955;2357;157969;74732;28.8;13.6
71;2021-05-05;3426;2080;161395;76812;29.5;14.0
71;2021-05-06;3467;2360;164862;79172;30.1;14.5
71;2021-05-07;3678;2802;168540;81974;30.8;15.0
71;2021-05-08;179;183;168719;82157;30.8;15.0
71;2021-05-09;44;47;168763;82204;30.8;15.0
71;2021-05-10;3696;2285;172459;84489;31.5;15.4
71;2021-05-11;4663;2359;177122;86848;32.3;15.9
71;2021-05-12;3978;2594;181100;89442;33.1;16.3
71;2021-05-13;1576;155;182676;89597;33.3;16.4
71;2021-05-14;3766;2194;186442;91791;34.0;16.8
71;2021-05-15;243;330;186685;92121;34.1;16.8
71;2021-05-16;2;0;186687;92121;34.1;16.8
71;2021-05-17;3864;1887;190551;94008;34.8;17.2
71;2021-05-18;3498;2425;194049;96433;35.4;17.6
71;2021-05-19;3719;2278;197768;98711;36.1;18.0
71;2021-05-20;4184;2286;201952;100997;36.9;18.4
71;2021-05-21;3721;2560;205673;103557;37.5;18.9
71;2021-05-22;169;304;205842;103861;37.6;19.0
71;2021-05-23;14;55;205856;103916;37.6;19.0
71;2021-05-24;21;96;205877;104012;37.6;19.0
71;2021-05-25;2689;3003;208566;107015;38.1;19.5
71;2021-05-26;2972;2432;211538;109447;38.6;20.0
71;2021-05-27;3387;2589;214925;112036;39.2;20.5
71;2021-05-28;2919;3149;217844;115185;39.8;21.0
71;2021-05-29;482;656;218326;115841;39.9;21.1
71;2021-05-30;76;58;218402;115899;39.9;21.2
71;2021-05-31;2774;3449;221176;119348;40.4;21.8
71;2021-06-01;3671;3538;224847;122886;41.0;22.4
71;2021-06-02;3997;2631;228844;125517;41.8;22.9
71;2021-06-03;4435;2521;233279;128038;42.6;23.4
71;2021-06-04;3716;3701;236995;131739;43.3;24.0
71;2021-06-05;684;647;237679;132386;43.4;24.2
71;2021-06-06;57;91;237736;132477;43.4;24.2
71;2021-06-07;3281;4150;241017;136627;44.0;24.9
71;2021-06-08;3894;4010;244911;140637;44.7;25.7
71;2021-06-09;4694;2752;249605;143389;45.6;26.2
71;2021-06-10;5265;2745;254870;146134;46.5;26.7
71;2021-06-11;4434;3721;259304;149855;47.3;27.4
71;2021-06-12;715;593;260019;150448;47.5;27.5
71;2021-06-13;104;187;260123;150635;47.5;27.5
71;2021-06-14;3510;3785;263633;154420;48.1;28.2
71;2021-06-15;4205;3549;267838;157969;48.9;28.8
71;2021-06-16;4595;2731;272433;160700;49.7;29.3
71;2021-06-17;4267;2989;276700;163689;50.5;29.9
71;2021-06-18;4325;3770;281025;167459;51.3;30.6
71;2021-06-19;1269;654;282294;168113;51.5;30.7
71;2021-06-20;37;27;282331;168140;51.5;30.7
71;2021-06-21;2270;4276;284601;172416;52.0;31.5
71;2021-06-22;2689;4354;287290;176770;52.4;32.3
71;2021-06-23;3060;3420;290350;180190;53.0;32.9
71;2021-06-24;3328;3022;293678;183212;53.6;33.4
71;2021-06-25;2652;4471;296330;187683;54.1;34.3
71;2021-06-26;372;551;296702;188234;54.2;34.4
71;2021-06-27;29;67;296731;188301;54.2;34.4
71;2021-06-28;1535;4624;298266;192925;54.4;35.2
71;2021-06-29;1992;4820;300258;197745;54.8;36.1
71;2021-06-30;2503;3934;302761;201679;55.3;36.8
71;2021-07-01;2826;3899;305587;205578;55.8;37.5
71;2021-07-02;3030;3987;308617;209565;56.3;38.3
71;2021-07-03;319;712;308936;210277;56.4;38.4
71;2021-07-04;28;132;308964;210409;56.4;38.4
71;2021-07-05;2474;4323;311438;214732;56.9;39.2
71;2021-07-06;2460;4560;313898;219292;57.3;40.0
71;2021-07-07;2983;3724;316881;223016;57.8;40.7
71;2021-07-08;2766;4109;319647;227125;58.3;41.5
71;2021-07-09;2383;5022;322030;232147;58.8;42.4
71;2021-07-10;212;656;322242;232803;58.8;42.5
71;2021-07-11;15;65;322257;232868;58.8;42.5
71;2021-07-12;1911;5304;324168;238172;59.2;43.5
71;2021-07-13;2537;5863;326705;244035;59.6;44.5
71;2021-07-14;950;401;327655;244436;59.8;44.6
71;2021-07-15;3024;5733;330679;250169;60.4;45.7
71;2021-07-16;3294;6002;333973;256171;61.0;46.8
71;2021-07-17;505;779;334478;256950;61.1;46.9
71;2021-07-18;89;86;334567;257036;61.1;46.9
71;2021-07-19;2864;5551;337431;262587;61.6;47.9
71;2021-07-20;3366;5913;340797;268500;62.2;49.0
71;2021-07-21;3413;5469;344210;273969;62.8;50.0
71;2021-07-22;3945;5332;348155;279301;63.6;51.0
71;2021-07-23;3233;5999;351388;285300;64.1;52.1
71;2021-07-24;715;597;352103;285897;64.3;52.2
71;2021-07-25;148;82;352251;285979;64.3;52.2
71;2021-07-26;3597;4889;355848;290868;65.0;53.1
71;2021-07-27;4090;5122;359938;295990;65.7;54.0
71;2021-07-28;4248;4809;364186;300799;66.5;54.9
71;2021-07-29;4212;4645;368398;305444;67.2;55.8
71;2021-07-30;4241;4925;372639;310369;68.0;56.7
71;2021-07-31;722;722;373361;311091;68.2;56.8
71;2021-08-01;108;35;373469;311126;68.2;56.8
71;2021-08-02;3967;3759;377436;314885;68.9;57.5
71;2021-08-03;4408;3821;381844;318706;69.7;58.2
71;2021-08-04;4390;2983;386234;321689;70.5;58.7
71;2021-08-05;4188;3267;390422;324956;71.3;59.3
71;2021-08-06;3700;4009;394122;328965;71.9;60.0
71;2021-08-07;495;329;394617;329294;72.0;60.1
71;2021-08-08;51;65;394668;329359;72.0;60.1
71;2021-08-09;3044;3407;397712;332766;72.6;60.7
71;2021-08-10;3074;3388;400786;336154;73.2;61.4
71;2021-08-11;3186;3080;403972;339234;73.7;61.9
71;2021-08-12;3016;3106;406988;342340;74.3;62.5
71;2021-08-13;2691;3334;409679;345674;74.8;63.1
71;2021-08-14;282;518;409961;346192;74.8;63.2
71;2021-08-15;49;110;410010;346302;74.8;63.2
71;2021-08-16;1709;3527;411719;349829;75.2;63.9
71;2021-08-17;1738;3433;413457;353262;75.5;64.5
71;2021-08-18;1453;3160;414910;356422;75.7;65.1
71;2021-08-19;1275;3115;416185;359537;76.0;65.6
71;2021-08-20;1290;3698;417475;363235;76.2;66.3
71;2021-08-21;148;413;417623;363648;76.2;66.4
71;2021-08-22;40;99;417663;363747;76.2;66.4
71;2021-08-23;1427;4543;419090;368290;76.5;67.2
71;2021-08-24;1334;3804;420424;372094;76.7;67.9
71;2021-08-25;950;3773;421374;375867;76.9;68.6
71;2021-08-26;959;3393;422333;379260;77.1;69.2
71;2021-08-27;1149;4462;423482;383722;77.3;70.0
71;2021-08-28;195;413;423677;384135;77.3;70.1
71;2021-08-29;29;106;423706;384241;77.3;70.1
71;2021-08-30;1251;3940;424957;388181;77.6;70.9
71;2021-08-31;1023;3627;425980;391808;77.8;71.5
71;2021-09-01;932;3587;426912;395395;77.9;72.2
71;2021-09-02;601;3118;427513;398513;78.0;72.7
71;2021-09-03;836;4030;428349;402543;78.2;73.5
71;2021-09-04;264;587;428613;403130;78.2;73.6
71;2021-09-05;23;58;428636;403188;78.2;73.6
71;2021-09-06;638;2786;429274;405974;78.4;74.1
71;2021-09-07;516;2269;429790;408243;78.5;74.5
71;2021-09-08;719;2604;430509;410847;78.6;75.0
71;2021-09-09;455;1795;430964;412642;78.7;75.3
71;2021-09-10;814;2760;431778;415402;78.8;75.8
71;2021-09-11;199;323;431977;415725;78.9;75.9
71;2021-09-12;19;49;431996;415774;78.9;75.9
71;2021-09-13;642;1624;432638;417398;79.0;76.2
71;2021-09-14;481;1569;433119;418967;79.1;76.5
71;2021-09-15;601;1495;433720;420462;79.2;76.8
71;2021-09-16;446;821;434166;421283;79.3;76.9
71;2021-09-17;533;1436;434699;422719;79.4;77.2
71;2021-09-18;141;262;434840;422981;79.4;77.2
71;2021-09-19;9;28;434849;423009;79.4;77.2
71;2021-09-20;484;923;435333;423932;79.5;77.4
71;2021-09-21;294;711;435627;424643;79.5;77.5
71;2021-09-22;341;1377;435968;426020;79.6;77.8
71;2021-09-23;306;577;436274;426597;79.6;77.9
71;2021-09-24;366;1028;436640;427625;79.7;78.1
71;2021-09-25;71;176;436711;427801;79.7;78.1
71;2021-09-26;11;35;436722;427836;79.7;78.1
71;2021-09-27;286;757;437008;428593;79.8;78.2
71;2021-09-28;288;477;437296;429070;79.8;78.3
71;2021-09-29;332;740;437628;429810;79.9;78.5
71;2021-09-30;204;500;437832;430310;79.9;78.5
71;2021-10-01;328;892;438160;431202;80.0;78.7
71;2021-10-02;108;226;438268;431428;80.0;78.8
71;2021-10-03;3;7;438271;431435;80.0;78.8
72;2020-12-27;0;0;0;0;0.0;0.0
72;2020-12-28;0;0;0;0;0.0;0.0
72;2020-12-29;0;0;0;0;0.0;0.0
72;2020-12-30;0;0;0;0;0.0;0.0
72;2020-12-31;0;0;0;0;0.0;0.0
72;2021-01-01;2;0;2;0;0.0;0.0
72;2021-01-02;0;0;2;0;0.0;0.0
72;2021-01-03;0;0;2;0;0.0;0.0
72;2021-01-04;0;0;2;0;0.0;0.0
72;2021-01-05;14;0;16;0;0.0;0.0
72;2021-01-06;27;0;43;0;0.0;0.0
72;2021-01-07;110;0;153;0;0.0;0.0
72;2021-01-08;232;0;385;0;0.1;0.0
72;2021-01-09;36;0;421;0;0.1;0.0
72;2021-01-10;0;0;421;0;0.1;0.0
72;2021-01-11;485;1;906;1;0.2;0.0
72;2021-01-12;614;1;1520;2;0.3;0.0
72;2021-01-13;500;1;2020;3;0.4;0.0
72;2021-01-14;644;3;2664;6;0.5;0.0
72;2021-01-15;478;1;3142;7;0.6;0.0
72;2021-01-16;94;0;3236;7;0.6;0.0
72;2021-01-17;0;0;3236;7;0.6;0.0
72;2021-01-18;294;0;3530;7;0.6;0.0
72;2021-01-19;779;4;4309;11;0.8;0.0
72;2021-01-20;1539;6;5848;17;1.0;0.0
72;2021-01-21;1779;5;7627;22;1.4;0.0
72;2021-01-22;1148;5;8775;27;1.6;0.0
72;2021-01-23;32;0;8807;27;1.6;0.0
72;2021-01-24;0;0;8807;27;1.6;0.0
72;2021-01-25;503;7;9310;34;1.7;0.0
72;2021-01-26;1166;21;10476;55;1.9;0.0
72;2021-01-27;883;20;11359;75;2.0;0.0
72;2021-01-28;776;66;12135;141;2.2;0.0
72;2021-01-29;712;59;12847;200;2.3;0.0
72;2021-01-30;58;0;12905;200;2.3;0.0
72;2021-01-31;1;0;12906;200;2.3;0.0
72;2021-02-01;499;195;13405;395;2.4;0.1
72;2021-02-02;506;287;13911;682;2.5;0.1
72;2021-02-03;487;216;14398;898;2.6;0.2
72;2021-02-04;477;327;14875;1225;2.7;0.2
72;2021-02-05;514;304;15389;1529;2.7;0.3
72;2021-02-06;83;7;15472;1536;2.8;0.3
72;2021-02-07;19;1;15491;1537;2.8;0.3
72;2021-02-08;310;319;15801;1856;2.8;0.3
72;2021-02-09;488;500;16289;2356;2.9;0.4
72;2021-02-10;567;847;16856;3203;3.0;0.6
72;2021-02-11;860;1246;17716;4449;3.2;0.8
72;2021-02-12;851;564;18567;5013;3.3;0.9
72;2021-02-13;111;34;18678;5047;3.3;0.9
72;2021-02-14;1;22;18679;5069;3.3;0.9
72;2021-02-15;220;389;18899;5458;3.4;1.0
72;2021-02-16;503;935;19402;6393;3.5;1.1
72;2021-02-17;463;577;19865;6970;3.5;1.2
72;2021-02-18;595;540;20460;7510;3.7;1.3
72;2021-02-19;521;491;20981;8001;3.7;1.4
72;2021-02-20;80;50;21061;8051;3.8;1.4
72;2021-02-21;0;0;21061;8051;3.8;1.4
72;2021-02-22;329;457;21390;8508;3.8;1.5
72;2021-02-23;569;372;21959;8880;3.9;1.6
72;2021-02-24;435;408;22394;9288;4.0;1.7
72;2021-02-25;922;468;23316;9756;4.2;1.7
72;2021-02-26;599;394;23915;10150;4.3;1.8
72;2021-02-27;322;32;24237;10182;4.3;1.8
72;2021-02-28;15;17;24252;10199;4.3;1.8
72;2021-03-01;379;371;24631;10570;4.4;1.9
72;2021-03-02;502;514;25133;11084;4.5;2.0
72;2021-03-03;733;540;25866;11624;4.6;2.1
72;2021-03-04;742;672;26608;12296;4.7;2.2
72;2021-03-05;935;691;27543;12987;4.9;2.3
72;2021-03-06;761;111;28304;13098;5.1;2.3
72;2021-03-07;448;26;28752;13124;5.1;2.3
72;2021-03-08;561;393;29313;13517;5.2;2.4
72;2021-03-09;1045;558;30358;14075;5.4;2.5
72;2021-03-10;1134;613;31492;14688;5.6;2.6
72;2021-03-11;1610;427;33102;15115;5.9;2.7
72;2021-03-12;1364;480;34466;15595;6.2;2.8
72;2021-03-13;983;103;35449;15698;6.3;2.8
72;2021-03-14;14;10;35463;15708;6.3;2.8
72;2021-03-15;1159;212;36622;15920;6.5;2.8
72;2021-03-16;1052;181;37674;16101;6.7;2.9
72;2021-03-17;1035;253;38709;16354;6.9;2.9
72;2021-03-18;1089;362;39798;16716;7.1;3.0
72;2021-03-19;1276;286;41074;17002;7.3;3.0
72;2021-03-20;489;88;41563;17090;7.4;3.1
72;2021-03-21;19;0;41582;17090;7.4;3.1
72;2021-03-22;1347;340;42929;17430;7.7;3.1
72;2021-03-23;1723;472;44652;17902;8.0;3.2
72;2021-03-24;1841;297;46493;18199;8.3;3.2
72;2021-03-25;2447;459;48940;18658;8.7;3.3
72;2021-03-26;2336;365;51276;19023;9.2;3.4
72;2021-03-27;614;31;51890;19054;9.3;3.4
72;2021-03-28;22;0;51912;19054;9.3;3.4
72;2021-03-29;1616;381;53528;19435;9.6;3.5
72;2021-03-30;2496;385;56024;19820;10.0;3.5
72;2021-03-31;2145;365;58169;20185;10.4;3.6
72;2021-04-01;2849;349;61018;20534;10.9;3.7
72;2021-04-02;2248;398;63266;20932;11.3;3.7
72;2021-04-03;292;39;63558;20971;11.3;3.7
72;2021-04-04;16;3;63574;20974;11.3;3.7
72;2021-04-05;51;49;63625;21023;11.4;3.8
72;2021-04-06;1759;469;65384;21492;11.7;3.8
72;2021-04-07;2577;599;67961;22091;12.1;3.9
72;2021-04-08;2721;782;70682;22873;12.6;4.1
72;2021-04-09;3863;583;74545;23456;13.3;4.2
72;2021-04-10;1112;52;75657;23508;13.5;4.2
72;2021-04-11;8;1;75665;23509;13.5;4.2
72;2021-04-12;1846;902;77511;24411;13.8;4.4
72;2021-04-13;2372;1072;79883;25483;14.3;4.5
72;2021-04-14;2250;1096;82133;26579;14.7;4.7
72;2021-04-15;2420;1117;84553;27696;15.1;4.9
72;2021-04-16;2563;959;87116;28655;15.6;5.1
72;2021-04-17;707;144;87823;28799;15.7;5.1
72;2021-04-18;57;2;87880;28801;15.7;5.1
72;2021-04-19;1396;1089;89276;29890;15.9;5.3
72;2021-04-20;2996;1304;92272;31194;16.5;5.6
72;2021-04-21;2515;1562;94787;32756;16.9;5.8
72;2021-04-22;2814;1790;97601;34546;17.4;6.2
72;2021-04-23;3213;1457;100814;36003;18.0;6.4
72;2021-04-24;1400;268;102214;36271;18.2;6.5
72;2021-04-25;881;18;103095;36289;18.4;6.5
72;2021-04-26;3513;1474;106608;37763;19.0;6.7
72;2021-04-27;4088;1852;110696;39615;19.8;7.1
72;2021-04-28;3835;1871;114531;41486;20.4;7.4
72;2021-04-29;4161;1781;118692;43267;21.2;7.7
72;2021-04-30;3615;1705;122307;44972;21.8;8.0
72;2021-05-01;1641;225;123948;45197;22.1;8.1
72;2021-05-02;1533;161;125481;45358;22.4;8.1
72;2021-05-03;3456;1153;128937;46511;23.0;8.3
72;2021-05-04;4013;1799;132950;48310;23.7;8.6
72;2021-05-05;3866;2173;136816;50483;24.4;9.0
72;2021-05-06;3596;1929;140412;52412;25.1;9.4
72;2021-05-07;3543;2139;143955;54551;25.7;9.7
72;2021-05-08;1900;152;145855;54703;26.0;9.8
72;2021-05-09;2080;214;147935;54917;26.4;9.8
72;2021-05-10;3769;1525;151704;56442;27.1;10.1
72;2021-05-11;4597;1994;156301;58436;27.9;10.4
72;2021-05-12;4080;1817;160381;60253;28.6;10.8
72;2021-05-13;3031;273;163412;60526;29.2;10.8
72;2021-05-14;3663;1397;167075;61923;29.8;11.1
72;2021-05-15;3117;365;170192;62288;30.4;11.1
72;2021-05-16;2500;151;172692;62439;30.8;11.1
72;2021-05-17;3724;1286;176416;63725;31.5;11.4
72;2021-05-18;4330;1688;180746;65413;32.3;11.7
72;2021-05-19;3973;1510;184719;66923;33.0;11.9
72;2021-05-20;4261;1452;188980;68375;33.7;12.2
72;2021-05-21;3788;1388;192768;69763;34.4;12.5
72;2021-05-22;2561;506;195329;70269;34.9;12.5
72;2021-05-23;1391;163;196720;70432;35.1;12.6
72;2021-05-24;2352;294;199072;70726;35.5;12.6
72;2021-05-25;4077;1412;203149;72138;36.3;12.9
72;2021-05-26;4096;1413;207245;73551;37.0;13.1
72;2021-05-27;4345;2049;211590;75600;37.8;13.5
72;2021-05-28;4105;2003;215695;77603;38.5;13.9
72;2021-05-29;2668;804;218363;78407;39.0;14.0
72;2021-05-30;1142;871;219505;79278;39.2;14.2
72;2021-05-31;3122;2326;222627;81604;39.7;14.6
72;2021-06-01;3570;2669;226197;84273;40.4;15.0
72;2021-06-02;3611;2777;229808;87050;41.0;15.5
72;2021-06-03;4242;2996;234050;90046;41.8;16.1
72;2021-06-04;3891;2750;237941;92796;42.5;16.6
72;2021-06-05;1440;2567;239381;95363;42.7;17.0
72;2021-06-06;911;1541;240292;96904;42.9;17.3
72;2021-06-07;1744;3424;242036;100328;43.2;17.9
72;2021-06-08;2930;3832;244966;104160;43.7;18.6
72;2021-06-09;2646;3371;247612;107531;44.2;19.2
72;2021-06-10;2825;3316;250437;110847;44.7;19.8
72;2021-06-11;2840;3771;253277;114618;45.2;20.5
72;2021-06-12;1242;2599;254519;117217;45.4;20.9
72;2021-06-13;388;1860;254907;119077;45.5;21.3
72;2021-06-14;1336;4127;256243;123204;45.7;22.0
72;2021-06-15;2752;3507;258995;126711;46.2;22.6
72;2021-06-16;2428;3579;261423;130290;46.7;23.3
72;2021-06-17;2318;3871;263741;134161;47.1;23.9
72;2021-06-18;2310;4312;266051;138473;47.5;24.7
72;2021-06-19;1128;2762;267179;141235;47.7;25.2
72;2021-06-20;339;2055;267518;143290;47.8;25.6
72;2021-06-21;1563;4029;269081;147319;48.0;26.3
72;2021-06-22;1710;4990;270791;152309;48.3;27.2
72;2021-06-23;2008;4222;272799;156531;48.7;27.9
72;2021-06-24;2232;4012;275031;160543;49.1;28.7
72;2021-06-25;1773;4832;276804;165375;49.4;29.5
72;2021-06-26;1190;2876;277994;168251;49.6;30.0
72;2021-06-27;392;2111;278386;170362;49.7;30.4
72;2021-06-28;1439;4292;279825;174654;49.9;31.2
72;2021-06-29;1770;4740;281595;179394;50.3;32.0
72;2021-06-30;1980;4168;283575;183562;50.6;32.8
72;2021-07-01;1953;4417;285528;187979;51.0;33.6
72;2021-07-02;1853;4713;287381;192692;51.3;34.4
72;2021-07-03;1292;3123;288673;195815;51.5;35.0
72;2021-07-04;579;1948;289252;197763;51.6;35.3
72;2021-07-05;1193;4164;290445;201927;51.8;36.0
72;2021-07-06;1458;5148;291903;207075;52.1;37.0
72;2021-07-07;1582;4608;293485;211683;52.4;37.8
72;2021-07-08;1648;4324;295133;216007;52.7;38.6
72;2021-07-09;2107;4604;297240;220611;53.1;39.4
72;2021-07-10;1589;2690;298829;223301;53.3;39.9
72;2021-07-11;947;1587;299776;224888;53.5;40.1
72;2021-07-12;1592;3753;301368;228641;53.8;40.8
72;2021-07-13;2091;4774;303459;233415;54.2;41.7
72;2021-07-14;1325;2365;304784;235780;54.4;42.1
72;2021-07-15;3485;3419;308269;239199;55.0;42.7
72;2021-07-16;3175;4120;311444;243319;55.6;43.4
72;2021-07-17;2646;1758;314090;245077;56.1;43.7
72;2021-07-18;1710;824;315800;245901;56.4;43.9
72;2021-07-19;2918;3508;318718;249409;56.9;44.5
72;2021-07-20;3040;4280;321758;253689;57.4;45.3
72;2021-07-21;2884;3586;324642;257275;57.9;45.9
72;2021-07-22;3772;2911;328414;260186;58.6;46.4
72;2021-07-23;3477;3792;331891;263978;59.2;47.1
72;2021-07-24;2820;1460;334711;265438;59.7;47.4
72;2021-07-25;1453;1080;336164;266518;60.0;47.6
72;2021-07-26;2726;2918;338890;269436;60.5;48.1
72;2021-07-27;3857;3819;342747;273255;61.2;48.8
72;2021-07-28;3571;3122;346318;276377;61.8;49.3
72;2021-07-29;3572;2712;349890;279089;62.5;49.8
72;2021-07-30;3788;3382;353678;282471;63.1;50.4
72;2021-07-31;2546;1749;356224;284220;63.6;50.7
72;2021-08-01;1835;432;358059;284652;63.9;50.8
72;2021-08-02;3215;2285;361274;286937;64.5;51.2
72;2021-08-03;3236;3297;364510;290234;65.1;51.8
72;2021-08-04;3768;2551;368278;292785;65.7;52.3
72;2021-08-05;3770;2460;372048;295245;66.4;52.7
72;2021-08-06;3342;2694;375390;297939;67.0;53.2
72;2021-08-07;2347;1613;377737;299552;67.4;53.5
72;2021-08-08;1623;700;379360;300252;67.7;53.6
72;2021-08-09;2699;2668;382059;302920;68.2;54.1
72;2021-08-10;2915;2747;384974;305667;68.7;54.6
72;2021-08-11;2367;2204;387341;307871;69.1;55.0
72;2021-08-12;2380;2597;389721;310468;69.6;55.4
72;2021-08-13;2157;2295;391878;312763;69.9;55.8
72;2021-08-14;1167;1546;393045;314309;70.2;56.1
72;2021-08-15;623;614;393668;314923;70.3;56.2
72;2021-08-16;1649;2372;395317;317295;70.6;56.6
72;2021-08-17;1717;2889;397034;320184;70.9;57.2
72;2021-08-18;1709;2872;398743;323056;71.2;57.7
72;2021-08-19;1245;2914;399988;325970;71.4;58.2
72;2021-08-20;1656;3169;401644;329139;71.7;58.8
72;2021-08-21;701;2031;402345;331170;71.8;59.1
72;2021-08-22;261;1150;402606;332320;71.9;59.3
72;2021-08-23;1739;3422;404345;335742;72.2;59.9
72;2021-08-24;1531;4121;405876;339863;72.4;60.7
72;2021-08-25;1599;3451;407475;343314;72.7;61.3
72;2021-08-26;1265;4444;408740;347758;73.0;62.1
72;2021-08-27;1191;4112;409931;351870;73.2;62.8
72;2021-08-28;881;2656;410812;354526;73.3;63.3
72;2021-08-29;357;1683;411169;356209;73.4;63.6
72;2021-08-30;1130;3464;412299;359673;73.6;64.2
72;2021-08-31;1218;4015;413517;363688;73.8;64.9
72;2021-09-01;1069;3310;414586;366998;74.0;65.5
72;2021-09-02;902;3459;415488;370457;74.2;66.1
72;2021-09-03;927;3305;416415;373762;74.3;66.7
72;2021-09-04;702;2657;417117;376419;74.5;67.2
72;2021-09-05;256;1555;417373;377974;74.5;67.5
72;2021-09-06;585;2812;417958;380786;74.6;68.0
72;2021-09-07;505;2952;418463;383738;74.7;68.5
72;2021-09-08;617;3173;419080;386911;74.8;69.1
72;2021-09-09;395;2094;419475;389005;74.9;69.4
72;2021-09-10;625;2712;420100;391717;75.0;69.9
72;2021-09-11;402;2719;420502;394436;75.1;70.4
72;2021-09-12;170;954;420672;395390;75.1;70.6
72;2021-09-13;366;1615;421038;397005;75.2;70.9
72;2021-09-14;487;1663;421525;398668;75.2;71.2
72;2021-09-15;614;1995;422139;400663;75.4;71.5
72;2021-09-16;336;831;422475;401494;75.4;71.7
72;2021-09-17;442;1423;422917;402917;75.5;71.9
72;2021-09-18;355;1519;423272;404436;75.6;72.2
72;2021-09-19;89;359;423361;404795;75.6;72.3
72;2021-09-20;349;792;423710;405587;75.6;72.4
72;2021-09-21;317;784;424027;406371;75.7;72.5
72;2021-09-22;442;1526;424469;407897;75.8;72.8
72;2021-09-23;396;630;424865;408527;75.8;72.9
72;2021-09-24;601;1005;425466;409532;75.9;73.1
72;2021-09-25;259;1004;425725;410536;76.0;73.3
72;2021-09-26;73;215;425798;410751;76.0;73.3
72;2021-09-27;210;639;426008;411390;76.0;73.4
72;2021-09-28;205;427;426213;411817;76.1;73.5
72;2021-09-29;360;1012;426573;412829;76.1;73.7
72;2021-09-30;163;330;426736;413159;76.2;73.7
72;2021-10-01;287;706;427023;413865;76.2;73.9
72;2021-10-02;311;575;427334;414440;76.3;74.0
72;2021-10-03;91;160;427425;414600;76.3;74.0
73;2020-12-27;1;0;1;0;0.0;0.0
73;2020-12-28;1;0;2;0;0.0;0.0
73;2020-12-29;0;0;2;0;0.0;0.0
73;2020-12-30;0;0;2;0;0.0;0.0
73;2020-12-31;0;0;2;0;0.0;0.0
73;2021-01-01;0;0;2;0;0.0;0.0
73;2021-01-02;0;0;2;0;0.0;0.0
73;2021-01-03;0;0;2;0;0.0;0.0
73;2021-01-04;1;0;3;0;0.0;0.0
73;2021-01-05;0;0;3;0;0.0;0.0
73;2021-01-06;1;0;4;0;0.0;0.0
73;2021-01-07;30;0;34;0;0.0;0.0
73;2021-01-08;81;0;115;0;0.0;0.0
73;2021-01-09;0;0;115;0;0.0;0.0
73;2021-01-10;0;0;115;0;0.0;0.0
73;2021-01-11;101;0;216;0;0.0;0.0
73;2021-01-12;303;1;519;1;0.1;0.0
73;2021-01-13;360;1;879;2;0.2;0.0
73;2021-01-14;516;2;1395;4;0.3;0.0
73;2021-01-15;617;1;2012;5;0.5;0.0
73;2021-01-16;128;0;2140;5;0.5;0.0
73;2021-01-17;0;0;2140;5;0.5;0.0
73;2021-01-18;624;0;2764;5;0.6;0.0
73;2021-01-19;1240;2;4004;7;0.9;0.0
73;2021-01-20;951;2;4955;9;1.1;0.0
73;2021-01-21;984;4;5939;13;1.4;0.0
73;2021-01-22;947;0;6886;13;1.6;0.0
73;2021-01-23;388;0;7274;13;1.7;0.0
73;2021-01-24;0;0;7274;13;1.7;0.0
73;2021-01-25;656;4;7930;17;1.8;0.0
73;2021-01-26;760;2;8690;19;2.0;0.0
73;2021-01-27;1107;5;9797;24;2.3;0.0
73;2021-01-28;961;5;10758;29;2.5;0.0
73;2021-01-29;684;5;11442;34;2.6;0.0
73;2021-01-30;345;2;11787;36;2.7;0.0
73;2021-01-31;0;0;11787;36;2.7;0.0
73;2021-02-01;606;37;12393;73;2.9;0.0
73;2021-02-02;752;327;13145;400;3.0;0.1
73;2021-02-03;650;344;13795;744;3.2;0.2
73;2021-02-04;625;224;14420;968;3.3;0.2
73;2021-02-05;680;398;15100;1366;3.5;0.3
73;2021-02-06;262;38;15362;1404;3.6;0.3
73;2021-02-07;1;0;15363;1404;3.6;0.3
73;2021-02-08;524;227;15887;1631;3.7;0.4
73;2021-02-09;793;400;16680;2031;3.9;0.5
73;2021-02-10;900;363;17580;2394;4.1;0.6
73;2021-02-11;962;675;18542;3069;4.3;0.7
73;2021-02-12;810;462;19352;3531;4.5;0.8
73;2021-02-13;263;46;19615;3577;4.5;0.8
73;2021-02-14;1;0;19616;3577;4.5;0.8
73;2021-02-15;346;387;19962;3964;4.6;0.9
73;2021-02-16;454;619;20416;4583;4.7;1.1
73;2021-02-17;451;829;20867;5412;4.8;1.3
73;2021-02-18;467;429;21334;5841;4.9;1.4
73;2021-02-19;444;528;21778;6369;5.0;1.5
73;2021-02-20;70;189;21848;6558;5.1;1.5
73;2021-02-21;0;0;21848;6558;5.1;1.5
73;2021-02-22;240;356;22088;6914;5.1;1.6
73;2021-02-23;327;434;22415;7348;5.2;1.7
73;2021-02-24;487;619;22902;7967;5.3;1.8
73;2021-02-25;504;410;23406;8377;5.4;1.9
73;2021-02-26;730;491;24136;8868;5.6;2.1
73;2021-02-27;330;200;24466;9068;5.7;2.1
73;2021-02-28;2;1;24468;9069;5.7;2.1
73;2021-03-01;557;441;25025;9510;5.8;2.2
73;2021-03-02;667;771;25692;10281;5.9;2.4
73;2021-03-03;643;1036;26335;11317;6.1;2.6
73;2021-03-04;1039;809;27374;12126;6.3;2.8
73;2021-03-05;1240;539;28614;12665;6.6;2.9
73;2021-03-06;1091;296;29705;12961;6.9;3.0
73;2021-03-07;455;88;30160;13049;7.0;3.0
73;2021-03-08;608;394;30768;13443;7.1;3.1
73;2021-03-09;983;468;31751;13911;7.3;3.2
73;2021-03-10;1036;760;32787;14671;7.6;3.4
73;2021-03-11;1560;586;34347;15257;7.9;3.5
73;2021-03-12;2018;507;36365;15764;8.4;3.6
73;2021-03-13;1179;192;37544;15956;8.7;3.7
73;2021-03-14;66;3;37610;15959;8.7;3.7
73;2021-03-15;1185;368;38795;16327;9.0;3.8
73;2021-03-16;795;388;39590;16715;9.2;3.9
73;2021-03-17;877;457;40467;17172;9.4;4.0
73;2021-03-18;1351;258;41818;17430;9.7;4.0
73;2021-03-19;1767;385;43585;17815;10.1;4.1
73;2021-03-20;888;127;44473;17942;10.3;4.1
73;2021-03-21;123;2;44596;17944;10.3;4.1
73;2021-03-22;1184;397;45780;18341;10.6;4.2
73;2021-03-23;1448;241;47228;18582;10.9;4.3
73;2021-03-24;1594;342;48822;18924;11.3;4.4
73;2021-03-25;2063;387;50885;19311;11.8;4.5
73;2021-03-26;2471;366;53356;19677;12.3;4.5
73;2021-03-27;885;148;54241;19825;12.5;4.6
73;2021-03-28;312;16;54553;19841;12.6;4.6
73;2021-03-29;1509;238;56062;20079;13.0;4.6
73;2021-03-30;2088;487;58150;20566;13.4;4.8
73;2021-03-31;2089;401;60239;20967;13.9;4.8
73;2021-04-01;2087;335;62326;21302;14.4;4.9
73;2021-04-02;2361;229;64687;21531;15.0;5.0
73;2021-04-03;849;147;65536;21678;15.2;5.0
73;2021-04-04;188;17;65724;21695;15.2;5.0
73;2021-04-05;212;26;65936;21721;15.2;5.0
73;2021-04-06;1506;510;67442;22231;15.6;5.1
73;2021-04-07;1947;650;69389;22881;16.0;5.3
73;2021-04-08;2491;820;71880;23701;16.6;5.5
73;2021-04-09;3059;524;74939;24225;17.3;5.6
73;2021-04-10;1134;320;76073;24545;17.6;5.7
73;2021-04-11;164;10;76237;24555;17.6;5.7
73;2021-04-12;1696;983;77933;25538;18.0;5.9
73;2021-04-13;1895;1129;79828;26667;18.5;6.2
73;2021-04-14;2013;1092;81841;27759;18.9;6.4
73;2021-04-15;2416;1190;84257;28949;19.5;6.7
73;2021-04-16;1893;934;86150;29883;19.9;6.9
73;2021-04-17;1173;560;87323;30443;20.2;7.0
73;2021-04-18;155;76;87478;30519;20.2;7.1
73;2021-04-19;1383;1057;88861;31576;20.5;7.3
73;2021-04-20;1790;1321;90651;32897;21.0;7.6
73;2021-04-21;1576;1301;92227;34198;21.3;7.9
73;2021-04-22;1812;1224;94039;35422;21.7;8.2
73;2021-04-23;1897;1254;95936;36676;22.2;8.5
73;2021-04-24;980;673;96916;37349;22.4;8.6
73;2021-04-25;79;96;96995;37445;22.4;8.7
73;2021-04-26;1164;1320;98159;38765;22.7;9.0
73;2021-04-27;1441;1468;99600;40233;23.0;9.3
73;2021-04-28;1731;1456;101331;41689;23.4;9.6
73;2021-04-29;2413;1562;103744;43251;24.0;10.0
73;2021-04-30;2396;1430;106140;44681;24.5;10.3
73;2021-05-01;1068;309;107208;44990;24.8;10.4
73;2021-05-02;34;165;107242;45155;24.8;10.4
73;2021-05-03;1392;1593;108634;46748;25.1;10.8
73;2021-05-04;1712;1828;110346;48576;25.5;11.2
73;2021-05-05;1975;1684;112321;50260;26.0;11.6
73;2021-05-06;2431;1695;114752;51955;26.5;12.0
73;2021-05-07;2259;1835;117011;53790;27.1;12.4
73;2021-05-08;1838;377;118849;54167;27.5;12.5
73;2021-05-09;127;126;118976;54293;27.5;12.6
73;2021-05-10;1608;1890;120584;56183;27.9;13.0
73;2021-05-11;2379;2367;122963;58550;28.4;13.5
73;2021-05-12;3556;2097;126519;60647;29.2;14.0
73;2021-05-13;1554;275;128073;60922;29.6;14.1
73;2021-05-14;1588;1492;129661;62414;30.0;14.4
73;2021-05-15;1447;943;131108;63357;30.3;14.6
73;2021-05-16;131;62;131239;63419;30.3;14.7
73;2021-05-17;1711;1948;132950;65367;30.7;15.1
73;2021-05-18;2495;1735;135445;67102;31.3;15.5
73;2021-05-19;2539;1623;137984;68725;31.9;15.9
73;2021-05-20;3161;1501;141145;70226;32.6;16.2
73;2021-05-21;2473;1849;143618;72075;33.2;16.7
73;2021-05-22;1989;923;145607;72998;33.7;16.9
73;2021-05-23;212;14;145819;73012;33.7;16.9
73;2021-05-24;2563;324;148382;73336;34.3;17.0
73;2021-05-25;2139;1741;150521;75077;34.8;17.4
73;2021-05-26;2343;1999;152864;77076;35.3;17.8
73;2021-05-27;3080;1713;155944;78789;36.1;18.2
73;2021-05-28;2918;2372;158862;81161;36.7;18.8
73;2021-05-29;2316;1321;161178;82482;37.3;19.1
73;2021-05-30;187;14;161365;82496;37.3;19.1
73;2021-05-31;2410;1632;163775;84128;37.9;19.4
73;2021-06-01;3178;1792;166953;85920;38.6;19.9
73;2021-06-02;3108;1454;170061;87374;39.3;20.2
73;2021-06-03;4422;1740;174483;89114;40.3;20.6
73;2021-06-04;4276;2184;178759;91298;41.3;21.1
73;2021-06-05;3161;1281;181920;92579;42.1;21.4
73;2021-06-06;1881;299;183801;92878;42.5;21.5
73;2021-06-07;2759;2148;186560;95026;43.1;22.0
73;2021-06-08;2684;1873;189244;96899;43.8;22.4
73;2021-06-09;2365;1789;191609;98688;44.3;22.8
73;2021-06-10;2005;1644;193614;100332;44.8;23.2
73;2021-06-11;2192;2441;195806;102773;45.3;23.8
73;2021-06-12;2245;1331;198051;104104;45.8;24.1
73;2021-06-13;44;82;198095;104186;45.8;24.1
73;2021-06-14;1347;2926;199442;107112;46.1;24.8
73;2021-06-15;1592;2754;201034;109866;46.5;25.4
73;2021-06-16;1466;2564;202500;112430;46.8;26.0
73;2021-06-17;947;1727;203447;114157;47.0;26.4
73;2021-06-18;1883;2931;205330;117088;47.5;27.1
73;2021-06-19;1424;1986;206754;119074;47.8;27.5
73;2021-06-20;448;307;207202;119381;47.9;27.6
73;2021-06-21;1111;2938;208313;122319;48.2;28.3
73;2021-06-22;1090;2870;209403;125189;48.4;28.9
73;2021-06-23;1086;3136;210489;128325;48.7;29.7
73;2021-06-24;883;1794;211372;130119;48.9;30.1
73;2021-06-25;1324;2794;212696;132913;49.2;30.7
73;2021-06-26;966;2398;213662;135311;49.4;31.3
73;2021-06-27;329;549;213991;135860;49.5;31.4
73;2021-06-28;971;3557;214962;139417;49.7;32.2
73;2021-06-29;1076;3340;216038;142757;49.9;33.0
73;2021-06-30;1239;3116;217277;145873;50.2;33.7
73;2021-07-01;1191;2362;218468;148235;50.5;34.3
73;2021-07-02;1203;3616;219671;151851;50.8;35.1
73;2021-07-03;961;2793;220632;154644;51.0;35.8
73;2021-07-04;301;619;220933;155263;51.1;35.9
73;2021-07-05;1157;3681;222090;158944;51.3;36.7
73;2021-07-06;1251;2951;223341;161895;51.6;37.4
73;2021-07-07;1443;2949;224784;164844;52.0;38.1
73;2021-07-08;1373;2296;226157;167140;52.3;38.6
73;2021-07-09;1431;4025;227588;171165;52.6;39.6
73;2021-07-10;891;3012;228479;174177;52.8;40.3
73;2021-07-11;561;1470;229040;175647;53.0;40.6
73;2021-07-12;1059;4194;230099;179841;53.2;41.6
73;2021-07-13;1729;4225;231828;184066;53.6;42.6
73;2021-07-14;1843;1919;233671;185985;54.0;43.0
73;2021-07-15;2747;3797;236418;189782;54.7;43.9
73;2021-07-16;2416;4015;238834;193797;55.2;44.8
73;2021-07-17;1515;2607;240349;196404;55.6;45.4
73;2021-07-18;1176;1218;241525;197622;55.8;45.7
73;2021-07-19;2449;3250;243974;200872;56.4;46.4
73;2021-07-20;3366;2855;247340;203727;57.2;47.1
73;2021-07-21;3382;2790;250722;206517;58.0;47.7
73;2021-07-22;2733;2216;253455;208733;58.6;48.3
73;2021-07-23;3417;2902;256872;211635;59.4;48.9
73;2021-07-24;2059;2280;258931;213915;59.9;49.5
73;2021-07-25;625;797;259556;214712;60.0;49.6
73;2021-07-26;2632;2495;262188;217207;60.6;50.2
73;2021-07-27;3813;2273;266001;219480;61.5;50.7
73;2021-07-28;3535;2095;269536;221575;62.3;51.2
73;2021-07-29;3980;2153;273516;223728;63.2;51.7
73;2021-07-30;3565;2475;277081;226203;64.1;52.3
73;2021-07-31;2477;1591;279558;227794;64.6;52.7
73;2021-08-01;834;620;280392;228414;64.8;52.8
73;2021-08-02;3104;2104;283496;230518;65.5;53.3
73;2021-08-03;3493;1999;286989;232517;66.3;53.8
73;2021-08-04;3299;2026;290288;234543;67.1;54.2
73;2021-08-05;2874;2232;293162;236775;67.8;54.7
73;2021-08-06;2509;2382;295671;239157;68.4;55.3
73;2021-08-07;1417;1482;297088;240639;68.7;55.6
73;2021-08-08;434;619;297522;241258;68.8;55.8
73;2021-08-09;1785;2396;299307;243654;69.2;56.3
73;2021-08-10;1897;2489;301204;246143;69.6;56.9
73;2021-08-11;1848;2535;303052;248678;70.1;57.5
73;2021-08-12;1683;2502;304735;251180;70.5;58.1
73;2021-08-13;1460;2842;306195;254022;70.8;58.7
73;2021-08-14;990;1534;307185;255556;71.0;59.1
73;2021-08-15;92;161;307277;255717;71.0;59.1
73;2021-08-16;952;1391;308229;257108;71.3;59.4
73;2021-08-17;963;1960;309192;259068;71.5;59.9
73;2021-08-18;1038;2841;310230;261909;71.7;60.6
73;2021-08-19;1045;3055;311275;264964;72.0;61.3
73;2021-08-20;852;3146;312127;268110;72.2;62.0
73;2021-08-21;463;1837;312590;269947;72.3;62.4
73;2021-08-22;268;936;312858;270883;72.3;62.6
73;2021-08-23;677;2970;313535;273853;72.5;63.3
73;2021-08-24;899;3160;314434;277013;72.7;64.0
73;2021-08-25;712;2907;315146;279920;72.9;64.7
73;2021-08-26;691;2424;315837;282344;73.0;65.3
73;2021-08-27;791;2748;316628;285092;73.2;65.9
73;2021-08-28;457;1749;317085;286841;73.3;66.3
73;2021-08-29;302;1016;317387;287857;73.4;66.5
73;2021-08-30;819;2590;318206;290447;73.6;67.1
73;2021-08-31;818;2392;319024;292839;73.8;67.7
73;2021-09-01;747;2244;319771;295083;73.9;68.2
73;2021-09-02;619;2018;320390;297101;74.1;68.7
73;2021-09-03;695;2210;321085;299311;74.2;69.2
73;2021-09-04;530;1463;321615;300774;74.4;69.5
73;2021-09-05;227;752;321842;301526;74.4;69.7
73;2021-09-06;348;1290;322190;302816;74.5;70.0
73;2021-09-07;414;1094;322604;303910;74.6;70.3
73;2021-09-08;490;1183;323094;305093;74.7;70.5
73;2021-09-09;467;1285;323561;306378;74.8;70.8
73;2021-09-10;574;1527;324135;307905;74.9;71.2
73;2021-09-11;354;1092;324489;308997;75.0;71.4
73;2021-09-12;96;163;324585;309160;75.0;71.5
73;2021-09-13;341;1029;324926;310189;75.1;71.7
73;2021-09-14;411;957;325337;311146;75.2;71.9
73;2021-09-15;424;815;325761;311961;75.3;72.1
73;2021-09-16;330;646;326091;312607;75.4;72.3
73;2021-09-17;377;868;326468;313475;75.5;72.5
73;2021-09-18;257;630;326725;314105;75.5;72.6
73;2021-09-19;46;205;326771;314310;75.5;72.7
73;2021-09-20;163;632;326934;314942;75.6;72.8
73;2021-09-21;297;537;327231;315479;75.7;72.9
73;2021-09-22;275;774;327506;316253;75.7;73.1
73;2021-09-23;280;476;327786;316729;75.8;73.2
73;2021-09-24;292;857;328078;317586;75.8;73.4
73;2021-09-25;189;723;328267;318309;75.9;73.6
73;2021-09-26;73;210;328340;318519;75.9;73.6
73;2021-09-27;243;499;328583;319018;76.0;73.8
73;2021-09-28;184;340;328767;319358;76.0;73.8
73;2021-09-29;220;675;328987;320033;76.1;74.0
73;2021-09-30;191;364;329178;320397;76.1;74.1
73;2021-10-01;209;563;329387;320960;76.2;74.2
73;2021-10-02;195;480;329582;321440;76.2;74.3
73;2021-10-03;8;11;329590;321451;76.2;74.3
74;2020-12-27;10;0;10;0;0.0;0.0
74;2020-12-28;9;0;19;0;0.0;0.0
74;2020-12-29;0;0;19;0;0.0;0.0
74;2020-12-30;5;0;24;0;0.0;0.0
74;2020-12-31;1;0;25;0;0.0;0.0
74;2021-01-01;0;0;25;0;0.0;0.0
74;2021-01-02;1;1;26;1;0.0;0.0
74;2021-01-03;0;0;26;1;0.0;0.0
74;2021-01-04;3;0;29;1;0.0;0.0
74;2021-01-05;4;0;33;1;0.0;0.0
74;2021-01-06;48;0;81;1;0.0;0.0
74;2021-01-07;220;1;301;2;0.0;0.0
74;2021-01-08;294;2;595;4;0.1;0.0
74;2021-01-09;79;0;674;4;0.1;0.0
74;2021-01-10;74;0;748;4;0.1;0.0
74;2021-01-11;375;0;1123;4;0.1;0.0
74;2021-01-12;408;3;1531;7;0.2;0.0
74;2021-01-13;396;0;1927;7;0.2;0.0
74;2021-01-14;482;1;2409;8;0.3;0.0
74;2021-01-15;645;4;3054;12;0.4;0.0
74;2021-01-16;254;1;3308;13;0.4;0.0
74;2021-01-17;134;1;3442;14;0.4;0.0
74;2021-01-18;527;0;3969;14;0.5;0.0
74;2021-01-19;814;2;4783;16;0.6;0.0
74;2021-01-20;1279;4;6062;20;0.7;0.0
74;2021-01-21;1570;2;7632;22;0.9;0.0
74;2021-01-22;1242;6;8874;28;1.1;0.0
74;2021-01-23;345;1;9219;29;1.1;0.0
74;2021-01-24;94;1;9313;30;1.1;0.0
74;2021-01-25;800;2;10113;32;1.2;0.0
74;2021-01-26;1371;14;11484;46;1.4;0.0
74;2021-01-27;1083;11;12567;57;1.5;0.0
74;2021-01-28;1001;28;13568;85;1.6;0.0
74;2021-01-29;882;35;14450;120;1.7;0.0
74;2021-01-30;305;1;14755;121;1.8;0.0
74;2021-01-31;87;1;14842;122;1.8;0.0
74;2021-02-01;632;44;15474;166;1.9;0.0
74;2021-02-02;645;147;16119;313;1.9;0.0
74;2021-02-03;606;114;16725;427;2.0;0.1
74;2021-02-04;617;122;17342;549;2.1;0.1
74;2021-02-05;556;186;17898;735;2.2;0.1
74;2021-02-06;275;111;18173;846;2.2;0.1
74;2021-02-07;93;102;18266;948;2.2;0.1
74;2021-02-08;620;310;18886;1258;2.3;0.2
74;2021-02-09;541;422;19427;1680;2.3;0.2
74;2021-02-10;688;467;20115;2147;2.4;0.3
74;2021-02-11;1082;933;21197;3080;2.6;0.4
74;2021-02-12;917;569;22114;3649;2.7;0.4
74;2021-02-13;407;212;22521;3861;2.7;0.5
74;2021-02-14;320;98;22841;3959;2.8;0.5
74;2021-02-15;281;634;23122;4593;2.8;0.6
74;2021-02-16;492;840;23614;5433;2.9;0.7
74;2021-02-17;530;896;24144;6329;2.9;0.8
74;2021-02-18;473;840;24617;7169;3.0;0.9
74;2021-02-19;619;567;25236;7736;3.0;0.9
74;2021-02-20;114;135;25350;7871;3.1;1.0
74;2021-02-21;48;49;25398;7920;3.1;1.0
74;2021-02-22;320;598;25718;8518;3.1;1.0
74;2021-02-23;307;674;26025;9192;3.1;1.1
74;2021-02-24;241;549;26266;9741;3.2;1.2
74;2021-02-25;524;599;26790;10340;3.2;1.2
74;2021-02-26;973;571;27763;10911;3.4;1.3
74;2021-02-27;254;137;28017;11048;3.4;1.3
74;2021-02-28;125;65;28142;11113;3.4;1.3
74;2021-03-01;723;552;28865;11665;3.5;1.4
74;2021-03-02;1093;567;29958;12232;3.6;1.5
74;2021-03-03;1025;544;30983;12776;3.7;1.5
74;2021-03-04;1612;894;32595;13670;3.9;1.7
74;2021-03-05;2093;792;34688;14462;4.2;1.7
74;2021-03-06;1762;301;36450;14763;4.4;1.8
74;2021-03-07;1386;103;37836;14866;4.6;1.8
74;2021-03-08;1198;849;39034;15715;4.7;1.9
74;2021-03-09;1957;592;40991;16307;4.9;2.0
74;2021-03-10;1749;789;42740;17096;5.2;2.1
74;2021-03-11;2451;663;45191;17759;5.5;2.1
74;2021-03-12;3246;971;48437;18730;5.8;2.3
74;2021-03-13;2002;267;50439;18997;6.1;2.3
74;2021-03-14;609;101;51048;19098;6.2;2.3
74;2021-03-15;2129;539;53177;19637;6.4;2.4
74;2021-03-16;1963;404;55140;20041;6.7;2.4
74;2021-03-17;1975;310;57115;20351;6.9;2.5
74;2021-03-18;2136;283;59251;20634;7.2;2.5
74;2021-03-19;2636;296;61887;20930;7.5;2.5
74;2021-03-20;1375;104;63262;21034;7.6;2.5
74;2021-03-21;290;32;63552;21066;7.7;2.5
74;2021-03-22;2054;316;65606;21382;7.9;2.6
74;2021-03-23;2723;337;68329;21719;8.2;2.6
74;2021-03-24;2948;306;71277;22025;8.6;2.7
74;2021-03-25;3875;309;75152;22334;9.1;2.7
74;2021-03-26;4095;386;79247;22720;9.6;2.7
74;2021-03-27;1941;261;81188;22981;9.8;2.8
74;2021-03-28;437;78;81625;23059;9.9;2.8
74;2021-03-29;3035;702;84660;23761;10.2;2.9
74;2021-03-30;3543;760;88203;24521;10.6;3.0
74;2021-03-31;3144;738;91347;25259;11.0;3.0
74;2021-04-01;4236;902;95583;26161;11.5;3.2
74;2021-04-02;3711;794;99294;26955;12.0;3.3
74;2021-04-03;1696;537;100990;27492;12.2;3.3
74;2021-04-04;236;122;101226;27614;12.2;3.3
74;2021-04-05;433;16;101659;27630;12.3;3.3
74;2021-04-06;2623;1206;104282;28836;12.6;3.5
74;2021-04-07;3195;1252;107477;30088;13.0;3.6
74;2021-04-08;3865;1191;111342;31279;13.4;3.8
74;2021-04-09;4111;1182;115453;32461;13.9;3.9
74;2021-04-10;1944;1027;117397;33488;14.2;4.0
74;2021-04-11;253;184;117650;33672;14.2;4.1
74;2021-04-12;2724;1778;120374;35450;14.5;4.3
74;2021-04-13;3123;2106;123497;37556;14.9;4.5
74;2021-04-14;2903;1972;126400;39528;15.3;4.8
74;2021-04-15;3463;1910;129863;41438;15.7;5.0
74;2021-04-16;3386;1789;133249;43227;16.1;5.2
74;2021-04-17;1936;1034;135185;44261;16.3;5.3
74;2021-04-18;218;211;135403;44472;16.3;5.4
74;2021-04-19;2100;2094;137503;46566;16.6;5.6
74;2021-04-20;3068;2415;140571;48981;17.0;5.9
74;2021-04-21;2464;2375;143035;51356;17.3;6.2
74;2021-04-22;2629;2338;145664;53694;17.6;6.5
74;2021-04-23;2573;2247;148237;55941;17.9;6.8
74;2021-04-24;1485;1540;149722;57481;18.1;6.9
74;2021-04-25;229;149;149951;57630;18.1;7.0
74;2021-04-26;2396;2462;152347;60092;18.4;7.3
74;2021-04-27;3272;2906;155619;62998;18.8;7.6
74;2021-04-28;3465;2629;159084;65627;19.2;7.9
74;2021-04-29;3909;2695;162993;68322;19.7;8.2
74;2021-04-30;4076;2225;167069;70547;20.2;8.5
74;2021-05-01;2121;397;169190;70944;20.4;8.6
74;2021-05-02;205;238;169395;71182;20.4;8.6
74;2021-05-03;2596;3021;171991;74203;20.8;9.0
74;2021-05-04;3217;3116;175208;77319;21.2;9.3
74;2021-05-05;3391;3021;178599;80340;21.6;9.7
74;2021-05-06;3859;2633;182458;82973;22.0;10.0
74;2021-05-07;3594;3541;186052;86514;22.5;10.4
74;2021-05-08;1145;827;187197;87341;22.6;10.5
74;2021-05-09;195;246;187392;87587;22.6;10.6
74;2021-05-10;3466;3145;190858;90732;23.0;11.0
74;2021-05-11;4317;3418;195175;94150;23.6;11.4
74;2021-05-12;5305;2963;200480;97113;24.2;11.7
74;2021-05-13;2357;950;202837;98063;24.5;11.8
74;2021-05-14;5956;2402;208793;100465;25.2;12.1
74;2021-05-15;4513;1848;213306;102313;25.7;12.4
74;2021-05-16;3012;338;216318;102651;26.1;12.4
74;2021-05-17;5397;2890;221715;105541;26.8;12.7
74;2021-05-18;6792;2817;228507;108358;27.6;13.1
74;2021-05-19;6234;2296;234741;110654;28.3;13.4
74;2021-05-20;6643;2558;241384;113212;29.1;13.7
74;2021-05-21;6526;2993;247910;116205;29.9;14.0
74;2021-05-22;5293;1568;253203;117773;30.6;14.2
74;2021-05-23;2052;282;255255;118055;30.8;14.3
74;2021-05-24;2362;660;257617;118715;31.1;14.3
74;2021-05-25;5073;3334;262690;122049;31.7;14.7
74;2021-05-26;5255;2563;267945;124612;32.3;15.0
74;2021-05-27;6001;2976;273946;127588;33.1;15.4
74;2021-05-28;5656;3576;279602;131164;33.8;15.8
74;2021-05-29;3799;2156;283401;133320;34.2;16.1
74;2021-05-30;488;309;283889;133629;34.3;16.1
74;2021-05-31;5069;3549;288958;137178;34.9;16.6
74;2021-06-01;4931;3726;293889;140904;35.5;17.0
74;2021-06-02;5269;3207;299158;144111;36.1;17.4
74;2021-06-03;6890;3249;306048;147360;36.9;17.8
74;2021-06-04;6911;4431;312959;151791;37.8;18.3
74;2021-06-05;4609;2706;317568;154497;38.3;18.6
74;2021-06-06;124;112;317692;154609;38.3;18.7
74;2021-06-07;5031;4144;322723;158753;39.0;19.2
74;2021-06-08;5025;3949;327748;162702;39.6;19.6
74;2021-06-09;5081;3481;332829;166183;40.2;20.1
74;2021-06-10;5123;2877;337952;169060;40.8;20.4
74;2021-06-11;5214;3812;343166;172872;41.4;20.9
74;2021-06-12;3567;2378;346733;175250;41.9;21.2
74;2021-06-13;120;89;346853;175339;41.9;21.2
74;2021-06-14;3595;4482;350448;179821;42.3;21.7
74;2021-06-15;3671;3896;354119;183717;42.7;22.2
74;2021-06-16;4827;3123;358946;186840;43.3;22.6
74;2021-06-17;3816;2953;362762;189793;43.8;22.9
74;2021-06-18;4114;4669;366876;194462;44.3;23.5
74;2021-06-19;2993;3101;369869;197563;44.6;23.8
74;2021-06-20;125;97;369994;197660;44.7;23.9
74;2021-06-21;2382;5418;372376;203078;45.0;24.5
74;2021-06-22;2493;5312;374869;208390;45.3;25.2
74;2021-06-23;2974;4618;377843;213008;45.6;25.7
74;2021-06-24;2865;4626;380708;217634;46.0;26.3
74;2021-06-25;2931;6768;383639;224402;46.3;27.1
74;2021-06-26;1705;5400;385344;229802;46.5;27.7
74;2021-06-27;66;1664;385410;231466;46.5;27.9
74;2021-06-28;1915;7219;387325;238685;46.8;28.8
74;2021-06-29;2297;7421;389622;246106;47.0;29.7
74;2021-06-30;2747;6544;392369;252650;47.4;30.5
74;2021-07-01;3526;5426;395895;258076;47.8;31.2
74;2021-07-02;3122;6639;399017;264715;48.2;32.0
74;2021-07-03;1698;5085;400715;269800;48.4;32.6
74;2021-07-04;81;1022;400796;270822;48.4;32.7
74;2021-07-05;2078;6828;402874;277650;48.6;33.5
74;2021-07-06;2799;6488;405673;284138;49.0;34.3
74;2021-07-07;3093;5446;408766;289584;49.3;35.0
74;2021-07-08;3866;4923;412632;294507;49.8;35.6
74;2021-07-09;2671;6974;415303;301481;50.1;36.4
74;2021-07-10;1622;5132;416925;306613;50.3;37.0
74;2021-07-11;76;142;417001;306755;50.3;37.0
74;2021-07-12;2095;7899;419096;314654;50.6;38.0
74;2021-07-13;3967;7586;423063;322240;51.1;38.9
74;2021-07-14;1968;2238;425031;324478;51.3;39.2
74;2021-07-15;3592;6876;428623;331354;51.7;40.0
74;2021-07-16;4242;7740;432865;339094;52.3;40.9
74;2021-07-17;3004;5330;435869;344424;52.6;41.6
74;2021-07-18;156;155;436025;344579;52.6;41.6
74;2021-07-19;4295;7351;440320;351930;53.2;42.5
74;2021-07-20;5873;6467;446193;358397;53.9;43.3
74;2021-07-21;5669;6674;451862;365071;54.5;44.1
74;2021-07-22;4773;5323;456635;370394;55.1;44.7
74;2021-07-23;6227;6993;462862;377387;55.9;45.6
74;2021-07-24;3156;4316;466018;381703;56.3;46.1
74;2021-07-25;181;171;466199;381874;56.3;46.1
74;2021-07-26;5617;6134;471816;388008;57.0;46.8
74;2021-07-27;6851;5176;478667;393184;57.8;47.5
74;2021-07-28;6659;5102;485326;398286;58.6;48.1
74;2021-07-29;5278;3930;490604;402216;59.2;48.6
74;2021-07-30;6715;5503;497319;407719;60.0;49.2
74;2021-07-31;4377;3124;501696;410843;60.6;49.6
74;2021-08-01;184;149;501880;410992;60.6;49.6
74;2021-08-02;6263;4408;508143;415400;61.3;50.1
74;2021-08-03;6036;3860;514179;419260;62.1;50.6
74;2021-08-04;6322;3509;520501;422769;62.8;51.0
74;2021-08-05;4930;3266;525431;426035;63.4;51.4
74;2021-08-06;5068;4182;530499;430217;64.0;51.9
74;2021-08-07;3210;2899;533709;433116;64.4;52.3
74;2021-08-08;154;134;533863;433250;64.4;52.3
74;2021-08-09;4972;4828;538835;438078;65.0;52.9
74;2021-08-10;4987;4687;543822;442765;65.6;53.4
74;2021-08-11;4413;4889;548235;447654;66.2;54.0
74;2021-08-12;3609;3607;551844;451261;66.6;54.5
74;2021-08-13;3822;4625;555666;455886;67.1;55.0
74;2021-08-14;2184;3342;557850;459228;67.3;55.4
74;2021-08-15;62;102;557912;459330;67.3;55.4
74;2021-08-16;3860;5877;561772;465207;67.8;56.2
74;2021-08-17;3133;5486;564905;470693;68.2;56.8
74;2021-08-18;3082;5460;567987;476153;68.6;57.5
74;2021-08-19;2353;3898;570340;480051;68.8;57.9
74;2021-08-20;2632;5698;572972;485749;69.2;58.6
74;2021-08-21;1239;4273;574211;490022;69.3;59.2
74;2021-08-22;56;137;574267;490159;69.3;59.2
74;2021-08-23;2187;6697;576454;496856;69.6;60.0
74;2021-08-24;2216;5938;578670;502794;69.9;60.7
74;2021-08-25;1969;6294;580639;509088;70.1;61.5
74;2021-08-26;1555;3786;582194;512874;70.3;61.9
74;2021-08-27;1928;5509;584122;518383;70.5;62.6
74;2021-08-28;926;4040;585048;522423;70.6;63.1
74;2021-08-29;66;188;585114;522611;70.6;63.1
74;2021-08-30;1860;5484;586974;528095;70.9;63.7
74;2021-08-31;1676;5126;588650;533221;71.1;64.4
74;2021-09-01;1798;4154;590448;537375;71.3;64.9
74;2021-09-02;1217;3035;591665;540410;71.4;65.2
74;2021-09-03;1534;4185;593199;544595;71.6;65.7
74;2021-09-04;1156;2848;594355;547443;71.7;66.1
74;2021-09-05;48;96;594403;547539;71.8;66.1
74;2021-09-06;1241;3377;595644;550916;71.9;66.5
74;2021-09-07;1025;3053;596669;553969;72.0;66.9
74;2021-09-08;1306;3179;597975;557148;72.2;67.3
74;2021-09-09;1215;2211;599190;559359;72.3;67.5
74;2021-09-10;1119;3110;600309;562469;72.5;67.9
74;2021-09-11;764;2323;601073;564792;72.6;68.2
74;2021-09-12;40;80;601113;564872;72.6;68.2
74;2021-09-13;954;2631;602067;567503;72.7;68.5
74;2021-09-14;1054;2478;603121;569981;72.8;68.8
74;2021-09-15;1056;2270;604177;572251;72.9;69.1
74;2021-09-16;747;1030;604924;573281;73.0;69.2
74;2021-09-17;830;1848;605754;575129;73.1;69.4
74;2021-09-18;604;1671;606358;576800;73.2;69.6
74;2021-09-19;3;9;606361;576809;73.2;69.6
74;2021-09-20;800;1883;607161;578692;73.3;69.9
74;2021-09-21;638;1372;607799;580064;73.4;70.0
74;2021-09-22;618;2101;608417;582165;73.4;70.3
74;2021-09-23;639;996;609056;583161;73.5;70.4
74;2021-09-24;721;1967;609777;585128;73.6;70.6
74;2021-09-25;461;1621;610238;586749;73.7;70.8
74;2021-09-26;1;2;610239;586751;73.7;70.8
74;2021-09-27;572;1771;610811;588522;73.7;71.0
74;2021-09-28;394;956;611205;589478;73.8;71.2
74;2021-09-29;542;1560;611747;591038;73.8;71.3
74;2021-09-30;388;1058;612135;592096;73.9;71.5
74;2021-10-01;600;1114;612735;593210;74.0;71.6
74;2021-10-02;434;811;613169;594021;74.0;71.7
74;2021-10-03;5;11;613174;594032;74.0;71.7
75;2020-12-27;72;1;72;1;0.0;0.0
75;2020-12-28;65;0;137;1;0.0;0.0
75;2020-12-29;33;0;170;1;0.0;0.0
75;2020-12-30;87;0;257;1;0.0;0.0
75;2020-12-31;48;1;305;2;0.0;0.0
75;2021-01-01;63;3;368;5;0.0;0.0
75;2021-01-02;64;1;432;6;0.0;0.0
75;2021-01-03;107;1;539;7;0.0;0.0
75;2021-01-04;323;1;862;8;0.0;0.0
75;2021-01-05;882;10;1744;18;0.1;0.0
75;2021-01-06;1370;16;3114;34;0.1;0.0
75;2021-01-07;2072;19;5186;53;0.2;0.0
75;2021-01-08;2881;30;8067;83;0.4;0.0
75;2021-01-09;1097;2;9164;85;0.4;0.0
75;2021-01-10;1101;4;10265;89;0.5;0.0
75;2021-01-11;3119;46;13384;135;0.6;0.0
75;2021-01-12;3491;52;16875;187;0.8;0.0
75;2021-01-13;3575;44;20450;231;1.0;0.0
75;2021-01-14;3790;61;24240;292;1.1;0.0
75;2021-01-15;3340;46;27580;338;1.3;0.0
75;2021-01-16;1147;14;28727;352;1.3;0.0
75;2021-01-17;563;14;29290;366;1.4;0.0
75;2021-01-18;3291;69;32581;435;1.5;0.0
75;2021-01-19;3873;47;36454;482;1.7;0.0
75;2021-01-20;4439;59;40893;541;1.9;0.0
75;2021-01-21;4950;71;45843;612;2.1;0.0
75;2021-01-22;4606;69;50449;681;2.3;0.0
75;2021-01-23;1769;12;52218;693;2.4;0.0
75;2021-01-24;761;7;52979;700;2.5;0.0
75;2021-01-25;1739;24;54718;724;2.5;0.0
75;2021-01-26;2564;80;57282;804;2.7;0.0
75;2021-01-27;3172;148;60454;952;2.8;0.0
75;2021-01-28;4789;229;65243;1181;3.0;0.1
75;2021-01-29;4064;237;69307;1418;3.2;0.1
75;2021-01-30;1362;18;70669;1436;3.3;0.1
75;2021-01-31;226;3;70895;1439;3.3;0.1
75;2021-02-01;1635;339;72530;1778;3.4;0.1
75;2021-02-02;2154;583;74684;2361;3.5;0.1
75;2021-02-03;1894;632;76578;2993;3.6;0.1
75;2021-02-04;2153;1034;78731;4027;3.7;0.2
75;2021-02-05;2226;755;80957;4782;3.8;0.2
75;2021-02-06;1136;73;82093;4855;3.8;0.2
75;2021-02-07;179;6;82272;4861;3.8;0.2
75;2021-02-08;1268;1273;83540;6134;3.9;0.3
75;2021-02-09;1801;2187;85341;8321;4.0;0.4
75;2021-02-10;2428;2169;87769;10490;4.1;0.5
75;2021-02-11;2951;4878;90720;15368;4.2;0.7
75;2021-02-12;3136;2223;93856;17591;4.4;0.8
75;2021-02-13;860;821;94716;18412;4.4;0.9
75;2021-02-14;211;39;94927;18451;4.4;0.9
75;2021-02-15;1011;1888;95938;20339;4.5;0.9
75;2021-02-16;1467;5125;97405;25464;4.5;1.2
75;2021-02-17;1343;2436;98748;27900;4.6;1.3
75;2021-02-18;1778;4499;100526;32399;4.7;1.5
75;2021-02-19;2231;3260;102757;35659;4.8;1.7
75;2021-02-20;485;1280;103242;36939;4.8;1.7
75;2021-02-21;201;112;103443;37051;4.8;1.7
75;2021-02-22;1230;1475;104673;38526;4.9;1.8
75;2021-02-23;1469;1974;106142;40500;4.9;1.9
75;2021-02-24;1700;1739;107842;42239;5.0;2.0
75;2021-02-25;2797;4291;110639;46530;5.2;2.2
75;2021-02-26;3387;2052;114026;48582;5.3;2.3
75;2021-02-27;1408;690;115434;49272;5.4;2.3
75;2021-02-28;330;99;115764;49371;5.4;2.3
75;2021-03-01;2603;1337;118367;50708;5.5;2.4
75;2021-03-02;4195;1671;122562;52379;5.7;2.4
75;2021-03-03;5442;1871;128004;54250;6.0;2.5
75;2021-03-04;8063;2131;136067;56381;6.3;2.6
75;2021-03-05;10584;2271;146651;58652;6.8;2.7
75;2021-03-06;11084;951;157735;59603;7.3;2.8
75;2021-03-07;9513;1404;167248;61007;7.8;2.8
75;2021-03-08;5927;1377;173175;62384;8.1;2.9
75;2021-03-09;7540;1892;180715;64276;8.4;3.0
75;2021-03-10;7524;1952;188239;66228;8.8;3.1
75;2021-03-11;10365;2343;198604;68571;9.2;3.2
75;2021-03-12;12074;2407;210678;70978;9.8;3.3
75;2021-03-13;8562;749;219240;71727;10.2;3.3
75;2021-03-14;4178;261;223418;71988;10.4;3.4
75;2021-03-15;7475;965;230893;72953;10.7;3.4
75;2021-03-16;5168;680;236061;73633;11.0;3.4
75;2021-03-17;5435;822;241496;74455;11.2;3.5
75;2021-03-18;6630;852;248126;75307;11.6;3.5
75;2021-03-19;9769;985;257895;76292;12.0;3.6
75;2021-03-20;5938;598;263833;76890;12.3;3.6
75;2021-03-21;1595;424;265428;77314;12.4;3.6
75;2021-03-22;8669;1017;274097;78331;12.8;3.6
75;2021-03-23;10969;1255;285066;79586;13.3;3.7
75;2021-03-24;11017;1328;296083;80914;13.8;3.8
75;2021-03-25;14224;1539;310307;82453;14.4;3.8
75;2021-03-26;13990;1702;324297;84155;15.1;3.9
75;2021-03-27;7289;765;331586;84920;15.4;4.0
75;2021-03-28;1791;151;333377;85071;15.5;4.0
75;2021-03-29;7979;2171;341356;87242;15.9;4.1
75;2021-03-30;10948;3205;352304;90447;16.4;4.2
75;2021-03-31;9755;3563;362059;94010;16.9;4.4
75;2021-04-01;10716;5172;372775;99182;17.4;4.6
75;2021-04-02;9066;5534;381841;104716;17.8;4.9
75;2021-04-03;4128;4846;385969;109562;18.0;5.1
75;2021-04-04;1424;1455;387393;111017;18.0;5.2
75;2021-04-05;2260;1316;389653;112333;18.1;5.2
75;2021-04-06;6929;4252;396582;116585;18.5;5.4
75;2021-04-07;8106;4375;404688;120960;18.8;5.6
75;2021-04-08;11095;4167;415783;125127;19.4;5.8
75;2021-04-09;12219;4617;428002;129744;19.9;6.0
75;2021-04-10;5850;4237;433852;133981;20.2;6.2
75;2021-04-11;1950;1784;435802;135765;20.3;6.3
75;2021-04-12;7490;3784;443292;139549;20.6;6.5
75;2021-04-13;8575;6780;451867;146329;21.0;6.8
75;2021-04-14;8307;5214;460174;151543;21.4;7.1
75;2021-04-15;8932;6126;469106;157669;21.8;7.3
75;2021-04-16;9396;6104;478502;163773;22.3;7.6
75;2021-04-17;4822;3637;483324;167410;22.5;7.8
75;2021-04-18;1673;876;484997;168286;22.6;7.8
75;2021-04-19;5593;4939;490590;173225;22.8;8.1
75;2021-04-20;6472;5944;497062;179169;23.1;8.3
75;2021-04-21;6882;5562;503944;184731;23.5;8.6
75;2021-04-22;7549;5897;511493;190628;23.8;8.9
75;2021-04-23;8689;6440;520182;197068;24.2;9.2
75;2021-04-24;6185;3346;526367;200414;24.5;9.3
75;2021-04-25;2971;760;529338;201174;24.6;9.4
75;2021-04-26;7030;4699;536368;205873;25.0;9.6
75;2021-04-27;10601;6387;546969;212260;25.5;9.9
75;2021-04-28;12205;5982;559174;218242;26.0;10.2
75;2021-04-29;13765;6317;572939;224559;26.7;10.5
75;2021-04-30;13669;6145;586608;230704;27.3;10.7
75;2021-05-01;5082;1324;591690;232028;27.5;10.8
75;2021-05-02;2391;789;594081;232817;27.7;10.8
75;2021-05-03;10296;13446;604377;246263;28.1;11.5
75;2021-05-04;11195;8061;615572;254324;28.7;11.8
75;2021-05-05;13564;6694;629136;261018;29.3;12.2
75;2021-05-06;14008;8174;643144;269192;29.9;12.5
75;2021-05-07;13987;8557;657131;277749;30.6;12.9
75;2021-05-08;10086;5508;667217;283257;31.1;13.2
75;2021-05-09;3821;3179;671038;286436;31.2;13.3
75;2021-05-10;14300;6705;685338;293141;31.9;13.6
75;2021-05-11;16851;8383;702189;301524;32.7;14.0
75;2021-05-12;17964;8132;720153;309656;33.5;14.4
75;2021-05-13;13644;2487;733797;312143;34.2;14.5
75;2021-05-14;18396;5119;752193;317262;35.0;14.8
75;2021-05-15;12326;2656;764519;319918;35.6;14.9
75;2021-05-16;3860;758;768379;320676;35.8;14.9
75;2021-05-17;16011;4645;784390;325321;36.5;15.1
75;2021-05-18;19162;5310;803552;330631;37.4;15.4
75;2021-05-19;20729;10692;824281;341323;38.4;15.9
75;2021-05-20;21585;8656;845866;349979;39.4;16.3
75;2021-05-21;21032;6545;866898;356524;40.4;16.6
75;2021-05-22;15907;3293;882805;359817;41.1;16.7
75;2021-05-23;5639;1335;888444;361152;41.4;16.8
75;2021-05-24;15635;2559;904079;363711;42.1;16.9
75;2021-05-25;18035;9559;922114;373270;42.9;17.4
75;2021-05-26;18888;8196;941002;381466;43.8;17.8
75;2021-05-27;20146;9792;961148;391258;44.7;18.2
75;2021-05-28;19340;10828;980488;402086;45.6;18.7
75;2021-05-29;16114;5836;996602;407922;46.4;19.0
75;2021-05-30;7040;2157;1003642;410079;46.7;19.1
75;2021-05-31;18095;9429;1021737;419508;47.6;19.5
75;2021-06-01;18695;12963;1040432;432471;48.4;20.1
75;2021-06-02;18120;10295;1058552;442766;49.3;20.6
75;2021-06-03;20254;11947;1078806;454713;50.2;21.2
75;2021-06-04;18119;12826;1096925;467539;51.1;21.8
75;2021-06-05;11988;9612;1108913;477151;51.6;22.2
75;2021-06-06;6726;3158;1115639;480309;51.9;22.4
75;2021-06-07;13891;11814;1129530;492123;52.6;22.9
75;2021-06-08;14799;13954;1144329;506077;53.3;23.6
75;2021-06-09;16509;15233;1160838;521310;54.0;24.3
75;2021-06-10;18362;26286;1179200;547596;54.9;25.5
75;2021-06-11;15311;16454;1194511;564050;55.6;26.3
75;2021-06-12;13284;10001;1207795;574051;56.2;26.7
75;2021-06-13;6277;3794;1214072;577845;56.5;26.9
75;2021-06-14;11822;15391;1225894;593236;57.1;27.6
75;2021-06-15;12730;19543;1238624;612779;57.7;28.5
75;2021-06-16;12206;17232;1250830;630011;58.2;29.3
75;2021-06-17;12658;17667;1263488;647678;58.8;30.1
75;2021-06-18;11274;22600;1274762;670278;59.3;31.2
75;2021-06-19;7531;11820;1282293;682098;59.7;31.8
75;2021-06-20;2820;5473;1285113;687571;59.8;32.0
75;2021-06-21;8512;16326;1293625;703897;60.2;32.8
75;2021-06-22;8809;21792;1302434;725689;60.6;33.8
75;2021-06-23;10309;21424;1312743;747113;61.1;34.8
75;2021-06-24;11317;20639;1324060;767752;61.6;35.7
75;2021-06-25;9873;24682;1333933;792434;62.1;36.9
75;2021-06-26;7935;15420;1341868;807854;62.5;37.6
75;2021-06-27;2702;6325;1344570;814179;62.6;37.9
75;2021-06-28;8475;20144;1353045;834323;63.0;38.8
75;2021-06-29;9345;23820;1362390;858143;63.4;39.9
75;2021-06-30;10213;23620;1372603;881763;63.9;41.0
75;2021-07-01;11435;23512;1384038;905275;64.4;42.1
75;2021-07-02;10886;24770;1394924;930045;64.9;43.3
75;2021-07-03;7817;19802;1402741;949847;65.3;44.2
75;2021-07-04;3907;9556;1406648;959403;65.5;44.7
75;2021-07-05;9345;21581;1415993;980984;65.9;45.7
75;2021-07-06;10168;24008;1426161;1004992;66.4;46.8
75;2021-07-07;10161;25090;1436322;1030082;66.9;47.9
75;2021-07-08;10672;25022;1446994;1055104;67.4;49.1
75;2021-07-09;10864;24030;1457858;1079134;67.9;50.2
75;2021-07-10;7949;18499;1465807;1097633;68.2;51.1
75;2021-07-11;4351;8529;1470158;1106162;68.4;51.5
75;2021-07-12;9859;23085;1480017;1129247;68.9;52.6
75;2021-07-13;14394;24804;1494411;1154051;69.6;53.7
75;2021-07-14;8354;9725;1502765;1163776;70.0;54.2
75;2021-07-15;15583;25660;1518348;1189436;70.7;55.4
75;2021-07-16;15824;22147;1534172;1211583;71.4;56.4
75;2021-07-17;12199;16909;1546371;1228492;72.0;57.2
75;2021-07-18;6267;6841;1552638;1235333;72.3;57.5
75;2021-07-19;14402;21296;1567040;1256629;72.9;58.5
75;2021-07-20;16073;21898;1583113;1278527;73.7;59.5
75;2021-07-21;15714;20707;1598827;1299234;74.4;60.5
75;2021-07-22;17148;20090;1615975;1319324;75.2;61.4
75;2021-07-23;17165;19107;1633140;1338431;76.0;62.3
75;2021-07-24;11194;14079;1644334;1352510;76.5;63.0
75;2021-07-25;5004;5070;1649338;1357580;76.8;63.2
75;2021-07-26;15183;16872;1664521;1374452;77.5;64.0
75;2021-07-27;18145;16661;1682666;1391113;78.3;64.8
75;2021-07-28;17147;15486;1699813;1406599;79.1;65.5
75;2021-07-29;16773;15094;1716586;1421693;79.9;66.2
75;2021-07-30;16722;14352;1733308;1436045;80.7;66.8
75;2021-07-31;9346;9866;1742654;1445911;81.1;67.3
75;2021-08-01;3717;3255;1746371;1449166;81.3;67.5
75;2021-08-02;10956;11981;1757327;1461147;81.8;68.0
75;2021-08-03;11129;10837;1768456;1471984;82.3;68.5
75;2021-08-04;9733;9485;1778189;1481469;82.8;69.0
75;2021-08-05;8725;9554;1786914;1491023;83.2;69.4
75;2021-08-06;8250;9992;1795164;1501015;83.6;69.9
75;2021-08-07;5706;7159;1800870;1508174;83.8;70.2
75;2021-08-08;1961;3282;1802831;1511456;83.9;70.4
75;2021-08-09;8606;11475;1811437;1522931;84.3;70.9
75;2021-08-10;9291;11587;1820728;1534518;84.8;71.4
75;2021-08-11;7790;10143;1828518;1544661;85.1;71.9
75;2021-08-12;6940;10597;1835458;1555258;85.4;72.4
75;2021-08-13;6254;8868;1841712;1564126;85.7;72.8
75;2021-08-14;4115;7197;1845827;1571323;85.9;73.1
75;2021-08-15;1026;1935;1846853;1573258;86.0;73.2
75;2021-08-16;6135;14032;1852988;1587290;86.3;73.9
75;2021-08-17;5814;13604;1858802;1600894;86.5;74.5
75;2021-08-18;5082;12009;1863884;1612903;86.8;75.1
75;2021-08-19;4770;12686;1868654;1625589;87.0;75.7
75;2021-08-20;4563;11789;1873217;1637378;87.2;76.2
75;2021-08-21;3187;8811;1876404;1646189;87.3;76.6
75;2021-08-22;997;3163;1877401;1649352;87.4;76.8
75;2021-08-23;4921;15304;1882322;1664656;87.6;77.5
75;2021-08-24;4804;14537;1887126;1679193;87.8;78.2
75;2021-08-25;4525;12335;1891651;1691528;88.1;78.7
75;2021-08-26;4081;10281;1895732;1701809;88.2;79.2
75;2021-08-27;4467;11678;1900199;1713487;88.5;79.8
75;2021-08-28;3074;8307;1903273;1721794;88.6;80.1
75;2021-08-29;753;2018;1904026;1723812;88.6;80.2
75;2021-08-30;4512;14668;1908538;1738480;88.8;80.9
75;2021-08-31;4394;13817;1912932;1752297;89.0;81.6
75;2021-09-01;3968;11411;1916900;1763708;89.2;82.1
75;2021-09-02;3235;9619;1920135;1773327;89.4;82.5
75;2021-09-03;3703;10405;1923838;1783732;89.6;83.0
75;2021-09-04;3559;8921;1927397;1792653;89.7;83.4
75;2021-09-05;704;1716;1928101;1794369;89.8;83.5
75;2021-09-06;2580;8079;1930681;1802448;89.9;83.9
75;2021-09-07;2364;7382;1933045;1809830;90.0;84.2
75;2021-09-08;2584;7335;1935629;1817165;90.1;84.6
75;2021-09-09;2371;6836;1938000;1824001;90.2;84.9
75;2021-09-10;2689;8043;1940689;1832044;90.3;85.3
75;2021-09-11;2365;6973;1943054;1839017;90.4;85.6
75;2021-09-12;502;1197;1943556;1840214;90.5;85.7
75;2021-09-13;2258;6495;1945814;1846709;90.6;86.0
75;2021-09-14;2235;5657;1948049;1852366;90.7;86.2
75;2021-09-15;2274;4644;1950323;1857010;90.8;86.4
75;2021-09-16;1883;3712;1952206;1860722;90.9;86.6
75;2021-09-17;2528;4759;1954734;1865481;91.0;86.8
75;2021-09-18;1559;4677;1956293;1870158;91.1;87.1
75;2021-09-19;283;738;1956576;1870896;91.1;87.1
75;2021-09-20;1691;3637;1958267;1874533;91.2;87.3
75;2021-09-21;1617;3197;1959884;1877730;91.2;87.4
75;2021-09-22;1587;3965;1961471;1881695;91.3;87.6
75;2021-09-23;1416;2842;1962887;1884537;91.4;87.7
75;2021-09-24;1791;4027;1964678;1888564;91.5;87.9
75;2021-09-25;1263;4349;1965941;1892913;91.5;88.1
75;2021-09-26;275;524;1966216;1893437;91.5;88.1
75;2021-09-27;1304;3011;1967520;1896448;91.6;88.3
75;2021-09-28;1399;2466;1968919;1898914;91.7;88.4
75;2021-09-29;1371;2869;1970290;1901783;91.7;88.5
75;2021-09-30;1242;2500;1971532;1904283;91.8;88.6
75;2021-10-01;1506;2666;1973038;1906949;91.8;88.8
75;2021-10-02;1400;2748;1974438;1909697;91.9;88.9
75;2021-10-03;219;422;1974657;1910119;91.9;88.9
76;2020-12-27;0;0;0;0;0.0;0.0
76;2020-12-28;1;0;1;0;0.0;0.0
76;2020-12-29;0;0;1;0;0.0;0.0
76;2020-12-30;0;0;1;0;0.0;0.0
76;2020-12-31;0;0;1;0;0.0;0.0
76;2021-01-01;0;0;1;0;0.0;0.0
76;2021-01-02;0;0;1;0;0.0;0.0
76;2021-01-03;0;0;1;0;0.0;0.0
76;2021-01-04;17;0;18;0;0.0;0.0
76;2021-01-05;138;0;156;0;0.0;0.0
76;2021-01-06;682;2;838;2;0.1;0.0
76;2021-01-07;1354;7;2192;9;0.2;0.0
76;2021-01-08;1537;2;3729;11;0.3;0.0
76;2021-01-09;735;2;4464;13;0.4;0.0
76;2021-01-10;492;1;4956;14;0.4;0.0
76;2021-01-11;1358;2;6314;16;0.5;0.0
76;2021-01-12;1358;2;7672;18;0.6;0.0
76;2021-01-13;1187;4;8859;22;0.7;0.0
76;2021-01-14;2178;23;11037;45;0.9;0.0
76;2021-01-15;1910;9;12947;54;1.0;0.0
76;2021-01-16;990;7;13937;61;1.1;0.0
76;2021-01-17;2898;19;16835;80;1.4;0.0
76;2021-01-18;4395;16;21230;96;1.7;0.0
76;2021-01-19;3021;8;24251;104;1.9;0.0
76;2021-01-20;2072;6;26323;110;2.1;0.0
76;2021-01-21;1773;4;28096;114;2.3;0.0
76;2021-01-22;1705;4;29801;118;2.4;0.0
76;2021-01-23;450;2;30251;120;2.4;0.0
76;2021-01-24;99;0;30350;120;2.4;0.0
76;2021-01-25;1475;135;31825;255;2.6;0.0
76;2021-01-26;1394;323;33219;578;2.7;0.0
76;2021-01-27;1341;411;34560;989;2.8;0.1
76;2021-01-28;1286;366;35846;1355;2.9;0.1
76;2021-01-29;1156;429;37002;1784;3.0;0.1
76;2021-01-30;283;274;37285;2058;3.0;0.2
76;2021-01-31;4;91;37289;2149;3.0;0.2
76;2021-02-01;841;738;38130;2887;3.1;0.2
76;2021-02-02;1055;941;39185;3828;3.2;0.3
76;2021-02-03;921;901;40106;4729;3.2;0.4
76;2021-02-04;976;1366;41082;6095;3.3;0.5
76;2021-02-05;975;1036;42057;7131;3.4;0.6
76;2021-02-06;263;770;42320;7901;3.4;0.6
76;2021-02-07;468;1481;42788;9382;3.4;0.8
76;2021-02-08;1921;3328;44709;12710;3.6;1.0
76;2021-02-09;1753;2600;46462;15310;3.7;1.2
76;2021-02-10;1488;1610;47950;16920;3.9;1.4
76;2021-02-11;1680;1297;49630;18217;4.0;1.5
76;2021-02-12;1706;1349;51336;19566;4.1;1.6
76;2021-02-13;230;278;51566;19844;4.1;1.6
76;2021-02-14;9;80;51575;19924;4.1;1.6
76;2021-02-15;552;1337;52127;21261;4.2;1.7
76;2021-02-16;742;1276;52869;22537;4.3;1.8
76;2021-02-17;626;1100;53495;23637;4.3;1.9
76;2021-02-18;780;1050;54275;24687;4.4;2.0
76;2021-02-19;870;1019;55145;25706;4.4;2.1
76;2021-02-20;270;228;55415;25934;4.5;2.1
76;2021-02-21;0;0;55415;25934;4.5;2.1
76;2021-02-22;371;943;55786;26877;4.5;2.2
76;2021-02-23;576;908;56362;27785;4.5;2.2
76;2021-02-24;600;902;56962;28687;4.6;2.3
76;2021-02-25;1665;956;58627;29643;4.7;2.4
76;2021-02-26;2171;817;60798;30460;4.9;2.4
76;2021-02-27;1109;229;61907;30689;5.0;2.5
76;2021-02-28;27;182;61934;30871;5.0;2.5
76;2021-03-01;830;1784;62764;32655;5.0;2.6
76;2021-03-02;1382;1464;64146;34119;5.2;2.7
76;2021-03-03;1942;1164;66088;35283;5.3;2.8
76;2021-03-04;2819;938;68907;36221;5.5;2.9
76;2021-03-05;4183;697;73090;36918;5.9;3.0
76;2021-03-06;3366;155;76456;37073;6.1;3.0
76;2021-03-07;1257;31;77713;37104;6.2;3.0
76;2021-03-08;2102;1101;79815;38205;6.4;3.1
76;2021-03-09;3574;1016;83389;39221;6.7;3.2
76;2021-03-10;3595;953;86984;40174;7.0;3.2
76;2021-03-11;5634;876;92618;41050;7.4;3.3
76;2021-03-12;6829;575;99447;41625;8.0;3.3
76;2021-03-13;4646;148;104093;41773;8.4;3.4
76;2021-03-14;1068;26;105161;41799;8.5;3.4
76;2021-03-15;2919;233;108080;42032;8.7;3.4
76;2021-03-16;2557;394;110637;42426;8.9;3.4
76;2021-03-17;2696;308;113333;42734;9.1;3.4
76;2021-03-18;3003;306;116336;43040;9.4;3.5
76;2021-03-19;4398;429;120734;43469;9.7;3.5
76;2021-03-20;3974;287;124708;43756;10.0;3.5
76;2021-03-21;838;16;125546;43772;10.1;3.5
76;2021-03-22;3992;349;129538;44121;10.4;3.5
76;2021-03-23;5711;355;135249;44476;10.9;3.6
76;2021-03-24;5701;394;140950;44870;11.3;3.6
76;2021-03-25;7505;576;148455;45446;11.9;3.7
76;2021-03-26;8722;590;157177;46036;12.6;3.7
76;2021-03-27;4809;392;161986;46428;13.0;3.7
76;2021-03-28;1021;32;163007;46460;13.1;3.7
76;2021-03-29;5388;817;168395;47277;13.5;3.8
76;2021-03-30;6587;1054;174982;48331;14.1;3.9
76;2021-03-31;6462;1256;181444;49587;14.6;4.0
76;2021-04-01;6785;2012;188229;51599;15.1;4.1
76;2021-04-02;6485;2676;194714;54275;15.7;4.4
76;2021-04-03;2442;1077;197156;55352;15.9;4.5
76;2021-04-04;265;10;197421;55362;15.9;4.5
76;2021-04-05;869;377;198290;55739;15.9;4.5
76;2021-04-06;3556;2780;201846;58519;16.2;4.7
76;2021-04-07;4415;2392;206261;60911;16.6;4.9
76;2021-04-08;5841;2776;212102;63687;17.1;5.1
76;2021-04-09;8803;3070;220905;66757;17.8;5.4
76;2021-04-10;4876;1424;225781;68181;18.2;5.5
76;2021-04-11;814;535;226595;68716;18.2;5.5
76;2021-04-12;4726;2845;231321;71561;18.6;5.8
76;2021-04-13;5925;2853;237246;74414;19.1;6.0
76;2021-04-14;4802;3126;242048;77540;19.5;6.2
76;2021-04-15;5562;3352;247610;80892;19.9;6.5
76;2021-04-16;7354;3441;254964;84333;20.5;6.8
76;2021-04-17;4387;1430;259351;85763;20.9;6.9
76;2021-04-18;339;141;259690;85904;20.9;6.9
76;2021-04-19;3478;3767;263168;89671;21.2;7.2
76;2021-04-20;4344;4276;267512;93947;21.5;7.6
76;2021-04-21;4192;4680;271704;98627;21.8;7.9
76;2021-04-22;4564;5435;276268;104062;22.2;8.4
76;2021-04-23;5444;5970;281712;110032;22.6;8.8
76;2021-04-24;4165;2190;285877;112222;23.0;9.0
76;2021-04-25;894;268;286771;112490;23.1;9.0
76;2021-04-26;4484;4461;291255;116951;23.4;9.4
76;2021-04-27;5000;4981;296255;121932;23.8;9.8
76;2021-04-28;5348;4144;301603;126076;24.2;10.1
76;2021-04-29;6926;4143;308529;130219;24.8;10.5
76;2021-04-30;8219;4606;316748;134825;25.5;10.8
76;2021-05-01;4827;1013;321575;135838;25.9;10.9
76;2021-05-02;1842;265;323417;136103;26.0;10.9
76;2021-05-03;4703;3297;328120;139400;26.4;11.2
76;2021-05-04;4821;4535;332941;143935;26.8;11.6
76;2021-05-05;4783;5167;337724;149102;27.2;12.0
76;2021-05-06;5923;5565;343647;154667;27.6;12.4
76;2021-05-07;6137;6738;349784;161405;28.1;13.0
76;2021-05-08;5056;909;354840;162314;28.5;13.0
76;2021-05-09;2538;234;357378;162548;28.7;13.1
76;2021-05-10;4947;5060;362325;167608;29.1;13.5
76;2021-05-11;6519;5675;368844;173283;29.7;13.9
76;2021-05-12;6263;5081;375107;178364;30.2;14.3
76;2021-05-13;8842;1284;383949;179648;30.9;14.4
76;2021-05-14;10415;4659;394364;184307;31.7;14.8
76;2021-05-15;9118;2457;403482;186764;32.4;15.0
76;2021-05-16;6236;479;409718;187243;32.9;15.1
76;2021-05-17;7226;3272;416944;190515;33.5;15.3
76;2021-05-18;8304;2815;425248;193330;34.2;15.5
76;2021-05-19;8401;3200;433649;196530;34.9;15.8
76;2021-05-20;9651;3425;443300;199955;35.6;16.1
76;2021-05-21;8369;4087;451669;204042;36.3;16.4
76;2021-05-22;7163;2357;458832;206399;36.9;16.6
76;2021-05-23;6388;416;465220;206815;37.4;16.6
76;2021-05-24;6864;1524;472084;208339;38.0;16.8
76;2021-05-25;8024;4084;480108;212423;38.6;17.1
76;2021-05-26;7570;3608;487678;216031;39.2;17.4
76;2021-05-27;8340;4695;496018;220726;39.9;17.7
76;2021-05-28;8231;6537;504249;227263;40.5;18.3
76;2021-05-29;6225;3511;510474;230774;41.0;18.6
76;2021-05-30;3149;431;513623;231205;41.3;18.6
76;2021-05-31;8166;3951;521789;235156;42.0;18.9
76;2021-06-01;9208;5018;530997;240174;42.7;19.3
76;2021-06-02;7929;4442;538926;244616;43.3;19.7
76;2021-06-03;9540;5392;548466;250008;44.1;20.1
76;2021-06-04;9240;6663;557706;256671;44.8;20.6
76;2021-06-05;6285;3800;563991;260471;45.3;20.9
76;2021-06-06;2556;650;566547;261121;45.6;21.0
76;2021-06-07;6978;5443;573525;266564;46.1;21.4
76;2021-06-08;8660;6266;582185;272830;46.8;21.9
76;2021-06-09;7210;6072;589395;278902;47.4;22.4
76;2021-06-10;7999;6557;597394;285459;48.0;23.0
76;2021-06-11;7575;8229;604969;293688;48.6;23.6
76;2021-06-12;7166;5876;612135;299564;49.2;24.1
76;2021-06-13;2961;1295;615096;300859;49.5;24.2
76;2021-06-14;6486;6719;621582;307578;50.0;24.7
76;2021-06-15;6300;7471;627882;315049;50.5;25.3
76;2021-06-16;6651;7483;634533;322532;51.0;25.9
76;2021-06-17;7011;7751;641544;330283;51.6;26.6
76;2021-06-18;7687;9225;649231;339508;52.2;27.3
76;2021-06-19;5987;6256;655218;345764;52.7;27.8
76;2021-06-20;2809;1818;658027;347582;52.9;27.9
76;2021-06-21;5589;8176;663616;355758;53.4;28.6
76;2021-06-22;4923;9866;668539;365624;53.8;29.4
76;2021-06-23;4727;9433;673266;375057;54.1;30.2
76;2021-06-24;4797;9913;678063;384970;54.5;31.0
76;2021-06-25;5220;11579;683283;396549;54.9;31.9
76;2021-06-26;3454;7874;686737;404423;55.2;32.5
76;2021-06-27;1367;5162;688104;409585;55.3;32.9
76;2021-06-28;3612;9947;691716;419532;55.6;33.7
76;2021-06-29;3873;10219;695589;429751;55.9;34.6
76;2021-06-30;4267;9836;699856;439587;56.3;35.3
76;2021-07-01;4596;9906;704452;449493;56.6;36.1
76;2021-07-02;4368;12004;708820;461497;57.0;37.1
76;2021-07-03;3584;8447;712404;469944;57.3;37.8
76;2021-07-04;1487;5305;713891;475249;57.4;38.2
76;2021-07-05;3956;9331;717847;484580;57.7;39.0
76;2021-07-06;4056;10074;721903;494654;58.0;39.8
76;2021-07-07;4012;9322;725915;503976;58.4;40.5
76;2021-07-08;4464;9457;730379;513433;58.7;41.3
76;2021-07-09;4364;12408;734743;525841;59.1;42.3
76;2021-07-10;3138;8548;737881;534389;59.3;43.0
76;2021-07-11;1777;2821;739658;537210;59.5;43.2
76;2021-07-12;3155;11149;742813;548359;59.7;44.1
76;2021-07-13;4934;12260;747747;560619;60.1;45.1
76;2021-07-14;4803;5547;752550;566166;60.5;45.5
76;2021-07-15;5912;11786;758462;577952;61.0;46.5
76;2021-07-16;6720;12007;765182;589959;61.5;47.4
76;2021-07-17;5277;8708;770459;598667;61.9;48.1
76;2021-07-18;2257;3357;772716;602024;62.1;48.4
76;2021-07-19;5160;11147;777876;613171;62.5;49.3
76;2021-07-20;6276;11617;784152;624788;63.0;50.2
76;2021-07-21;6342;10563;790494;635351;63.6;51.1
76;2021-07-22;8240;9651;798734;645002;64.2;51.9
76;2021-07-23;7642;11997;806376;656999;64.8;52.8
76;2021-07-24;4992;7716;811368;664715;65.2;53.4
76;2021-07-25;2873;3139;814241;667854;65.5;53.7
76;2021-07-26;5433;10144;819674;677998;65.9;54.5
76;2021-07-27;8337;9550;828011;687548;66.6;55.3
76;2021-07-28;8269;7824;836280;695372;67.2;55.9
76;2021-07-29;9589;6991;845869;702363;68.0;56.5
76;2021-07-30;8012;7845;853881;710208;68.7;57.1
76;2021-07-31;6613;5333;860494;715541;69.2;57.5
76;2021-08-01;3863;2085;864357;717626;69.5;57.7
76;2021-08-02;6561;7098;870918;724724;70.0;58.3
76;2021-08-03;7972;6359;878890;731083;70.7;58.8
76;2021-08-04;7259;5841;886149;736924;71.2;59.2
76;2021-08-05;8099;5726;894248;742650;71.9;59.7
76;2021-08-06;6810;6874;901058;749524;72.4;60.3
76;2021-08-07;4792;4383;905850;753907;72.8;60.6
76;2021-08-08;2408;2157;908258;756064;73.0;60.8
76;2021-08-09;5637;6738;913895;762802;73.5;61.3
76;2021-08-10;6351;6555;920246;769357;74.0;61.9
76;2021-08-11;6451;5495;926697;774852;74.5;62.3
76;2021-08-12;6044;6061;932741;780913;75.0;62.8
76;2021-08-13;5058;6207;937799;787120;75.4;63.3
76;2021-08-14;3839;4599;941638;791719;75.7;63.7
76;2021-08-15;1578;2357;943216;794076;75.8;63.8
76;2021-08-16;3665;6718;946881;800794;76.1;64.4
76;2021-08-17;3919;6946;950800;807740;76.4;64.9
76;2021-08-18;3747;6735;954547;814475;76.7;65.5
76;2021-08-19;3390;7170;957937;821645;77.0;66.1
76;2021-08-20;3433;7831;961370;829476;77.3;66.7
76;2021-08-21;1823;4220;963193;833696;77.4;67.0
76;2021-08-22;869;3295;964062;836991;77.5;67.3
76;2021-08-23;2624;7760;966686;844751;77.7;67.9
76;2021-08-24;2823;7591;969509;852342;77.9;68.5
76;2021-08-25;2629;7079;972138;859421;78.2;69.1
76;2021-08-26;2075;5799;974213;865220;78.3;69.6
76;2021-08-27;2695;7951;976908;873171;78.5;70.2
76;2021-08-28;2137;6063;979045;879234;78.7;70.7
76;2021-08-29;698;3013;979743;882247;78.8;70.9
76;2021-08-30;2167;7446;981910;889693;78.9;71.5
76;2021-08-31;1943;7336;983853;897029;79.1;72.1
76;2021-09-01;1722;6891;985575;903920;79.2;72.7
76;2021-09-02;1306;4993;986881;908913;79.3;73.1
76;2021-09-03;1593;7210;988474;916123;79.5;73.7
76;2021-09-04;1616;6345;990090;922468;79.6;74.2
76;2021-09-05;635;1948;990725;924416;79.7;74.3
76;2021-09-06;1311;5065;992036;929481;79.8;74.7
76;2021-09-07;1165;4405;993201;933886;79.9;75.1
76;2021-09-08;1274;5081;994475;938967;80.0;75.5
76;2021-09-09;1092;3578;995567;942545;80.0;75.8
76;2021-09-10;1699;4838;997266;947383;80.2;76.2
76;2021-09-11;1167;3608;998433;950991;80.3;76.5
76;2021-09-12;286;893;998719;951884;80.3;76.5
76;2021-09-13;823;3185;999542;955069;80.4;76.8
76;2021-09-14;1374;3679;1000916;958748;80.5;77.1
76;2021-09-15;1168;3266;1002084;962014;80.6;77.3
76;2021-09-16;1269;1954;1003353;963968;80.7;77.5
76;2021-09-17;1403;2897;1004756;966865;80.8;77.7
76;2021-09-18;733;2510;1005489;969375;80.8;77.9
76;2021-09-19;195;776;1005684;970151;80.9;78.0
76;2021-09-20;841;1809;1006525;971960;80.9;78.1
76;2021-09-21;765;1596;1007290;973556;81.0;78.3
76;2021-09-22;675;2296;1007965;975852;81.0;78.5
76;2021-09-23;753;1169;1008718;977021;81.1;78.6
76;2021-09-24;1060;2041;1009778;979062;81.2;78.7
76;2021-09-25;574;2129;1010352;981191;81.2;78.9
76;2021-09-26;125;416;1010477;981607;81.2;78.9
76;2021-09-27;625;1345;1011102;982952;81.3;79.0
76;2021-09-28;503;1123;1011605;984075;81.3;79.1
76;2021-09-29;783;1586;1012388;985661;81.4;79.2
76;2021-09-30;422;879;1012810;986540;81.4;79.3
76;2021-10-01;847;1697;1013657;988237;81.5;79.5
76;2021-10-02;582;1304;1014239;989541;81.5;79.6
76;2021-10-03;129;385;1014368;989926;81.6;79.6
77;2020-12-27;1;0;1;0;0.0;0.0
77;2020-12-28;2;0;3;0;0.0;0.0
77;2020-12-29;0;0;3;0;0.0;0.0
77;2020-12-30;0;0;3;0;0.0;0.0
77;2020-12-31;0;0;3;0;0.0;0.0
77;2021-01-01;4;0;7;0;0.0;0.0
77;2021-01-02;2;0;9;0;0.0;0.0
77;2021-01-03;0;0;9;0;0.0;0.0
77;2021-01-04;7;0;16;0;0.0;0.0
77;2021-01-05;199;0;215;0;0.0;0.0
77;2021-01-06;237;2;452;2;0.0;0.0
77;2021-01-07;521;4;973;6;0.1;0.0
77;2021-01-08;621;0;1594;6;0.1;0.0
77;2021-01-09;273;1;1867;7;0.1;0.0
77;2021-01-10;235;2;2102;9;0.1;0.0
77;2021-01-11;782;3;2884;12;0.2;0.0
77;2021-01-12;884;1;3768;13;0.3;0.0
77;2021-01-13;941;1;4709;14;0.3;0.0
77;2021-01-14;849;7;5558;21;0.4;0.0
77;2021-01-15;859;10;6417;31;0.5;0.0
77;2021-01-16;168;1;6585;32;0.5;0.0
77;2021-01-17;132;2;6717;34;0.5;0.0
77;2021-01-18;1195;4;7912;38;0.6;0.0
77;2021-01-19;1722;13;9634;51;0.7;0.0
77;2021-01-20;2540;9;12174;60;0.9;0.0
77;2021-01-21;2062;25;14236;85;1.0;0.0
77;2021-01-22;1148;7;15384;92;1.1;0.0
77;2021-01-23;350;0;15734;92;1.1;0.0
77;2021-01-24;45;0;15779;92;1.1;0.0
77;2021-01-25;940;22;16719;114;1.2;0.0
77;2021-01-26;1715;24;18434;138;1.3;0.0
77;2021-01-27;1364;23;19798;161;1.4;0.0
77;2021-01-28;1699;89;21497;250;1.5;0.0
77;2021-01-29;1289;139;22786;389;1.6;0.0
77;2021-01-30;211;2;22997;391;1.6;0.0
77;2021-01-31;1;0;22998;391;1.6;0.0
77;2021-02-01;570;191;23568;582;1.7;0.0
77;2021-02-02;872;243;24440;825;1.7;0.1
77;2021-02-03;795;490;25235;1315;1.8;0.1
77;2021-02-04;789;758;26024;2073;1.8;0.1
77;2021-02-05;857;765;26881;2838;1.9;0.2
77;2021-02-06;165;95;27046;2933;1.9;0.2
77;2021-02-07;17;87;27063;3020;1.9;0.2
77;2021-02-08;498;826;27561;3846;1.9;0.3
77;2021-02-09;590;1351;28151;5197;2.0;0.4
77;2021-02-10;1030;1673;29181;6870;2.0;0.5
77;2021-02-11;1060;1504;30241;8374;2.1;0.6
77;2021-02-12;1098;1036;31339;9410;2.2;0.7
77;2021-02-13;189;167;31528;9577;2.2;0.7
77;2021-02-14;12;56;31540;9633;2.2;0.7
77;2021-02-15;555;723;32095;10356;2.3;0.7
77;2021-02-16;598;1176;32693;11532;2.3;0.8
77;2021-02-17;514;962;33207;12494;2.3;0.9
77;2021-02-18;839;1344;34046;13838;2.4;1.0
77;2021-02-19;776;904;34822;14742;2.4;1.0
77;2021-02-20;54;131;34876;14873;2.4;1.0
77;2021-02-21;7;31;34883;14904;2.5;1.0
77;2021-02-22;303;540;35186;15444;2.5;1.1
77;2021-02-23;360;817;35546;16261;2.5;1.1
77;2021-02-24;513;657;36059;16918;2.5;1.2
77;2021-02-25;794;737;36853;17655;2.6;1.2
77;2021-02-26;840;661;37693;18316;2.6;1.3
77;2021-02-27;459;119;38152;18435;2.7;1.3
77;2021-02-28;33;5;38185;18440;2.7;1.3
77;2021-03-01;679;575;38864;19015;2.7;1.3
77;2021-03-02;1091;872;39955;19887;2.8;1.4
77;2021-03-03;1958;1039;41913;20926;2.9;1.5
77;2021-03-04;2795;994;44708;21920;3.1;1.5
77;2021-03-05;3374;904;48082;22824;3.4;1.6
77;2021-03-06;4827;247;52909;23071;3.7;1.6
77;2021-03-07;3194;111;56103;23182;3.9;1.6
77;2021-03-08;1230;461;57333;23643;4.0;1.7
77;2021-03-09;2508;569;59841;24212;4.2;1.7
77;2021-03-10;2397;528;62238;24740;4.4;1.7
77;2021-03-11;3502;747;65740;25487;4.6;1.8
77;2021-03-12;3890;654;69630;26141;4.9;1.8
77;2021-03-13;4478;199;74108;26340;5.2;1.9
77;2021-03-14;2153;111;76261;26451;5.4;1.9
77;2021-03-15;2511;269;78772;26720;5.5;1.9
77;2021-03-16;2444;371;81216;27091;5.7;1.9
77;2021-03-17;2555;417;83771;27508;5.9;1.9
77;2021-03-18;3011;387;86782;27895;6.1;2.0
77;2021-03-19;3358;427;90140;28322;6.3;2.0
77;2021-03-20;1967;77;92107;28399;6.5;2.0
77;2021-03-21;243;14;92350;28413;6.5;2.0
77;2021-03-22;3019;393;95369;28806;6.7;2.0
77;2021-03-23;4520;522;99889;29328;7.0;2.1
77;2021-03-24;4156;612;104045;29940;7.3;2.1
77;2021-03-25;5907;400;109952;30340;7.7;2.1
77;2021-03-26;6267;450;116219;30790;8.2;2.2
77;2021-03-27;3323;123;119542;30913;8.4;2.2
77;2021-03-28;1730;49;121272;30962;8.5;2.2
77;2021-03-29;2654;684;123926;31646;8.7;2.2
77;2021-03-30;3995;1179;127921;32825;9.0;2.3
77;2021-03-31;3755;1217;131676;34042;9.2;2.4
77;2021-04-01;4141;1797;135817;35839;9.5;2.5
77;2021-04-02;3992;2007;139809;37846;9.8;2.7
77;2021-04-03;1743;2271;141552;40117;9.9;2.8
77;2021-04-04;421;1424;141973;41541;10.0;2.9
77;2021-04-05;161;164;142134;41705;10.0;2.9
77;2021-04-06;2721;1923;144855;43628;10.2;3.1
77;2021-04-07;3320;2085;148175;45713;10.4;3.2
77;2021-04-08;4532;2363;152707;48076;10.7;3.4
77;2021-04-09;4854;2086;157561;50162;11.1;3.5
77;2021-04-10;3074;2750;160635;52912;11.3;3.7
77;2021-04-11;586;717;161221;53629;11.3;3.8
77;2021-04-12;2230;1820;163451;55449;11.5;3.9
77;2021-04-13;3359;2634;166810;58083;11.7;4.1
77;2021-04-14;2519;2651;169329;60734;11.9;4.3
77;2021-04-15;3319;3113;172648;63847;12.1;4.5
77;2021-04-16;3575;2717;176223;66564;12.4;4.7
77;2021-04-17;1386;477;177609;67041;12.5;4.7
77;2021-04-18;150;11;177759;67052;12.5;4.7
77;2021-04-19;2083;2512;179842;69564;12.6;4.9
77;2021-04-20;2572;3379;182414;72943;12.8;5.1
77;2021-04-21;2194;3472;184608;76415;13.0;5.4
77;2021-04-22;3002;3855;187610;80270;13.2;5.6
77;2021-04-23;3531;3634;191141;83904;13.4;5.9
77;2021-04-24;4899;2498;196040;86402;13.8;6.1
77;2021-04-25;4078;1239;200118;87641;14.1;6.2
77;2021-04-26;3225;2041;203343;89682;14.3;6.3
77;2021-04-27;3996;2506;207339;92188;14.6;6.5
77;2021-04-28;4067;2606;211406;94794;14.9;6.7
77;2021-04-29;4482;3063;215888;97857;15.2;6.9
77;2021-04-30;4911;3327;220799;101184;15.5;7.1
77;2021-05-01;2465;593;223264;101777;15.7;7.1
77;2021-05-02;3141;276;226405;102053;15.9;7.2
77;2021-05-03;5991;2069;232396;104122;16.3;7.3
77;2021-05-04;6437;2990;238833;107112;16.8;7.5
77;2021-05-05;6018;3022;244851;110134;17.2;7.7
77;2021-05-06;6886;3590;251737;113724;17.7;8.0
77;2021-05-07;8204;3257;259941;116981;18.3;8.2
77;2021-05-08;5718;810;265659;117791;18.7;8.3
77;2021-05-09;4904;482;270563;118273;19.0;8.3
77;2021-05-10;8086;2327;278649;120600;19.6;8.5
77;2021-05-11;9577;2911;288226;123511;20.2;8.7
77;2021-05-12;8977;2277;297203;125788;20.9;8.8
77;2021-05-13;9302;879;306505;126667;21.5;8.9
77;2021-05-14;10438;1669;316943;128336;22.3;9.0
77;2021-05-15;8991;1247;325934;129583;22.9;9.1
77;2021-05-16;5151;470;331085;130053;23.3;9.1
77;2021-05-17;10371;1477;341456;131530;24.0;9.2
77;2021-05-18;11786;1803;353242;133333;24.8;9.4
77;2021-05-19;10917;1600;364159;134933;25.6;9.5
77;2021-05-20;12214;2154;376373;137087;26.4;9.6
77;2021-05-21;11652;2695;388025;139782;27.3;9.8
77;2021-05-22;9817;1737;397842;141519;27.9;9.9
77;2021-05-23;6978;815;404820;142334;28.4;10.0
77;2021-05-24;6762;778;411582;143112;28.9;10.1
77;2021-05-25;8315;2817;419897;145929;29.5;10.3
77;2021-05-26;7561;2978;427458;148907;30.0;10.5
77;2021-05-27;7552;3968;435010;152875;30.6;10.7
77;2021-05-28;7633;3996;442643;156871;31.1;11.0
77;2021-05-29;7353;2319;449996;159190;31.6;11.2
77;2021-05-30;4355;891;454351;160081;31.9;11.2
77;2021-05-31;8382;3833;462733;163914;32.5;11.5
77;2021-06-01;9645;4372;472378;168286;33.2;11.8
77;2021-06-02;9005;3928;481383;172214;33.8;12.1
77;2021-06-03;9001;5258;490384;177472;34.4;12.5
77;2021-06-04;9114;5490;499498;182962;35.1;12.9
77;2021-06-05;6660;4982;506158;187944;35.6;13.2
77;2021-06-06;4909;3210;511067;191154;35.9;13.4
77;2021-06-07;6421;4535;517488;195689;36.4;13.7
77;2021-06-08;5726;5223;523214;200912;36.8;14.1
77;2021-06-09;5059;4956;528273;205868;37.1;14.5
77;2021-06-10;5014;5455;533287;211323;37.5;14.8
77;2021-06-11;5752;6025;539039;217348;37.9;15.3
77;2021-06-12;6543;4752;545582;222100;38.3;15.6
77;2021-06-13;3507;3052;549089;225152;38.6;15.8
77;2021-06-14;3218;7932;552307;233084;38.8;16.4
77;2021-06-15;4126;8477;556433;241561;39.1;17.0
77;2021-06-16;4804;8378;561237;249939;39.4;17.6
77;2021-06-17;4467;9021;565704;258960;39.7;18.2
77;2021-06-18;4364;9785;570068;268745;40.0;18.9
77;2021-06-19;5305;6931;575373;275676;40.4;19.4
77;2021-06-20;2096;3801;577469;279477;40.6;19.6
77;2021-06-21;3228;9580;580697;289057;40.8;20.3
77;2021-06-22;3665;11371;584362;300428;41.0;21.1
77;2021-06-23;3443;10050;587805;310478;41.3;21.8
77;2021-06-24;3359;10911;591164;321389;41.5;22.6
77;2021-06-25;3622;10798;594786;332187;41.8;23.3
77;2021-06-26;4086;10070;598872;342257;42.1;24.0
77;2021-06-27;2123;6427;600995;348684;42.2;24.5
77;2021-06-28;2796;10830;603791;359514;42.4;25.3
77;2021-06-29;3415;12524;607206;372038;42.7;26.1
77;2021-06-30;3290;11450;610496;383488;42.9;26.9
77;2021-07-01;3296;11649;613792;395137;43.1;27.8
77;2021-07-02;3463;12253;617255;407390;43.4;28.6
77;2021-07-03;3182;10801;620437;418191;43.6;29.4
77;2021-07-04;1996;6490;622433;424681;43.7;29.8
77;2021-07-05;3584;9541;626017;434222;44.0;30.5
77;2021-07-06;3736;9525;629753;443747;44.2;31.2
77;2021-07-07;4051;8950;633804;452697;44.5;31.8
77;2021-07-08;3934;8760;637738;461457;44.8;32.4
77;2021-07-09;4712;10339;642450;471796;45.1;33.1
77;2021-07-10;4043;9841;646493;481637;45.4;33.8
77;2021-07-11;3090;5093;649583;486730;45.6;34.2
77;2021-07-12;3285;10871;652868;497601;45.9;35.0
77;2021-07-13;6161;12036;659029;509637;46.3;35.8
77;2021-07-14;3602;6447;662631;516084;46.5;36.3
77;2021-07-15;7189;11972;669820;528056;47.1;37.1
77;2021-07-16;7824;9891;677644;537947;47.6;37.8
77;2021-07-17;5792;9464;683436;547411;48.0;38.5
77;2021-07-18;4137;5329;687573;552740;48.3;38.8
77;2021-07-19;7516;8955;695089;561695;48.8;39.5
77;2021-07-20;9662;8042;704751;569737;49.5;40.0
77;2021-07-21;9524;7481;714275;577218;50.2;40.5
77;2021-07-22;10558;7552;724833;584770;50.9;41.1
77;2021-07-23;9877;8207;734710;592977;51.6;41.7
77;2021-07-24;7215;7876;741925;600853;52.1;42.2
77;2021-07-25;5898;4036;747823;604889;52.5;42.5
77;2021-07-26;9210;5967;757033;610856;53.2;42.9
77;2021-07-27;10953;6047;767986;616903;53.9;43.3
77;2021-07-28;9491;6427;777477;623330;54.6;43.8
77;2021-07-29;9538;5513;787015;628843;55.3;44.2
77;2021-07-30;9744;6368;796759;635211;56.0;44.6
77;2021-07-31;7264;6632;804023;641843;56.5;45.1
77;2021-08-01;2953;1216;806976;643059;56.7;45.2
77;2021-08-02;7133;5733;814109;648792;57.2;45.6
77;2021-08-03;5855;4525;819964;653317;57.6;45.9
77;2021-08-04;4740;4388;824704;657705;57.9;46.2
77;2021-08-05;3260;2973;827964;660678;58.2;46.4
77;2021-08-06;5981;5262;833945;665940;58.6;46.8
77;2021-08-07;5294;6793;839239;672733;59.0;47.3
77;2021-08-08;1976;1863;841215;674596;59.1;47.4
77;2021-08-09;5092;6582;846307;681178;59.4;47.8
77;2021-08-10;2713;3579;849020;684757;59.6;48.1
77;2021-08-11;3143;6241;852163;690998;59.9;48.5
77;2021-08-12;2282;3575;854445;694573;60.0;48.8
77;2021-08-13;2736;4895;857181;699468;60.2;49.1
77;2021-08-14;2958;7331;860139;706799;60.4;49.6
77;2021-08-15;789;773;860928;707572;60.5;49.7
77;2021-08-16;2478;6986;863406;714558;60.6;50.2
77;2021-08-17;2896;7215;866302;721773;60.9;50.7
77;2021-08-18;2685;6562;868987;728335;61.0;51.2
77;2021-08-19;2652;5104;871639;733439;61.2;51.5
77;2021-08-20;2710;5686;874349;739125;61.4;51.9
77;2021-08-21;2716;7339;877065;746464;61.6;52.4
77;2021-08-22;1735;5344;878800;751808;61.7;52.8
77;2021-08-23;2513;9618;881313;761426;61.9;53.5
77;2021-08-24;3068;9244;884381;770670;62.1;54.1
77;2021-08-25;2564;6538;886945;777208;62.3;54.6
77;2021-08-26;2560;6255;889505;783463;62.5;55.0
77;2021-08-27;2779;6994;892284;790457;62.7;55.5
77;2021-08-28;1974;7250;894258;797707;62.8;56.0
77;2021-08-29;1482;5150;895740;802857;62.9;56.4
77;2021-08-30;2525;8152;898265;811009;63.1;57.0
77;2021-08-31;2850;5736;901115;816745;63.3;57.4
77;2021-09-01;2256;3851;903371;820596;63.5;57.6
77;2021-09-02;1609;3148;904980;823744;63.6;57.9
77;2021-09-03;2135;4561;907115;828305;63.7;58.2
77;2021-09-04;2420;5778;909535;834083;63.9;58.6
77;2021-09-05;901;1557;910436;835640;64.0;58.7
77;2021-09-06;1064;2319;911500;837959;64.0;58.9
77;2021-09-07;844;2291;912344;840250;64.1;59.0
77;2021-09-08;1714;3579;914058;843829;64.2;59.3
77;2021-09-09;973;2211;915031;846040;64.3;59.4
77;2021-09-10;1191;2567;916222;848607;64.4;59.6
77;2021-09-11;2038;5705;918260;854312;64.5;60.0
77;2021-09-12;521;1425;918781;855737;64.5;60.1
77;2021-09-13;879;2313;919660;858050;64.6;60.3
77;2021-09-14;1016;2155;920676;860205;64.7;60.4
77;2021-09-15;1172;2525;921848;862730;64.8;60.6
77;2021-09-16;953;1499;922801;864229;64.8;60.7
77;2021-09-17;1150;2019;923951;866248;64.9;60.8
77;2021-09-18;1296;3580;925247;869828;65.0;61.1
77;2021-09-19;232;1182;925479;871010;65.0;61.2
77;2021-09-20;823;1624;926302;872634;65.1;61.3
77;2021-09-21;794;1500;927096;874134;65.1;61.4
77;2021-09-22;751;2482;927847;876616;65.2;61.6
77;2021-09-23;568;1507;928415;878123;65.2;61.7
77;2021-09-24;806;1942;929221;880065;65.3;61.8
77;2021-09-25;1001;3955;930222;884020;65.3;62.1
77;2021-09-26;205;756;930427;884776;65.4;62.2
77;2021-09-27;645;1309;931072;886085;65.4;62.2
77;2021-09-28;772;843;931844;886928;65.5;62.3
77;2021-09-29;937;1972;932781;888900;65.5;62.4
77;2021-09-30;586;934;933367;889834;65.6;62.5
77;2021-10-01;623;1021;933990;890855;65.6;62.6
77;2021-10-02;944;2092;934934;892947;65.7;62.7
77;2021-10-03;127;469;935061;893416;65.7;62.8
78;2020-12-27;2;0;2;0;0.0;0.0
78;2020-12-28;1;1;3;1;0.0;0.0
78;2020-12-29;0;0;3;1;0.0;0.0
78;2020-12-30;1;0;4;1;0.0;0.0
78;2020-12-31;15;0;19;1;0.0;0.0
78;2021-01-01;1;0;20;1;0.0;0.0
78;2021-01-02;1;0;21;1;0.0;0.0
78;2021-01-03;3;0;24;1;0.0;0.0
78;2021-01-04;145;3;169;4;0.0;0.0
78;2021-01-05;175;1;344;5;0.0;0.0
78;2021-01-06;208;3;552;8;0.0;0.0
78;2021-01-07;470;2;1022;10;0.1;0.0
78;2021-01-08;651;3;1673;13;0.1;0.0
78;2021-01-09;22;0;1695;13;0.1;0.0
78;2021-01-10;2;0;1697;13;0.1;0.0
78;2021-01-11;791;3;2488;16;0.2;0.0
78;2021-01-12;945;5;3433;21;0.2;0.0
78;2021-01-13;741;8;4174;29;0.3;0.0
78;2021-01-14;812;9;4986;38;0.3;0.0
78;2021-01-15;848;10;5834;48;0.4;0.0
78;2021-01-16;32;0;5866;48;0.4;0.0
78;2021-01-17;0;0;5866;48;0.4;0.0
78;2021-01-18;1384;21;7250;69;0.5;0.0
78;2021-01-19;1841;28;9091;97;0.6;0.0
78;2021-01-20;1651;15;10742;112;0.7;0.0
78;2021-01-21;3258;16;14000;128;1.0;0.0
78;2021-01-22;2216;17;16216;145;1.1;0.0
78;2021-01-23;280;0;16496;145;1.1;0.0
78;2021-01-24;5;0;16501;145;1.1;0.0
78;2021-01-25;957;26;17458;171;1.2;0.0
78;2021-01-26;1560;19;19018;190;1.3;0.0
78;2021-01-27;2062;38;21080;228;1.5;0.0
78;2021-01-28;2439;89;23519;317;1.6;0.0
78;2021-01-29;1491;57;25010;374;1.7;0.0
78;2021-01-30;210;2;25220;376;1.7;0.0
78;2021-01-31;3;0;25223;376;1.7;0.0
78;2021-02-01;788;210;26011;586;1.8;0.0
78;2021-02-02;967;318;26978;904;1.9;0.1
78;2021-02-03;975;217;27953;1121;1.9;0.1
78;2021-02-04;1117;414;29070;1535;2.0;0.1
78;2021-02-05;1191;447;30261;1982;2.1;0.1
78;2021-02-06;200;44;30461;2026;2.1;0.1
78;2021-02-07;139;13;30600;2039;2.1;0.1
78;2021-02-08;760;538;31360;2577;2.2;0.2
78;2021-02-09;1121;860;32481;3437;2.2;0.2
78;2021-02-10;1245;1067;33726;4504;2.3;0.3
78;2021-02-11;1820;1680;35546;6184;2.5;0.4
78;2021-02-12;1820;1242;37366;7426;2.6;0.5
78;2021-02-13;173;63;37539;7489;2.6;0.5
78;2021-02-14;27;23;37566;7512;2.6;0.5
78;2021-02-15;448;1131;38014;8643;2.6;0.6
78;2021-02-16;628;1298;38642;9941;2.7;0.7
78;2021-02-17;588;1926;39230;11867;2.7;0.8
78;2021-02-18;998;1911;40228;13778;2.8;1.0
78;2021-02-19;820;1440;41048;15218;2.8;1.1
78;2021-02-20;148;102;41196;15320;2.8;1.1
78;2021-02-21;0;12;41196;15332;2.8;1.1
78;2021-02-22;502;809;41698;16141;2.9;1.1
78;2021-02-23;540;895;42238;17036;2.9;1.2
78;2021-02-24;619;1031;42857;18067;3.0;1.2
78;2021-02-25;867;916;43724;18983;3.0;1.3
78;2021-02-26;1131;1016;44855;19999;3.1;1.4
78;2021-02-27;740;115;45595;20114;3.1;1.4
78;2021-02-28;68;18;45663;20132;3.2;1.4
78;2021-03-01;966;702;46629;20834;3.2;1.4
78;2021-03-02;1727;885;48356;21719;3.3;1.5
78;2021-03-03;1965;1053;50321;22772;3.5;1.6
78;2021-03-04;2951;1412;53272;24184;3.7;1.7
78;2021-03-05;3256;1470;56528;25654;3.9;1.8
78;2021-03-06;6244;284;62772;25938;4.3;1.8
78;2021-03-07;3444;104;66216;26042;4.6;1.8
78;2021-03-08;1462;669;67678;26711;4.7;1.8
78;2021-03-09;2940;832;70618;27543;4.9;1.9
78;2021-03-10;3081;1034;73699;28577;5.1;2.0
78;2021-03-11;4177;1237;77876;29814;5.4;2.1
78;2021-03-12;5371;1285;83247;31099;5.7;2.1
78;2021-03-13;4657;199;87904;31298;6.1;2.2
78;2021-03-14;1036;41;88940;31339;6.1;2.2
78;2021-03-15;3620;266;92560;31605;6.4;2.2
78;2021-03-16;2567;561;95127;32166;6.6;2.2
78;2021-03-17;2969;434;98096;32600;6.8;2.3
78;2021-03-18;3780;443;101876;33043;7.0;2.3
78;2021-03-19;5317;484;107193;33527;7.4;2.3
78;2021-03-20;2260;129;109453;33656;7.6;2.3
78;2021-03-21;167;7;109620;33663;7.6;2.3
78;2021-03-22;3530;378;113150;34041;7.8;2.3
78;2021-03-23;5231;538;118381;34579;8.2;2.4
78;2021-03-24;4892;551;123273;35130;8.5;2.4
78;2021-03-25;6940;564;130213;35694;9.0;2.5
78;2021-03-26;6944;706;137157;36400;9.5;2.5
78;2021-03-27;3746;198;140903;36598;9.7;2.5
78;2021-03-28;1918;55;142821;36653;9.9;2.5
78;2021-03-29;3863;758;146684;37411;10.1;2.6
78;2021-03-30;5526;1049;152210;38460;10.5;2.7
78;2021-03-31;5334;1288;157544;39748;10.9;2.7
78;2021-04-01;5589;2349;163133;42097;11.3;2.9
78;2021-04-02;5194;2621;168327;44718;11.6;3.1
78;2021-04-03;2198;2562;170525;47280;11.8;3.3
78;2021-04-04;174;14;170699;47294;11.8;3.3
78;2021-04-05;199;19;170898;47313;11.8;3.3
78;2021-04-06;3618;2300;174516;49613;12.0;3.4
78;2021-04-07;4356;2583;178872;52196;12.3;3.6
78;2021-04-08;5524;2669;184396;54865;12.7;3.8
78;2021-04-09;6907;2441;191303;57306;13.2;4.0
78;2021-04-10;3995;1903;195298;59209;13.5;4.1
78;2021-04-11;374;606;195672;59815;13.5;4.1
78;2021-04-12;3531;2356;199203;62171;13.8;4.3
78;2021-04-13;5461;2499;204664;64670;14.1;4.5
78;2021-04-14;4954;3382;209618;68052;14.5;4.7
78;2021-04-15;4616;3852;214234;71904;14.8;5.0
78;2021-04-16;5625;4016;219859;75920;15.2;5.2
78;2021-04-17;3610;717;223469;76637;15.4;5.3
78;2021-04-18;272;42;223741;76679;15.4;5.3
78;2021-04-19;3246;2812;226987;79491;15.7;5.5
78;2021-04-20;4709;3682;231696;83173;16.0;5.7
78;2021-04-21;4533;3502;236229;86675;16.3;6.0
78;2021-04-22;4566;4693;240795;91368;16.6;6.3
78;2021-04-23;5059;4429;245854;95797;17.0;6.6
78;2021-04-24;4865;2614;250719;98411;17.3;6.8
78;2021-04-25;3049;1732;253768;100143;17.5;6.9
78;2021-04-26;4768;3317;258536;103460;17.8;7.1
78;2021-04-27;5474;4295;264010;107755;18.2;7.4
78;2021-04-28;5650;4773;269660;112528;18.6;7.8
78;2021-04-29;6263;4056;275923;116584;19.0;8.0
78;2021-04-30;7207;4445;283130;121029;19.5;8.4
78;2021-05-01;612;254;283742;121283;19.6;8.4
78;2021-05-02;2009;164;285751;121447;19.7;8.4
78;2021-05-03;7465;1272;293216;122719;20.2;8.5
78;2021-05-04;6076;3968;299292;126687;20.7;8.7
78;2021-05-05;7295;4545;306587;131232;21.2;9.1
78;2021-05-06;6480;5163;313067;136395;21.6;9.4
78;2021-05-07;8308;5112;321375;141507;22.2;9.8
78;2021-05-08;2916;1446;324291;142953;22.4;9.9
78;2021-05-09;2820;351;327111;143304;22.6;9.9
78;2021-05-10;7343;4447;334454;147751;23.1;10.2
78;2021-05-11;8143;5405;342597;153156;23.6;10.6
78;2021-05-12;8729;3913;351326;157069;24.3;10.8
78;2021-05-13;6628;600;357954;157669;24.7;10.9
78;2021-05-14;10216;2216;368170;159885;25.4;11.0
78;2021-05-15;4934;2359;373104;162244;25.8;11.2
78;2021-05-16;3697;792;376801;163036;26.0;11.3
78;2021-05-17;8741;1348;385542;164384;26.6;11.3
78;2021-05-18;9886;1894;395428;166278;27.3;11.5
78;2021-05-19;11650;1712;407078;167990;28.1;11.6
78;2021-05-20;11595;2262;418673;170252;28.9;11.8
78;2021-05-21;12120;2618;430793;172870;29.7;11.9
78;2021-05-22;6537;1357;437330;174227;30.2;12.0
78;2021-05-23;3125;390;440455;174617;30.4;12.1
78;2021-05-24;3521;417;443976;175034;30.6;12.1
78;2021-05-25;9983;2504;453959;177538;31.3;12.3
78;2021-05-26;10159;3776;464118;181314;32.0;12.5
78;2021-05-27;10947;4639;475065;185953;32.8;12.8
78;2021-05-28;11405;6012;486470;191965;33.6;13.3
78;2021-05-29;4228;3381;490698;195346;33.9;13.5
78;2021-05-30;135;345;490833;195691;33.9;13.5
78;2021-05-31;7967;5350;498800;201041;34.4;13.9
78;2021-06-01;10022;6515;508822;207556;35.1;14.3
78;2021-06-02;8581;6194;517403;213750;35.7;14.8
78;2021-06-03;9892;6470;527295;220220;36.4;15.2
78;2021-06-04;9794;8143;537089;228363;37.1;15.8
78;2021-06-05;5519;6129;542608;234492;37.5;16.2
78;2021-06-06;2150;2009;544758;236501;37.6;16.3
78;2021-06-07;8113;6513;552871;243014;38.2;16.8
78;2021-06-08;8064;7322;560935;250336;38.7;17.3
78;2021-06-09;7327;6724;568262;257060;39.2;17.7
78;2021-06-10;7105;7095;575367;264155;39.7;18.2
78;2021-06-11;7583;8182;582950;272337;40.2;18.8
78;2021-06-12;6374;2920;589324;275257;40.7;19.0
78;2021-06-13;946;2458;590270;277715;40.7;19.2
78;2021-06-14;3415;9807;593685;287522;41.0;19.8
78;2021-06-15;5794;8283;599479;295805;41.4;20.4
78;2021-06-16;5430;8619;604909;304424;41.8;21.0
78;2021-06-17;5481;8533;610390;312957;42.1;21.6
78;2021-06-18;6103;9801;616493;322758;42.6;22.3
78;2021-06-19;5219;4817;621712;327575;42.9;22.6
78;2021-06-20;625;2838;622337;330413;43.0;22.8
78;2021-06-21;4092;9468;626429;339881;43.2;23.5
78;2021-06-22;3349;10317;629778;350198;43.5;24.2
78;2021-06-23;3839;10392;633617;360590;43.7;24.9
78;2021-06-24;3794;9970;637411;370560;44.0;25.6
78;2021-06-25;3994;13143;641405;383703;44.3;26.5
78;2021-06-26;4209;7947;645614;391650;44.6;27.0
78;2021-06-27;1041;2540;646655;394190;44.6;27.2
78;2021-06-28;3286;10897;649941;405087;44.9;28.0
78;2021-06-29;3535;11246;653476;416333;45.1;28.7
78;2021-06-30;4110;13224;657586;429557;45.4;29.7
78;2021-07-01;4106;12700;661692;442257;45.7;30.5
78;2021-07-02;4260;13935;665952;456192;46.0;31.5
78;2021-07-03;3159;8618;669111;464810;46.2;32.1
78;2021-07-04;778;1742;669889;466552;46.2;32.2
78;2021-07-05;3383;9692;673272;476244;46.5;32.9
78;2021-07-06;3525;12039;676797;488283;46.7;33.7
78;2021-07-07;3821;11604;680618;499887;47.0;34.5
78;2021-07-08;3927;11676;684545;511563;47.3;35.3
78;2021-07-09;4759;12740;689304;524303;47.6;36.2
78;2021-07-10;2626;6611;691930;530914;47.8;36.6
78;2021-07-11;748;2047;692678;532961;47.8;36.8
78;2021-07-12;3037;11740;695715;544701;48.0;37.6
78;2021-07-13;5351;11972;701066;556673;48.4;38.4
78;2021-07-14;2532;4989;703598;561662;48.6;38.8
78;2021-07-15;5662;11953;709260;573615;49.0;39.6
78;2021-07-16;7320;10783;716580;584398;49.5;40.3
78;2021-07-17;4725;4889;721305;589287;49.8;40.7
78;2021-07-18;1158;471;722463;589758;49.9;40.7
78;2021-07-19;3877;10348;726340;600106;50.1;41.4
78;2021-07-20;5616;9922;731956;610028;50.5;42.1
78;2021-07-21;5905;9858;737861;619886;50.9;42.8
78;2021-07-22;5972;9293;743833;629179;51.3;43.4
78;2021-07-23;6259;9229;750092;638408;51.8;44.1
78;2021-07-24;2937;4966;753029;643374;52.0;44.4
78;2021-07-25;987;376;754016;643750;52.1;44.4
78;2021-07-26;4868;6986;758884;650736;52.4;44.9
78;2021-07-27;7598;6914;766482;657650;52.9;45.4
78;2021-07-28;6976;5933;773458;663583;53.4;45.8
78;2021-07-29;7901;6007;781359;669590;53.9;46.2
78;2021-07-30;7739;7049;789098;676639;54.5;46.7
78;2021-07-31;2653;2732;791751;679371;54.7;46.9
78;2021-08-01;109;72;791860;679443;54.7;46.9
78;2021-08-02;2444;2126;794304;681569;54.8;47.0
78;2021-08-03;4268;4251;798572;685820;55.1;47.3
78;2021-08-04;4462;2809;803034;688629;55.4;47.5
78;2021-08-05;3885;3172;806919;691801;55.7;47.8
78;2021-08-06;3978;3713;810897;695514;56.0;48.0
78;2021-08-07;2819;3442;813716;698956;56.2;48.2
78;2021-08-08;483;343;814199;699299;56.2;48.3
78;2021-08-09;1877;1662;816076;700961;56.3;48.4
78;2021-08-10;3413;3982;819489;704943;56.6;48.7
78;2021-08-11;2982;3383;822471;708326;56.8;48.9
78;2021-08-12;2746;3534;825217;711860;57.0;49.1
78;2021-08-13;2865;3186;828082;715046;57.2;49.4
78;2021-08-14;2301;2977;830383;718023;57.3;49.6
78;2021-08-15;318;375;830701;718398;57.3;49.6
78;2021-08-16;910;2339;831611;720737;57.4;49.8
78;2021-08-17;2795;4422;834406;725159;57.6;50.1
78;2021-08-18;2471;3819;836877;728978;57.8;50.3
78;2021-08-19;2237;3583;839114;732561;57.9;50.6
78;2021-08-20;2098;3998;841212;736559;58.1;50.8
78;2021-08-21;1883;3586;843095;740145;58.2;51.1
78;2021-08-22;87;147;843182;740292;58.2;51.1
78;2021-08-23;2153;4248;845335;744540;58.4;51.4
78;2021-08-24;3629;6972;848964;751512;58.6;51.9
78;2021-08-25;3296;6593;852260;758105;58.8;52.3
78;2021-08-26;2979;7236;855239;765341;59.0;52.8
78;2021-08-27;2862;7370;858101;772711;59.2;53.3
78;2021-08-28;2440;5276;860541;777987;59.4;53.7
78;2021-08-29;368;352;860909;778339;59.4;53.7
78;2021-08-30;2859;5071;863768;783410;59.6;54.1
78;2021-08-31;3453;5827;867221;789237;59.9;54.5
78;2021-09-01;2777;5289;869998;794526;60.1;54.8
78;2021-09-02;2095;4439;872093;798965;60.2;55.2
78;2021-09-03;2257;4720;874350;803685;60.4;55.5
78;2021-09-04;2475;4250;876825;807935;60.5;55.8
78;2021-09-05;292;383;877117;808318;60.5;55.8
78;2021-09-06;1286;3004;878403;811322;60.6;56.0
78;2021-09-07;1352;3510;879755;814832;60.7;56.2
78;2021-09-08;1679;3793;881434;818625;60.8;56.5
78;2021-09-09;1079;3312;882513;821937;60.9;56.7
78;2021-09-10;1370;3468;883883;825405;61.0;57.0
78;2021-09-11;2052;4198;885935;829603;61.2;57.3
78;2021-09-12;72;165;886007;829768;61.2;57.3
78;2021-09-13;776;2568;886783;832336;61.2;57.5
78;2021-09-14;1065;3819;887848;836155;61.3;57.7
78;2021-09-15;1202;3531;889050;839686;61.4;58.0
78;2021-09-16;841;2085;889891;841771;61.4;58.1
78;2021-09-17;1177;2838;891068;844609;61.5;58.3
78;2021-09-18;1393;4071;892461;848680;61.6;58.6
78;2021-09-19;145;407;892606;849087;61.6;58.6
78;2021-09-20;669;1707;893275;850794;61.7;58.7
78;2021-09-21;820;1977;894095;852771;61.7;58.9
78;2021-09-22;956;3512;895051;856283;61.8;59.1
78;2021-09-23;882;1634;895933;857917;61.8;59.2
78;2021-09-24;1010;2382;896943;860299;61.9;59.4
78;2021-09-25;1055;3917;897998;864216;62.0;59.7
78;2021-09-26;59;155;898057;864371;62.0;59.7
78;2021-09-27;678;1501;898735;865872;62.0;59.8
78;2021-09-28;828;1495;899563;867367;62.1;59.9
78;2021-09-29;1007;2157;900570;869524;62.2;60.0
78;2021-09-30;559;926;901129;870450;62.2;60.1
78;2021-10-01;926;1822;902055;872272;62.3;60.2
78;2021-10-02;1232;2460;903287;874732;62.4;60.4
78;2021-10-03;54;70;903341;874802;62.4;60.4
79;2020-12-27;0;0;0;0;0.0;0.0
79;2020-12-28;4;0;4;0;0.0;0.0
79;2020-12-29;0;0;4;0;0.0;0.0
79;2020-12-30;0;0;4;0;0.0;0.0
79;2020-12-31;0;0;4;0;0.0;0.0
79;2021-01-01;0;0;4;0;0.0;0.0
79;2021-01-02;0;0;4;0;0.0;0.0
79;2021-01-03;0;0;4;0;0.0;0.0
79;2021-01-04;1;0;5;0;0.0;0.0
79;2021-01-05;0;0;5;0;0.0;0.0
79;2021-01-06;0;0;5;0;0.0;0.0
79;2021-01-07;158;0;163;0;0.0;0.0
79;2021-01-08;165;0;328;0;0.1;0.0
79;2021-01-09;100;0;428;0;0.1;0.0
79;2021-01-10;3;0;431;0;0.1;0.0
79;2021-01-11;184;1;615;1;0.2;0.0
79;2021-01-12;245;1;860;2;0.2;0.0
79;2021-01-13;258;0;1118;2;0.3;0.0
79;2021-01-14;506;8;1624;10;0.4;0.0
79;2021-01-15;618;5;2242;15;0.6;0.0
79;2021-01-16;66;0;2308;15;0.6;0.0
79;2021-01-17;0;0;2308;15;0.6;0.0
79;2021-01-18;477;2;2785;17;0.7;0.0
79;2021-01-19;1361;2;4146;19;1.1;0.0
79;2021-01-20;1678;1;5824;20;1.6;0.0
79;2021-01-21;1999;7;7823;27;2.1;0.0
79;2021-01-22;875;4;8698;31;2.3;0.0
79;2021-01-23;65;0;8763;31;2.4;0.0
79;2021-01-24;0;0;8763;31;2.4;0.0
79;2021-01-25;646;7;9409;38;2.5;0.0
79;2021-01-26;593;13;10002;51;2.7;0.0
79;2021-01-27;740;81;10742;132;2.9;0.0
79;2021-01-28;735;128;11477;260;3.1;0.1
79;2021-01-29;495;81;11972;341;3.2;0.1
79;2021-01-30;0;0;11972;341;3.2;0.1
79;2021-01-31;0;0;11972;341;3.2;0.1
79;2021-02-01;207;105;12179;446;3.3;0.1
79;2021-02-02;334;73;12513;519;3.4;0.1
79;2021-02-03;391;56;12904;575;3.5;0.2
79;2021-02-04;326;107;13230;682;3.6;0.2
79;2021-02-05;360;273;13590;955;3.6;0.3
79;2021-02-06;6;0;13596;955;3.6;0.3
79;2021-02-07;22;0;13618;955;3.7;0.3
79;2021-02-08;283;159;13901;1114;3.7;0.3
79;2021-02-09;457;744;14358;1858;3.9;0.5
79;2021-02-10;619;1148;14977;3006;4.0;0.8
79;2021-02-11;777;1192;15754;4198;4.2;1.1
79;2021-02-12;471;711;16225;4909;4.4;1.3
79;2021-02-13;53;61;16278;4970;4.4;1.3
79;2021-02-14;0;0;16278;4970;4.4;1.3
79;2021-02-15;186;426;16464;5396;4.4;1.4
79;2021-02-16;333;642;16797;6038;4.5;1.6
79;2021-02-17;248;754;17045;6792;4.6;1.8
79;2021-02-18;353;847;17398;7639;4.7;2.1
79;2021-02-19;268;507;17666;8146;4.7;2.2
79;2021-02-20;5;18;17671;8164;4.7;2.2
79;2021-02-21;1;0;17672;8164;4.7;2.2
79;2021-02-22;137;400;17809;8564;4.8;2.3
79;2021-02-23;248;498;18057;9062;4.8;2.4
79;2021-02-24;246;461;18303;9523;4.9;2.6
79;2021-02-25;520;416;18823;9939;5.1;2.7
79;2021-02-26;599;348;19422;10287;5.2;2.8
79;2021-02-27;408;7;19830;10294;5.3;2.8
79;2021-02-28;35;0;19865;10294;5.3;2.8
79;2021-03-01;89;295;19954;10589;5.4;2.8
79;2021-03-02;302;453;20256;11042;5.4;3.0
79;2021-03-03;662;482;20918;11524;5.6;3.1
79;2021-03-04;904;524;21822;12048;5.9;3.2
79;2021-03-05;1218;408;23040;12456;6.2;3.3
79;2021-03-06;611;6;23651;12462;6.3;3.3
79;2021-03-07;77;1;23728;12463;6.4;3.3
79;2021-03-08;344;279;24072;12742;6.5;3.4
79;2021-03-09;842;311;24914;13053;6.7;3.5
79;2021-03-10;1146;374;26060;13427;7.0;3.6
79;2021-03-11;1639;306;27699;13733;7.4;3.7
79;2021-03-12;1721;111;29420;13844;7.9;3.7
79;2021-03-13;1135;13;30555;13857;8.2;3.7
79;2021-03-14;50;0;30605;13857;8.2;3.7
79;2021-03-15;497;157;31102;14014;8.3;3.8
79;2021-03-16;735;146;31837;14160;8.5;3.8
79;2021-03-17;578;107;32415;14267;8.7;3.8
79;2021-03-18;553;198;32968;14465;8.8;3.9
79;2021-03-19;661;256;33629;14721;9.0;4.0
79;2021-03-20;1007;14;34636;14735;9.3;4.0
79;2021-03-21;3;0;34639;14735;9.3;4.0
79;2021-03-22;957;204;35596;14939;9.6;4.0
79;2021-03-23;1595;169;37191;15108;10.0;4.1
79;2021-03-24;1831;162;39022;15270;10.5;4.1
79;2021-03-25;2499;192;41521;15462;11.1;4.1
79;2021-03-26;2406;137;43927;15599;11.8;4.2
79;2021-03-27;768;18;44695;15617;12.0;4.2
79;2021-03-28;1;0;44696;15617;12.0;4.2
79;2021-03-29;2148;115;46844;15732;12.6;4.2
79;2021-03-30;2817;64;49661;15796;13.3;4.2
79;2021-03-31;2777;381;52438;16177;14.1;4.3
79;2021-04-01;2698;383;55136;16560;14.8;4.4
79;2021-04-02;2823;394;57959;16954;15.6;4.5
79;2021-04-03;634;53;58593;17007;15.7;4.6
79;2021-04-04;3;0;58596;17007;15.7;4.6
79;2021-04-05;381;4;58977;17011;15.8;4.6
79;2021-04-06;1792;583;60769;17594;16.3;4.7
79;2021-04-07;3114;728;63883;18322;17.1;4.9
79;2021-04-08;2632;698;66515;19020;17.9;5.1
79;2021-04-09;3737;541;70252;19561;18.9;5.2
79;2021-04-10;1466;387;71718;19948;19.2;5.4
79;2021-04-11;4;0;71722;19948;19.2;5.4
79;2021-04-12;1753;353;73475;20301;19.7;5.4
79;2021-04-13;2174;748;75649;21049;20.3;5.6
79;2021-04-14;2480;678;78129;21727;21.0;5.8
79;2021-04-15;2216;666;80345;22393;21.6;6.0
79;2021-04-16;1412;443;81757;22836;21.9;6.1
79;2021-04-17;581;353;82338;23189;22.1;6.2
79;2021-04-18;1;14;82339;23203;22.1;6.2
79;2021-04-19;1088;838;83427;24041;22.4;6.5
79;2021-04-20;1506;1229;84933;25270;22.8;6.8
79;2021-04-21;1419;1438;86352;26708;23.2;7.2
79;2021-04-22;1572;1085;87924;27793;23.6;7.5
79;2021-04-23;1316;1187;89240;28980;23.9;7.8
79;2021-04-24;653;458;89893;29438;24.1;7.9
79;2021-04-25;1;0;89894;29438;24.1;7.9
79;2021-04-26;1343;1813;91237;31251;24.5;8.4
79;2021-04-27;1898;2335;93135;33586;25.0;9.0
79;2021-04-28;1458;2865;94593;36451;25.4;9.8
79;2021-04-29;2105;2239;96698;38690;26.0;10.4
79;2021-04-30;2115;2453;98813;41143;26.5;11.0
79;2021-05-01;521;378;99334;41521;26.7;11.1
79;2021-05-02;1;11;99335;41532;26.7;11.1
79;2021-05-03;1182;1291;100517;42823;27.0;11.5
79;2021-05-04;1732;2324;102249;45147;27.4;12.1
79;2021-05-05;1694;2479;103943;47626;27.9;12.8
79;2021-05-06;2326;2222;106269;49848;28.5;13.4
79;2021-05-07;2105;2795;108374;52643;29.1;14.1
79;2021-05-08;198;506;108572;53149;29.1;14.3
79;2021-05-09;0;0;108572;53149;29.1;14.3
79;2021-05-10;1582;1785;110154;54934;29.6;14.7
79;2021-05-11;2309;1651;112463;56585;30.2;15.2
79;2021-05-12;2000;2680;114463;59265;30.7;15.9
79;2021-05-13;640;289;115103;59554;30.9;16.0
79;2021-05-14;2100;673;117203;60227;31.5;16.2
79;2021-05-15;1399;498;118602;60725;31.8;16.3
79;2021-05-16;1;22;118603;60747;31.8;16.3
79;2021-05-17;1873;1085;120476;61832;32.3;16.6
79;2021-05-18;2971;1272;123447;63104;33.1;16.9
79;2021-05-19;2898;968;126345;64072;33.9;17.2
79;2021-05-20;3106;1244;129451;65316;34.7;17.5
79;2021-05-21;2768;1066;132219;66382;35.5;17.8
79;2021-05-22;1084;261;133303;66643;35.8;17.9
79;2021-05-23;1;0;133304;66643;35.8;17.9
79;2021-05-24;161;20;133465;66663;35.8;17.9
79;2021-05-25;3198;991;136663;67654;36.7;18.2
79;2021-05-26;3312;853;139975;68507;37.6;18.4
79;2021-05-27;3589;1719;143564;70226;38.5;18.8
79;2021-05-28;3331;1815;146895;72041;39.4;19.3
79;2021-05-29;1072;446;147967;72487;39.7;19.5
79;2021-05-30;3;1;147970;72488;39.7;19.5
79;2021-05-31;2382;731;150352;73219;40.3;19.6
79;2021-06-01;3021;1568;153373;74787;41.2;20.1
79;2021-06-02;4066;1164;157439;75951;42.3;20.4
79;2021-06-03;4089;1754;161528;77705;43.3;20.9
79;2021-06-04;4141;2032;165669;79737;44.5;21.4
79;2021-06-05;2801;758;168470;80495;45.2;21.6
79;2021-06-06;696;39;169166;80534;45.4;21.6
79;2021-06-07;2805;1413;171971;81947;46.2;22.0
79;2021-06-08;2982;2069;174953;84016;47.0;22.5
79;2021-06-09;3631;1935;178584;85951;47.9;23.1
79;2021-06-10;3020;1964;181604;87915;48.7;23.6
79;2021-06-11;3767;2315;185371;90230;49.7;24.2
79;2021-06-12;1707;611;187078;90841;50.2;24.4
79;2021-06-13;213;24;187291;90865;50.3;24.4
79;2021-06-14;1247;1690;188538;92555;50.6;24.8
79;2021-06-15;1881;2358;190419;94913;51.1;25.5
79;2021-06-16;2204;2247;192623;97160;51.7;26.1
79;2021-06-17;2237;2616;194860;99776;52.3;26.8
79;2021-06-18;2413;2313;197273;102089;52.9;27.4
79;2021-06-19;1246;579;198519;102668;53.3;27.6
79;2021-06-20;3;2;198522;102670;53.3;27.6
79;2021-06-21;1233;2282;199755;104952;53.6;28.2
79;2021-06-22;1547;2870;201302;107822;54.0;28.9
79;2021-06-23;1770;2549;203072;110371;54.5;29.6
79;2021-06-24;2105;2000;205177;112371;55.1;30.2
79;2021-06-25;1488;2838;206665;115209;55.5;30.9
79;2021-06-26;870;808;207535;116017;55.7;31.1
79;2021-06-27;13;6;207548;116023;55.7;31.1
79;2021-06-28;1056;2620;208604;118643;56.0;31.8
79;2021-06-29;1473;3550;210077;122193;56.4;32.8
79;2021-06-30;1354;3447;211431;125640;56.7;33.7
79;2021-07-01;1202;3785;212633;129425;57.1;34.7
79;2021-07-02;1487;3346;214120;132771;57.5;35.6
79;2021-07-03;399;1504;214519;134275;57.6;36.0
79;2021-07-04;2;9;214521;134284;57.6;36.0
79;2021-07-05;753;2119;215274;136403;57.8;36.6
79;2021-07-06;947;3661;216221;140064;58.0;37.6
79;2021-07-07;1332;4308;217553;144372;58.4;38.7
79;2021-07-08;1107;4041;218660;148413;58.7;39.8
79;2021-07-09;836;3717;219496;152130;58.9;40.8
79;2021-07-10;514;1315;220010;153445;59.0;41.2
79;2021-07-11;3;12;220013;153457;59.0;41.2
79;2021-07-12;545;3695;220558;157152;59.2;42.2
79;2021-07-13;999;5185;221557;162337;59.5;43.6
79;2021-07-14;134;874;221691;163211;59.5;43.8
79;2021-07-15;1235;4682;222926;167893;59.8;45.1
79;2021-07-16;1333;4363;224259;172256;60.2;46.2
79;2021-07-17;576;2424;224835;174680;60.3;46.9
79;2021-07-18;44;498;224879;175178;60.3;47.0
79;2021-07-19;736;3315;225615;178493;60.5;47.9
79;2021-07-20;1230;3944;226845;182437;60.9;49.0
79;2021-07-21;1177;4195;228022;186632;61.2;50.1
79;2021-07-22;1354;3972;229376;190604;61.6;51.2
79;2021-07-23;1349;4553;230725;195157;61.9;52.4
79;2021-07-24;865;1499;231590;196656;62.2;52.8
79;2021-07-25;55;326;231645;196982;62.2;52.9
79;2021-07-26;1371;2598;233016;199580;62.5;53.6
79;2021-07-27;2084;2993;235100;202573;63.1;54.4
79;2021-07-28;2498;2492;237598;205065;63.8;55.0
79;2021-07-29;3009;2861;240607;207926;64.6;55.8
79;2021-07-30;2138;2814;242745;210740;65.1;56.6
79;2021-07-31;888;1157;243633;211897;65.4;56.9
79;2021-08-01;5;3;243638;211900;65.4;56.9
79;2021-08-02;1796;1545;245434;213445;65.9;57.3
79;2021-08-03;2822;2051;248256;215496;66.6;57.8
79;2021-08-04;2985;1742;251241;217238;67.4;58.3
79;2021-08-05;2900;2211;254141;219449;68.2;58.9
79;2021-08-06;2529;1633;256670;221082;68.9;59.3
79;2021-08-07;872;812;257542;221894;69.1;59.5
79;2021-08-08;4;3;257546;221897;69.1;59.5
79;2021-08-09;2495;1086;260041;222983;69.8;59.8
79;2021-08-10;2977;1547;263018;224530;70.6;60.3
79;2021-08-11;2583;1660;265601;226190;71.3;60.7
79;2021-08-12;2766;1430;268367;227620;72.0;61.1
79;2021-08-13;2875;1059;271242;228679;72.8;61.4
79;2021-08-14;518;391;271760;229070;72.9;61.5
79;2021-08-15;8;5;271768;229075;72.9;61.5
79;2021-08-16;1765;1196;273533;230271;73.4;61.8
79;2021-08-17;2102;1591;275635;231862;74.0;62.2
79;2021-08-18;1922;1915;277557;233777;74.5;62.7
79;2021-08-19;1617;1709;279174;235486;74.9;63.2
79;2021-08-20;1513;2162;280687;237648;75.3;63.8
79;2021-08-21;243;543;280930;238191;75.4;63.9
79;2021-08-22;1;21;280931;238212;75.4;63.9
79;2021-08-23;864;2176;281795;240388;75.6;64.5
79;2021-08-24;1072;2484;282867;242872;75.9;65.2
79;2021-08-25;1050;2760;283917;245632;76.2;65.9
79;2021-08-26;1015;2330;284932;247962;76.5;66.5
79;2021-08-27;611;2059;285543;250021;76.6;67.1
79;2021-08-28;299;841;285842;250862;76.7;67.3
79;2021-08-29;7;5;285849;250867;76.7;67.3
79;2021-08-30;554;2366;286403;253233;76.9;68.0
79;2021-08-31;633;2537;287036;255770;77.0;68.6
79;2021-09-01;650;2694;287686;258464;77.2;69.4
79;2021-09-02;761;2513;288447;260977;77.4;70.0
79;2021-09-03;637;2795;289084;263772;77.6;70.8
79;2021-09-04;266;721;289350;264493;77.7;71.0
79;2021-09-05;12;24;289362;264517;77.7;71.0
79;2021-09-06;329;1900;289691;266417;77.7;71.5
79;2021-09-07;347;2140;290038;268557;77.8;72.1
79;2021-09-08;543;2235;290581;270792;78.0;72.7
79;2021-09-09;316;1763;290897;272555;78.1;73.1
79;2021-09-10;422;2290;291319;274845;78.2;73.8
79;2021-09-11;161;868;291480;275713;78.2;74.0
79;2021-09-12;0;0;291480;275713;78.2;74.0
79;2021-09-13;363;1291;291843;277004;78.3;74.3
79;2021-09-14;370;1556;292213;278560;78.4;74.8
79;2021-09-15;475;1432;292688;279992;78.5;75.1
79;2021-09-16;461;1094;293149;281086;78.7;75.4
79;2021-09-17;443;1405;293592;282491;78.8;75.8
79;2021-09-18;139;567;293731;283058;78.8;76.0
79;2021-09-19;1;4;293732;283062;78.8;76.0
79;2021-09-20;190;553;293922;283615;78.9;76.1
79;2021-09-21;351;720;294273;284335;79.0;76.3
79;2021-09-22;209;1102;294482;285437;79.0;76.6
79;2021-09-23;412;566;294894;286003;79.1;76.8
79;2021-09-24;243;1348;295137;287351;79.2;77.1
79;2021-09-25;73;324;295210;287675;79.2;77.2
79;2021-09-26;0;1;295210;287676;79.2;77.2
79;2021-09-27;205;525;295415;288201;79.3;77.3
79;2021-09-28;130;409;295545;288610;79.3;77.5
79;2021-09-29;325;742;295870;289352;79.4;77.7
79;2021-09-30;154;279;296024;289631;79.4;77.7
79;2021-10-01;247;541;296271;290172;79.5;77.9
79;2021-10-02;127;248;296398;290420;79.5;77.9
79;2021-10-03;0;0;296398;290420;79.5;77.9
80;2020-12-27;0;0;0;0;0.0;0.0
80;2020-12-28;0;0;0;0;0.0;0.0
80;2020-12-29;11;0;11;0;0.0;0.0
80;2020-12-30;0;0;11;0;0.0;0.0
80;2020-12-31;0;0;11;0;0.0;0.0
80;2021-01-01;0;0;11;0;0.0;0.0
80;2021-01-02;1;0;12;0;0.0;0.0
80;2021-01-03;1;0;13;0;0.0;0.0
80;2021-01-04;0;0;13;0;0.0;0.0
80;2021-01-05;1;0;14;0;0.0;0.0
80;2021-01-06;30;0;44;0;0.0;0.0
80;2021-01-07;276;2;320;2;0.1;0.0
80;2021-01-08;330;0;650;2;0.1;0.0
80;2021-01-09;108;0;758;2;0.1;0.0
80;2021-01-10;21;0;779;2;0.1;0.0
80;2021-01-11;276;0;1055;2;0.2;0.0
80;2021-01-12;430;1;1485;3;0.3;0.0
80;2021-01-13;514;4;1999;7;0.4;0.0
80;2021-01-14;454;4;2453;11;0.4;0.0
80;2021-01-15;331;1;2784;12;0.5;0.0
80;2021-01-16;103;1;2887;13;0.5;0.0
80;2021-01-17;102;1;2989;14;0.5;0.0
80;2021-01-18;412;2;3401;16;0.6;0.0
80;2021-01-19;963;16;4364;32;0.8;0.0
80;2021-01-20;1086;11;5450;43;1.0;0.0
80;2021-01-21;1012;9;6462;52;1.1;0.0
80;2021-01-22;1113;3;7575;55;1.3;0.0
80;2021-01-23;907;3;8482;58;1.5;0.0
80;2021-01-24;823;5;9305;63;1.6;0.0
80;2021-01-25;1543;10;10848;73;1.9;0.0
80;2021-01-26;1480;11;12328;84;2.2;0.0
80;2021-01-27;822;22;13150;106;2.3;0.0
80;2021-01-28;622;157;13772;263;2.4;0.0
80;2021-01-29;637;190;14409;453;2.5;0.1
80;2021-01-30;87;54;14496;507;2.5;0.1
80;2021-01-31;0;0;14496;507;2.5;0.1
80;2021-02-01;26;230;14522;737;2.5;0.1
80;2021-02-02;21;407;14543;1144;2.6;0.2
80;2021-02-03;28;480;14571;1624;2.6;0.3
80;2021-02-04;278;312;14849;1936;2.6;0.3
80;2021-02-05;347;196;15196;2132;2.7;0.4
80;2021-02-06;168;56;15364;2188;2.7;0.4
80;2021-02-07;1;0;15365;2188;2.7;0.4
80;2021-02-08;425;205;15790;2393;2.8;0.4
80;2021-02-09;686;230;16476;2623;2.9;0.5
80;2021-02-10;607;425;17083;3048;3.0;0.5
80;2021-02-11;862;301;17945;3349;3.1;0.6
80;2021-02-12;945;284;18890;3633;3.3;0.6
80;2021-02-13;197;372;19087;4005;3.3;0.7
80;2021-02-14;78;480;19165;4485;3.4;0.8
80;2021-02-15;606;943;19771;5428;3.5;1.0
80;2021-02-16;688;980;20459;6408;3.6;1.1
80;2021-02-17;484;977;20943;7385;3.7;1.3
80;2021-02-18;569;893;21512;8278;3.8;1.5
80;2021-02-19;502;678;22014;8956;3.9;1.6
80;2021-02-20;22;365;22036;9321;3.9;1.6
80;2021-02-21;47;38;22083;9359;3.9;1.6
80;2021-02-22;147;455;22230;9814;3.9;1.7
80;2021-02-23;471;572;22701;10386;4.0;1.8
80;2021-02-24;431;526;23132;10912;4.1;1.9
80;2021-02-25;814;414;23946;11326;4.2;2.0
80;2021-02-26;1063;411;25009;11737;4.4;2.1
80;2021-02-27;475;54;25484;11791;4.5;2.1
80;2021-02-28;49;22;25533;11813;4.5;2.1
80;2021-03-01;729;61;26262;11874;4.6;2.1
80;2021-03-02;1013;89;27275;11963;4.8;2.1
80;2021-03-03;982;51;28257;12014;5.0;2.1
80;2021-03-04;1389;192;29646;12206;5.2;2.1
80;2021-03-05;1874;307;31520;12513;5.5;2.2
80;2021-03-06;2917;330;34437;12843;6.0;2.3
80;2021-03-07;1842;74;36279;12917;6.4;2.3
80;2021-03-08;714;550;36993;13467;6.5;2.4
80;2021-03-09;1310;797;38303;14264;6.7;2.5
80;2021-03-10;1724;695;40027;14959;7.0;2.6
80;2021-03-11;1909;760;41936;15719;7.4;2.8
80;2021-03-12;3138;703;45074;16422;7.9;2.9
80;2021-03-13;4006;205;49080;16627;8.6;2.9
80;2021-03-14;350;12;49430;16639;8.7;2.9
80;2021-03-15;1014;239;50444;16878;8.9;3.0
80;2021-03-16;882;330;51326;17208;9.0;3.0
80;2021-03-17;665;269;51991;17477;9.1;3.1
80;2021-03-18;1002;286;52993;17763;9.3;3.1
80;2021-03-19;1739;370;54732;18133;9.6;3.2
80;2021-03-20;3821;117;58553;18250;10.3;3.2
80;2021-03-21;486;31;59039;18281;10.4;3.2
80;2021-03-22;903;288;59942;18569;10.5;3.3
80;2021-03-23;1713;411;61655;18980;10.8;3.3
80;2021-03-24;1755;464;63410;19444;11.1;3.4
80;2021-03-25;2714;443;66124;19887;11.6;3.5
80;2021-03-26;3105;405;69229;20292;12.2;3.6
80;2021-03-27;2237;226;71466;20518;12.5;3.6
80;2021-03-28;676;93;72142;20611;12.7;3.6
80;2021-03-29;1979;739;74121;21350;13.0;3.7
80;2021-03-30;1967;861;76088;22211;13.4;3.9
80;2021-03-31;1495;981;77583;23192;13.6;4.1
80;2021-04-01;1950;1480;79533;24672;14.0;4.3
80;2021-04-02;2811;1550;82344;26222;14.5;4.6
80;2021-04-03;3048;853;85392;27075;15.0;4.8
80;2021-04-04;134;8;85526;27083;15.0;4.8
80;2021-04-05;684;195;86210;27278;15.1;4.8
80;2021-04-06;1280;959;87490;28237;15.4;5.0
80;2021-04-07;1624;1193;89114;29430;15.6;5.2
80;2021-04-08;2154;842;91268;30272;16.0;5.3
80;2021-04-09;3533;1351;94801;31623;16.6;5.6
80;2021-04-10;2737;1946;97538;33569;17.1;5.9
80;2021-04-11;188;176;97726;33745;17.2;5.9
80;2021-04-12;1814;483;99540;34228;17.5;6.0
80;2021-04-13;2385;1031;101925;35259;17.9;6.2
80;2021-04-14;2769;1163;104694;36422;18.4;6.4
80;2021-04-15;3731;878;108425;37300;19.0;6.5
80;2021-04-16;3337;871;111762;38171;19.6;6.7
80;2021-04-17;1653;2291;113415;40462;19.9;7.1
80;2021-04-18;372;390;113787;40852;20.0;7.2
80;2021-04-19;951;771;114738;41623;20.1;7.3
80;2021-04-20;1613;820;116351;42443;20.4;7.4
80;2021-04-21;1612;996;117963;43439;20.7;7.6
80;2021-04-22;2167;1251;120130;44690;21.1;7.8
80;2021-04-23;2639;1245;122769;45935;21.5;8.1
80;2021-04-24;1357;1190;124126;47125;21.8;8.3
80;2021-04-25;209;531;124335;47656;21.8;8.4
80;2021-04-26;1295;1438;125630;49094;22.0;8.6
80;2021-04-27;2025;1396;127655;50490;22.4;8.9
80;2021-04-28;2199;1379;129854;51869;22.8;9.1
80;2021-04-29;3218;1867;133072;53736;23.4;9.4
80;2021-04-30;3081;2839;136153;56575;23.9;9.9
80;2021-05-01;987;658;137140;57233;24.1;10.0
80;2021-05-02;371;53;137511;57286;24.1;10.1
80;2021-05-03;2720;1186;140231;58472;24.6;10.3
80;2021-05-04;2494;1697;142725;60169;25.0;10.6
80;2021-05-05;3366;1895;146091;62064;25.6;10.9
80;2021-05-06;3169;2546;149260;64610;26.2;11.3
80;2021-05-07;3454;2685;152714;67295;26.8;11.8
80;2021-05-08;2784;924;155498;68219;27.3;12.0
80;2021-05-09;1407;268;156905;68487;27.5;12.0
80;2021-05-10;1880;1828;158785;70315;27.9;12.3
80;2021-05-11;3274;1793;162059;72108;28.4;12.7
80;2021-05-12;4703;1574;166762;73682;29.3;12.9
80;2021-05-13;3837;367;170599;74049;29.9;13.0
80;2021-05-14;5188;1392;175787;75441;30.9;13.2
80;2021-05-15;5917;1053;181704;76494;31.9;13.4
80;2021-05-16;2678;312;184382;76806;32.4;13.5
80;2021-05-17;2371;818;186753;77624;32.8;13.6
80;2021-05-18;3949;850;190702;78474;33.5;13.8
80;2021-05-19;4018;940;194720;79414;34.2;13.9
80;2021-05-20;4568;1215;199288;80629;35.0;14.2
80;2021-05-21;4890;1650;204178;82279;35.8;14.4
80;2021-05-22;5030;1156;209208;83435;36.7;14.6
80;2021-05-23;1783;237;210991;83672;37.0;14.7
80;2021-05-24;1469;159;212460;83831;37.3;14.7
80;2021-05-25;2622;1137;215082;84968;37.7;14.9
80;2021-05-26;4249;1704;219331;86672;38.5;15.2
80;2021-05-27;3977;2467;223308;89139;39.2;15.6
80;2021-05-28;3866;2968;227174;92107;39.9;16.2
80;2021-05-29;3697;1627;230871;93734;40.5;16.5
80;2021-05-30;1182;198;232053;93932;40.7;16.5
80;2021-05-31;2604;1369;234657;95301;41.2;16.7
80;2021-06-01;4031;2434;238688;97735;41.9;17.2
80;2021-06-02;3334;2005;242022;99740;42.5;17.5
80;2021-06-03;4263;2924;246285;102664;43.2;18.0
80;2021-06-04;4796;3082;251081;105746;44.1;18.6
80;2021-06-05;3554;2065;254635;107811;44.7;18.9
80;2021-06-06;802;211;255437;108022;44.8;19.0
80;2021-06-07;1750;1945;257187;109967;45.1;19.3
80;2021-06-08;2743;2552;259930;112519;45.6;19.7
80;2021-06-09;3012;2735;262942;115254;46.1;20.2
80;2021-06-10;3163;3167;266105;118421;46.7;20.8
80;2021-06-11;3216;3893;269321;122314;47.3;21.5
80;2021-06-12;3042;2326;272363;124640;47.8;21.9
80;2021-06-13;474;404;272837;125044;47.9;21.9
80;2021-06-14;1263;2852;274100;127896;48.1;22.4
80;2021-06-15;2315;3418;276415;131314;48.5;23.0
80;2021-06-16;1563;4212;277978;135526;48.8;23.8
80;2021-06-17;2359;3622;280337;139148;49.2;24.4
80;2021-06-18;2552;3903;282889;143051;49.6;25.1
80;2021-06-19;2986;4340;285875;147391;50.2;25.9
80;2021-06-20;203;1077;286078;148468;50.2;26.1
80;2021-06-21;1015;2619;287093;151087;50.4;26.5
80;2021-06-22;1149;3929;288242;155016;50.6;27.2
80;2021-06-23;1850;5289;290092;160305;50.9;28.1
80;2021-06-24;1695;4683;291787;164988;51.2;29.0
80;2021-06-25;1374;6125;293161;171113;51.5;30.0
80;2021-06-26;1933;6183;295094;177296;51.8;31.1
80;2021-06-27;333;2031;295427;179327;51.9;31.5
80;2021-06-28;903;3169;296330;182496;52.0;32.0
80;2021-06-29;1919;4622;298249;187118;52.3;32.8
80;2021-06-30;1245;4784;299494;191902;52.6;33.7
80;2021-07-01;1594;5000;301088;196902;52.8;34.6
80;2021-07-02;1856;5984;302944;202886;53.2;35.6
80;2021-07-03;1293;5265;304237;208151;53.4;36.5
80;2021-07-04;692;1471;304929;209622;53.5;36.8
80;2021-07-05;879;2963;305808;212585;53.7;37.3
80;2021-07-06;1852;3990;307660;216575;54.0;38.0
80;2021-07-07;1560;4504;309220;221079;54.3;38.8
80;2021-07-08;2082;5003;311302;226082;54.6;39.7
80;2021-07-09;2596;5472;313898;231554;55.1;40.6
80;2021-07-10;1616;4015;315514;235569;55.4;41.3
80;2021-07-11;406;805;315920;236374;55.4;41.5
80;2021-07-12;871;3378;316791;239752;55.6;42.1
80;2021-07-13;2087;5083;318878;244835;56.0;43.0
80;2021-07-14;2801;1749;321679;246584;56.5;43.3
80;2021-07-15;2792;5296;324471;251880;56.9;44.2
80;2021-07-16;3878;5890;328349;257770;57.6;45.2
80;2021-07-17;3368;4460;331717;262230;58.2;46.0
80;2021-07-18;874;896;332591;263126;58.4;46.2
80;2021-07-19;2157;2885;334748;266011;58.8;46.7
80;2021-07-20;3321;4903;338069;270914;59.3;47.5
80;2021-07-21;3496;4496;341565;275410;59.9;48.3
80;2021-07-22;4362;4569;345927;279979;60.7;49.1
80;2021-07-23;5399;4825;351326;284804;61.7;50.0
80;2021-07-24;4369;4343;355695;289147;62.4;50.7
80;2021-07-25;1185;650;356880;289797;62.6;50.9
80;2021-07-26;2681;2340;359561;292137;63.1;51.3
80;2021-07-27;4373;3705;363934;295842;63.9;51.9
80;2021-07-28;5101;2803;369035;298645;64.8;52.4
80;2021-07-29;4991;3229;374026;301874;65.6;53.0
80;2021-07-30;5024;3638;379050;305512;66.5;53.6
80;2021-07-31;4156;2927;383206;308439;67.3;54.1
80;2021-08-01;1288;363;384494;308802;67.5;54.2
80;2021-08-02;2059;1739;386553;310541;67.8;54.5
80;2021-08-03;3716;2363;390269;312904;68.5;54.9
80;2021-08-04;3367;2491;393636;315395;69.1;55.4
80;2021-08-05;3137;2576;396773;317971;69.6;55.8
80;2021-08-06;3248;2876;400021;320847;70.2;56.3
80;2021-08-07;2423;2667;402444;323514;70.6;56.8
80;2021-08-08;621;686;403065;324200;70.7;56.9
80;2021-08-09;1382;2078;404447;326278;71.0;57.3
80;2021-08-10;2353;2849;406800;329127;71.4;57.8
80;2021-08-11;1946;2383;408746;331510;71.7;58.2
80;2021-08-12;2236;2659;410982;334169;72.1;58.6
80;2021-08-13;1882;3154;412864;337323;72.5;59.2
80;2021-08-14;1411;2113;414275;339436;72.7;59.6
80;2021-08-15;318;663;414593;340099;72.8;59.7
80;2021-08-16;897;2419;415490;342518;72.9;60.1
80;2021-08-17;1709;3505;417199;346023;73.2;60.7
80;2021-08-18;1234;3714;418433;349737;73.4;61.4
80;2021-08-19;1569;3821;420002;353558;73.7;62.1
80;2021-08-20;1264;4434;421266;357992;73.9;62.8
80;2021-08-21;1078;2686;422344;360678;74.1;63.3
80;2021-08-22;145;680;422489;361358;74.2;63.4
80;2021-08-23;583;2999;423072;364357;74.3;63.9
80;2021-08-24;1092;4371;424164;368728;74.4;64.7
80;2021-08-25;973;3677;425137;372405;74.6;65.4
80;2021-08-26;956;3819;426093;376224;74.8;66.0
80;2021-08-27;1014;4457;427107;380681;75.0;66.8
80;2021-08-28;720;3347;427827;384028;75.1;67.4
80;2021-08-29;199;555;428026;384583;75.1;67.5
80;2021-08-30;500;2307;428526;386890;75.2;67.9
80;2021-08-31;750;3185;429276;390075;75.3;68.5
80;2021-09-01;675;2481;429951;392556;75.5;68.9
80;2021-09-02;527;2277;430478;394833;75.6;69.3
80;2021-09-03;761;3116;431239;397949;75.7;69.8
80;2021-09-04;956;2754;432195;400703;75.9;70.3
80;2021-09-05;165;374;432360;401077;75.9;70.4
80;2021-09-06;421;1562;432781;402639;76.0;70.7
80;2021-09-07;490;1840;433271;404479;76.0;71.0
80;2021-09-08;495;1873;433766;406352;76.1;71.3
80;2021-09-09;529;1753;434295;408105;76.2;71.6
80;2021-09-10;619;2077;434914;410182;76.3;72.0
80;2021-09-11;520;2117;435434;412299;76.4;72.4
80;2021-09-12;77;327;435511;412626;76.4;72.4
80;2021-09-13;310;1101;435821;413727;76.5;72.6
80;2021-09-14;638;1474;436459;415201;76.6;72.9
80;2021-09-15;356;1088;436815;416289;76.7;73.1
80;2021-09-16;474;1031;437289;417320;76.7;73.2
80;2021-09-17;506;1238;437795;418558;76.8;73.5
80;2021-09-18;348;1276;438143;419834;76.9;73.7
80;2021-09-19;17;169;438160;420003;76.9;73.7
80;2021-09-20;325;446;438485;420449;77.0;73.8
80;2021-09-21;295;615;438780;421064;77.0;73.9
80;2021-09-22;284;709;439064;421773;77.1;74.0
80;2021-09-23;302;505;439366;422278;77.1;74.1
80;2021-09-24;369;896;439735;423174;77.2;74.3
80;2021-09-25;282;1131;440017;424305;77.2;74.5
80;2021-09-26;20;109;440037;424414;77.2;74.5
80;2021-09-27;189;536;440226;424950;77.3;74.6
80;2021-09-28;148;380;440374;425330;77.3;74.6
80;2021-09-29;257;510;440631;425840;77.3;74.7
80;2021-09-30;198;329;440829;426169;77.4;74.8
80;2021-10-01;301;718;441130;426887;77.4;74.9
80;2021-10-02;336;890;441466;427777;77.5;75.1
80;2021-10-03;18;64;441484;427841;77.5;75.1
81;2020-12-27;1;0;1;0;0.0;0.0
81;2020-12-28;0;0;1;0;0.0;0.0
81;2020-12-29;0;0;1;0;0.0;0.0
81;2020-12-30;1;0;2;0;0.0;0.0
81;2020-12-31;1;0;3;0;0.0;0.0
81;2021-01-01;0;0;3;0;0.0;0.0
81;2021-01-02;0;0;3;0;0.0;0.0
81;2021-01-03;0;0;3;0;0.0;0.0
81;2021-01-04;1;0;4;0;0.0;0.0
81;2021-01-05;0;0;4;0;0.0;0.0
81;2021-01-06;5;0;9;0;0.0;0.0
81;2021-01-07;265;0;274;0;0.1;0.0
81;2021-01-08;312;1;586;1;0.2;0.0
81;2021-01-09;74;1;660;2;0.2;0.0
81;2021-01-10;1;0;661;2;0.2;0.0
81;2021-01-11;133;0;794;2;0.2;0.0
81;2021-01-12;167;0;961;2;0.2;0.0
81;2021-01-13;234;1;1195;3;0.3;0.0
81;2021-01-14;963;5;2158;8;0.6;0.0
81;2021-01-15;523;3;2681;11;0.7;0.0
81;2021-01-16;71;1;2752;12;0.7;0.0
81;2021-01-17;0;0;2752;12;0.7;0.0
81;2021-01-18;581;2;3333;14;0.9;0.0
81;2021-01-19;662;4;3995;18;1.0;0.0
81;2021-01-20;754;2;4749;20;1.2;0.0
81;2021-01-21;1183;4;5932;24;1.5;0.0
81;2021-01-22;857;2;6789;26;1.8;0.0
81;2021-01-23;221;2;7010;28;1.8;0.0
81;2021-01-24;102;0;7112;28;1.8;0.0
81;2021-01-25;570;1;7682;29;2.0;0.0
81;2021-01-26;635;2;8317;31;2.1;0.0
81;2021-01-27;552;1;8869;32;2.3;0.0
81;2021-01-28;700;203;9569;235;2.5;0.1
81;2021-01-29;303;171;9872;406;2.5;0.1
81;2021-01-30;204;34;10076;440;2.6;0.1
81;2021-01-31;104;0;10180;440;2.6;0.1
81;2021-02-01;320;111;10500;551;2.7;0.1
81;2021-02-02;445;116;10945;667;2.8;0.2
81;2021-02-03;476;204;11421;871;2.9;0.2
81;2021-02-04;1449;628;12870;1499;3.3;0.4
81;2021-02-05;870;298;13740;1797;3.5;0.5
81;2021-02-06;274;17;14014;1814;3.6;0.5
81;2021-02-07;103;0;14117;1814;3.6;0.5
81;2021-02-08;275;194;14392;2008;3.7;0.5
81;2021-02-09;420;187;14812;2195;3.8;0.6
81;2021-02-10;371;262;15183;2457;3.9;0.6
81;2021-02-11;651;340;15834;2797;4.1;0.7
81;2021-02-12;579;465;16413;3262;4.2;0.8
81;2021-02-13;188;104;16601;3366;4.3;0.9
81;2021-02-14;100;1;16701;3367;4.3;0.9
81;2021-02-15;234;324;16935;3691;4.4;1.0
81;2021-02-16;281;459;17216;4150;4.4;1.1
81;2021-02-17;241;378;17457;4528;4.5;1.2
81;2021-02-18;482;540;17939;5068;4.6;1.3
81;2021-02-19;571;303;18510;5371;4.8;1.4
81;2021-02-20;322;223;18832;5594;4.9;1.4
81;2021-02-21;23;66;18855;5660;4.9;1.5
81;2021-02-22;233;419;19088;6079;4.9;1.6
81;2021-02-23;169;480;19257;6559;5.0;1.7
81;2021-02-24;291;513;19548;7072;5.0;1.8
81;2021-02-25;719;920;20267;7992;5.2;2.1
81;2021-02-26;911;843;21178;8835;5.5;2.3
81;2021-02-27;275;221;21453;9056;5.5;2.3
81;2021-02-28;21;61;21474;9117;5.5;2.4
81;2021-03-01;208;354;21682;9471;5.6;2.4
81;2021-03-02;364;458;22046;9929;5.7;2.6
81;2021-03-03;463;370;22509;10299;5.8;2.7
81;2021-03-04;1061;403;23570;10702;6.1;2.8
81;2021-03-05;1406;352;24976;11054;6.4;2.8
81;2021-03-06;982;158;25958;11212;6.7;2.9
81;2021-03-07;154;91;26112;11303;6.7;2.9
81;2021-03-08;466;319;26578;11622;6.9;3.0
81;2021-03-09;815;332;27393;11954;7.1;3.1
81;2021-03-10;898;360;28291;12314;7.3;3.2
81;2021-03-11;1350;325;29641;12639;7.6;3.3
81;2021-03-12;1690;296;31331;12935;8.1;3.3
81;2021-03-13;1030;171;32361;13106;8.3;3.4
81;2021-03-14;66;79;32427;13185;8.4;3.4
81;2021-03-15;1093;219;33520;13404;8.6;3.5
81;2021-03-16;724;215;34244;13619;8.8;3.5
81;2021-03-17;893;275;35137;13894;9.1;3.6
81;2021-03-18;970;573;36107;14467;9.3;3.7
81;2021-03-19;1271;456;37378;14923;9.6;3.8
81;2021-03-20;677;285;38055;15208;9.8;3.9
81;2021-03-21;139;22;38194;15230;9.8;3.9
81;2021-03-22;932;267;39126;15497;10.1;4.0
81;2021-03-23;1420;219;40546;15716;10.5;4.1
81;2021-03-24;1606;262;42152;15978;10.9;4.1
81;2021-03-25;2028;322;44180;16300;11.4;4.2
81;2021-03-26;2100;270;46280;16570;11.9;4.3
81;2021-03-27;1091;37;47371;16607;12.2;4.3
81;2021-03-28;734;38;48105;16645;12.4;4.3
81;2021-03-29;2866;188;50971;16833;13.1;4.3
81;2021-03-30;3055;215;54026;17048;13.9;4.4
81;2021-03-31;2691;297;56717;17345;14.6;4.5
81;2021-04-01;3314;569;60031;17914;15.5;4.6
81;2021-04-02;2616;369;62647;18283;16.2;4.7
81;2021-04-03;1147;304;63794;18587;16.4;4.8
81;2021-04-04;1403;24;65197;18611;16.8;4.8
81;2021-04-05;718;20;65915;18631;17.0;4.8
81;2021-04-06;1599;516;67514;19147;17.4;4.9
81;2021-04-07;1817;581;69331;19728;17.9;5.1
81;2021-04-08;2619;822;71950;20550;18.5;5.3
81;2021-04-09;3052;476;75002;21026;19.3;5.4
81;2021-04-10;1476;516;76478;21542;19.7;5.6
81;2021-04-11;1299;70;77777;21612;20.1;5.6
81;2021-04-12;1220;682;78997;22294;20.4;5.7
81;2021-04-13;2528;792;81525;23086;21.0;6.0
81;2021-04-14;2506;834;84031;23920;21.7;6.2
81;2021-04-15;3099;1198;87130;25118;22.5;6.5
81;2021-04-16;2822;1090;89952;26208;23.2;6.8
81;2021-04-17;1145;297;91097;26505;23.5;6.8
81;2021-04-18;519;145;91616;26650;23.6;6.9
81;2021-04-19;913;819;92529;27469;23.9;7.1
81;2021-04-20;2270;1168;94799;28637;24.4;7.4
81;2021-04-21;2224;1004;97023;29641;25.0;7.6
81;2021-04-22;2816;1060;99839;30701;25.7;7.9
81;2021-04-23;2885;969;102724;31670;26.5;8.2
81;2021-04-24;1326;741;104050;32411;26.8;8.4
81;2021-04-25;454;715;104504;33126;26.9;8.5
81;2021-04-26;1061;2421;105565;35547;27.2;9.2
81;2021-04-27;1596;2346;107161;37893;27.6;9.8
81;2021-04-28;1427;2393;108588;40286;28.0;10.4
81;2021-04-29;1818;2739;110406;43025;28.5;11.1
81;2021-04-30;2013;2348;112419;45373;29.0;11.7
81;2021-05-01;362;686;112781;46059;29.1;11.9
81;2021-05-02;291;1376;113072;47435;29.1;12.2
81;2021-05-03;1115;1168;114187;48603;29.4;12.5
81;2021-05-04;2620;1908;116807;50511;30.1;13.0
81;2021-05-05;2016;1931;118823;52442;30.6;13.5
81;2021-05-06;2748;3455;121571;55897;31.3;14.4
81;2021-05-07;2128;2878;123699;58775;31.9;15.2
81;2021-05-08;962;878;124661;59653;32.1;15.4
81;2021-05-09;534;1350;125195;61003;32.3;15.7
81;2021-05-10;824;1599;126019;62602;32.5;16.1
81;2021-05-11;1661;2571;127680;65173;32.9;16.8
81;2021-05-12;1640;2459;129320;67632;33.3;17.4
81;2021-05-13;1216;564;130536;68196;33.7;17.6
81;2021-05-14;1890;1723;132426;69919;34.1;18.0
81;2021-05-15;1511;618;133937;70537;34.5;18.2
81;2021-05-16;1368;417;135305;70954;34.9;18.3
81;2021-05-17;1167;864;136472;71818;35.2;18.5
81;2021-05-18;1702;1419;138174;73237;35.6;18.9
81;2021-05-19;2641;1244;140815;74481;36.3;19.2
81;2021-05-20;2968;1351;143783;75832;37.1;19.5
81;2021-05-21;2739;1115;146522;76947;37.8;19.8
81;2021-05-22;2814;520;149336;77467;38.5;20.0
81;2021-05-23;1178;74;150514;77541;38.8;20.0
81;2021-05-24;837;83;151351;77624;39.0;20.0
81;2021-05-25;2490;1100;153841;78724;39.7;20.3
81;2021-05-26;1891;800;155732;79524;40.1;20.5
81;2021-05-27;2555;1542;158287;81066;40.8;20.9
81;2021-05-28;2566;1660;160853;82726;41.5;21.3
81;2021-05-29;1400;544;162253;83270;41.8;21.5
81;2021-05-30;935;219;163188;83489;42.1;21.5
81;2021-05-31;1183;1336;164371;84825;42.4;21.9
81;2021-06-01;1779;2695;166150;87520;42.8;22.6
81;2021-06-02;2006;2444;168156;89964;43.4;23.2
81;2021-06-03;2003;2529;170159;92493;43.9;23.8
81;2021-06-04;1844;2942;172003;95435;44.3;24.6
81;2021-06-05;1757;1307;173760;96742;44.8;24.9
81;2021-06-06;370;366;174130;97108;44.9;25.0
81;2021-06-07;1209;1540;175339;98648;45.2;25.4
81;2021-06-08;2369;2382;177708;101030;45.8;26.0
81;2021-06-09;2438;1867;180146;102897;46.4;26.5
81;2021-06-10;1278;1560;181424;104457;46.8;26.9
81;2021-06-11;2657;2198;184081;106655;47.5;27.5
81;2021-06-12;1659;1038;185740;107693;47.9;27.8
81;2021-06-13;444;475;186184;108168;48.0;27.9
81;2021-06-14;771;1415;186955;109583;48.2;28.3
81;2021-06-15;1677;3500;188632;113083;48.6;29.2
81;2021-06-16;1269;3013;189901;116096;49.0;29.9
81;2021-06-17;1344;2525;191245;118621;49.3;30.6
81;2021-06-18;1836;2770;193081;121391;49.8;31.3
81;2021-06-19;824;951;193905;122342;50.0;31.5
81;2021-06-20;405;536;194310;122878;50.1;31.7
81;2021-06-21;425;1038;194735;123916;50.2;31.9
81;2021-06-22;1061;2567;195796;126483;50.5;32.6
81;2021-06-23;1142;2159;196938;128642;50.8;33.2
81;2021-06-24;1115;1937;198053;130579;51.1;33.7
81;2021-06-25;1238;2864;199291;133443;51.4;34.4
81;2021-06-26;721;1712;200012;135155;51.6;34.8
81;2021-06-27;526;1646;200538;136801;51.7;35.3
81;2021-06-28;476;1538;201014;138339;51.8;35.7
81;2021-06-29;1079;2634;202093;140973;52.1;36.3
81;2021-06-30;1043;3153;203136;144126;52.4;37.2
81;2021-07-01;1101;2627;204237;146753;52.7;37.8
81;2021-07-02;1070;2860;205307;149613;52.9;38.6
81;2021-07-03;732;2829;206039;152442;53.1;39.3
81;2021-07-04;268;1010;206307;153452;53.2;39.6
81;2021-07-05;702;1625;207009;155077;53.4;40.0
81;2021-07-06;975;3176;207984;158253;53.6;40.8
81;2021-07-07;1059;2437;209043;160690;53.9;41.4
81;2021-07-08;1030;2232;210073;162922;54.2;42.0
81;2021-07-09;1147;2702;211220;165624;54.5;42.7
81;2021-07-10;806;1523;212026;167147;54.7;43.1
81;2021-07-11;436;1012;212462;168159;54.8;43.4
81;2021-07-12;785;1725;213247;169884;55.0;43.8
81;2021-07-13;2081;3144;215328;173028;55.5;44.6
81;2021-07-14;1443;1573;216771;174601;55.9;45.0
81;2021-07-15;2545;2760;219316;177361;56.5;45.7
81;2021-07-16;2032;3027;221348;180388;57.1;46.5
81;2021-07-17;1218;2452;222566;182840;57.4;47.1
81;2021-07-18;672;1131;223238;183971;57.6;47.4
81;2021-07-19;1256;1734;224494;185705;57.9;47.9
81;2021-07-20;3064;2806;227558;188511;58.7;48.6
81;2021-07-21;3488;2346;231046;190857;59.6;49.2
81;2021-07-22;3557;2092;234603;192949;60.5;49.7
81;2021-07-23;3172;3245;237775;196194;61.3;50.6
81;2021-07-24;2518;1723;240293;197917;61.9;51.0
81;2021-07-25;1684;711;241977;198628;62.4;51.2
81;2021-07-26;2014;1547;243991;200175;62.9;51.6
81;2021-07-27;3619;2544;247610;202719;63.8;52.3
81;2021-07-28;3052;2206;250662;204925;64.6;52.8
81;2021-07-29;3354;1781;254016;206706;65.5;53.3
81;2021-07-30;2829;2261;256845;208967;66.2;53.9
81;2021-07-31;1947;1015;258792;209982;66.7;54.1
81;2021-08-01;835;639;259627;210621;66.9;54.3
81;2021-08-02;1082;989;260709;211610;67.2;54.6
81;2021-08-03;2362;2116;263071;213726;67.8;55.1
81;2021-08-04;2031;1535;265102;215261;68.3;55.5
81;2021-08-05;1544;1877;266646;217138;68.7;56.0
81;2021-08-06;1726;1970;268372;219108;69.2;56.5
81;2021-08-07;985;1042;269357;220150;69.4;56.8
81;2021-08-08;437;708;269794;220858;69.6;56.9
81;2021-08-09;805;659;270599;221517;69.8;57.1
81;2021-08-10;1610;2756;272209;224273;70.2;57.8
81;2021-08-11;1110;2410;273319;226683;70.5;58.4
81;2021-08-12;1063;2250;274382;228933;70.7;59.0
81;2021-08-13;873;2473;275255;231406;71.0;59.7
81;2021-08-14;501;1873;275756;233279;71.1;60.1
81;2021-08-15;141;1100;275897;234379;71.1;60.4
81;2021-08-16;631;1816;276528;236195;71.3;60.9
81;2021-08-17;1347;3101;277875;239296;71.6;61.7
81;2021-08-18;1067;2359;278942;241655;71.9;62.3
81;2021-08-19;942;2267;279884;243922;72.2;62.9
81;2021-08-20;928;2354;280812;246276;72.4;63.5
81;2021-08-21;471;1538;281283;247814;72.5;63.9
81;2021-08-22;184;931;281467;248745;72.6;64.1
81;2021-08-23;487;1260;281954;250005;72.7;64.5
81;2021-08-24;852;2543;282806;252548;72.9;65.1
81;2021-08-25;718;2054;283524;254602;73.1;65.6
81;2021-08-26;855;2110;284379;256712;73.3;66.2
81;2021-08-27;853;2185;285232;258897;73.5;66.7
81;2021-08-28;484;1417;285716;260314;73.7;67.1
81;2021-08-29;163;832;285879;261146;73.7;67.3
81;2021-08-30;420;1211;286299;262357;73.8;67.6
81;2021-08-31;831;2117;287130;264474;74.0;68.2
81;2021-09-01;657;1410;287787;265884;74.2;68.5
81;2021-09-02;575;1305;288362;267189;74.3;68.9
81;2021-09-03;581;1466;288943;268655;74.5;69.3
81;2021-09-04;496;932;289439;269587;74.6;69.5
81;2021-09-05;97;245;289536;269832;74.6;69.6
81;2021-09-06;277;678;289813;270510;74.7;69.7
81;2021-09-07;388;1380;290201;271890;74.8;70.1
81;2021-09-08;439;1267;290640;273157;74.9;70.4
81;2021-09-09;367;1040;291007;274197;75.0;70.7
81;2021-09-10;394;1247;291401;275444;75.1;71.0
81;2021-09-11;407;926;291808;276370;75.2;71.2
81;2021-09-12;79;244;291887;276614;75.2;71.3
81;2021-09-13;230;729;292117;277343;75.3;71.5
81;2021-09-14;498;1196;292615;278539;75.4;71.8
81;2021-09-15;452;764;293067;279303;75.6;72.0
81;2021-09-16;335;548;293402;279851;75.6;72.1
81;2021-09-17;411;841;293813;280692;75.7;72.4
81;2021-09-18;258;697;294071;281389;75.8;72.5
81;2021-09-19;50;164;294121;281553;75.8;72.6
81;2021-09-20;107;323;294228;281876;75.9;72.7
81;2021-09-21;265;596;294493;282472;75.9;72.8
81;2021-09-22;212;664;294705;283136;76.0;73.0
81;2021-09-23;164;663;294869;283799;76.0;73.2
81;2021-09-24;308;705;295177;284504;76.1;73.3
81;2021-09-25;173;673;295350;285177;76.1;73.5
81;2021-09-26;36;116;295386;285293;76.2;73.5
81;2021-09-27;136;272;295522;285565;76.2;73.6
81;2021-09-28;185;362;295707;285927;76.2;73.7
81;2021-09-29;248;517;295955;286444;76.3;73.8
81;2021-09-30;141;293;296096;286737;76.3;73.9
81;2021-10-01;243;426;296339;287163;76.4;74.0
81;2021-10-02;180;415;296519;287578;76.4;74.1
81;2021-10-03;44;104;296563;287682;76.5;74.2
82;2020-12-27;1;0;1;0;0.0;0.0
82;2020-12-28;2;0;3;0;0.0;0.0
82;2020-12-29;0;0;3;0;0.0;0.0
82;2020-12-30;0;0;3;0;0.0;0.0
82;2020-12-31;0;0;3;0;0.0;0.0
82;2021-01-01;0;0;3;0;0.0;0.0
82;2021-01-02;0;0;3;0;0.0;0.0
82;2021-01-03;0;0;3;0;0.0;0.0
82;2021-01-04;0;0;3;0;0.0;0.0
82;2021-01-05;86;0;89;0;0.0;0.0
82;2021-01-06;1;0;90;0;0.0;0.0
82;2021-01-07;75;0;165;0;0.1;0.0
82;2021-01-08;46;0;211;0;0.1;0.0
82;2021-01-09;77;0;288;0;0.1;0.0
82;2021-01-10;0;0;288;0;0.1;0.0
82;2021-01-11;94;0;382;0;0.1;0.0
82;2021-01-12;285;0;667;0;0.3;0.0
82;2021-01-13;336;1;1003;1;0.4;0.0
82;2021-01-14;443;2;1446;3;0.6;0.0
82;2021-01-15;612;2;2058;5;0.8;0.0
82;2021-01-16;230;3;2288;8;0.9;0.0
82;2021-01-17;89;0;2377;8;0.9;0.0
82;2021-01-18;432;0;2809;8;1.1;0.0
82;2021-01-19;482;1;3291;9;1.3;0.0
82;2021-01-20;663;2;3954;11;1.5;0.0
82;2021-01-21;447;2;4401;13;1.7;0.0
82;2021-01-22;483;2;4884;15;1.9;0.0
82;2021-01-23;151;0;5035;15;1.9;0.0
82;2021-01-24;0;0;5035;15;1.9;0.0
82;2021-01-25;375;0;5410;15;2.1;0.0
82;2021-01-26;468;0;5878;15;2.2;0.0
82;2021-01-27;520;0;6398;15;2.4;0.0
82;2021-01-28;587;34;6985;49;2.7;0.0
82;2021-01-29;405;108;7390;157;2.8;0.1
82;2021-01-30;44;20;7434;177;2.8;0.1
82;2021-01-31;2;0;7436;177;2.8;0.1
82;2021-02-01;292;53;7728;230;2.9;0.1
82;2021-02-02;344;96;8072;326;3.1;0.1
82;2021-02-03;462;65;8534;391;3.2;0.1
82;2021-02-04;768;208;9302;599;3.5;0.2
82;2021-02-05;480;132;9782;731;3.7;0.3
82;2021-02-06;93;36;9875;767;3.8;0.3
82;2021-02-07;29;79;9904;846;3.8;0.3
82;2021-02-08;151;185;10055;1031;3.8;0.4
82;2021-02-09;238;330;10293;1361;3.9;0.5
82;2021-02-10;271;543;10564;1904;4.0;0.7
82;2021-02-11;225;347;10789;2251;4.1;0.9
82;2021-02-12;190;520;10979;2771;4.2;1.1
82;2021-02-13;60;97;11039;2868;4.2;1.1
82;2021-02-14;5;61;11044;2929;4.2;1.1
82;2021-02-15;216;246;11260;3175;4.3;1.2
82;2021-02-16;280;326;11540;3501;4.4;1.3
82;2021-02-17;359;463;11899;3964;4.5;1.5
82;2021-02-18;507;430;12406;4394;4.7;1.7
82;2021-02-19;490;500;12896;4894;4.9;1.9
82;2021-02-20;78;119;12974;5013;4.9;1.9
82;2021-02-21;0;0;12974;5013;4.9;1.9
82;2021-02-22;200;332;13174;5345;5.0;2.0
82;2021-02-23;277;411;13451;5756;5.1;2.2
82;2021-02-24;282;363;13733;6119;5.2;2.3
82;2021-02-25;637;465;14370;6584;5.5;2.5
82;2021-02-26;648;382;15018;6966;5.7;2.7
82;2021-02-27;214;63;15232;7029;5.8;2.7
82;2021-02-28;30;7;15262;7036;5.8;2.7
82;2021-03-01;291;197;15553;7233;5.9;2.8
82;2021-03-02;495;356;16048;7589;6.1;2.9
82;2021-03-03;440;342;16488;7931;6.3;3.0
82;2021-03-04;600;280;17088;8211;6.5;3.1
82;2021-03-05;680;359;17768;8570;6.8;3.3
82;2021-03-06;693;36;18461;8606;7.0;3.3
82;2021-03-07;302;3;18763;8609;7.1;3.3
82;2021-03-08;603;141;19366;8750;7.4;3.3
82;2021-03-09;582;229;19948;8979;7.6;3.4
82;2021-03-10;779;223;20727;9202;7.9;3.5
82;2021-03-11;977;267;21704;9469;8.3;3.6
82;2021-03-12;992;99;22696;9568;8.6;3.6
82;2021-03-13;564;54;23260;9622;8.9;3.7
82;2021-03-14;61;5;23321;9627;8.9;3.7
82;2021-03-15;485;312;23806;9939;9.1;3.8
82;2021-03-16;197;324;24003;10263;9.1;3.9
82;2021-03-17;191;285;24194;10548;9.2;4.0
82;2021-03-18;279;344;24473;10892;9.3;4.1
82;2021-03-19;533;303;25006;11195;9.5;4.3
82;2021-03-20;251;56;25257;11251;9.6;4.3
82;2021-03-21;23;0;25280;11251;9.6;4.3
82;2021-03-22;406;317;25686;11568;9.8;4.4
82;2021-03-23;601;312;26287;11880;10.0;4.5
82;2021-03-24;621;321;26908;12201;10.2;4.6
82;2021-03-25;928;244;27836;12445;10.6;4.7
82;2021-03-26;1216;264;29052;12709;11.1;4.8
82;2021-03-27;479;78;29531;12787;11.2;4.9
82;2021-03-28;136;2;29667;12789;11.3;4.9
82;2021-03-29;925;375;30592;13164;11.6;5.0
82;2021-03-30;1188;280;31780;13444;12.1;5.1
82;2021-03-31;1018;260;32798;13704;12.5;5.2
82;2021-04-01;1070;196;33868;13900;12.9;5.3
82;2021-04-02;1213;284;35081;14184;13.4;5.4
82;2021-04-03;715;129;35796;14313;13.6;5.5
82;2021-04-04;276;14;36072;14327;13.7;5.5
82;2021-04-05;388;20;36460;14347;13.9;5.5
82;2021-04-06;953;510;37413;14857;14.2;5.7
82;2021-04-07;1016;495;38429;15352;14.6;5.8
82;2021-04-08;1454;418;39883;15770;15.2;6.0
82;2021-04-09;1656;470;41539;16240;15.8;6.2
82;2021-04-10;1716;103;43255;16343;16.5;6.2
82;2021-04-11;560;19;43815;16362;16.7;6.2
82;2021-04-12;1348;294;45163;16656;17.2;6.3
82;2021-04-13;1626;271;46789;16927;17.8;6.4
82;2021-04-14;1411;298;48200;17225;18.4;6.6
82;2021-04-15;1781;324;49981;17549;19.0;6.7
82;2021-04-16;1542;335;51523;17884;19.6;6.8
82;2021-04-17;1243;70;52766;17954;20.1;6.8
82;2021-04-18;560;15;53326;17969;20.3;6.8
82;2021-04-19;958;358;54284;18327;20.7;7.0
82;2021-04-20;1267;401;55551;18728;21.2;7.1
82;2021-04-21;1217;373;56768;19101;21.6;7.3
82;2021-04-22;1452;294;58220;19395;22.2;7.4
82;2021-04-23;1076;682;59296;20077;22.6;7.6
82;2021-04-24;1188;265;60484;20342;23.0;7.7
82;2021-04-25;736;49;61220;20391;23.3;7.8
82;2021-04-26;748;808;61968;21199;23.6;8.1
82;2021-04-27;905;921;62873;22120;23.9;8.4
82;2021-04-28;921;896;63794;23016;24.3;8.8
82;2021-04-29;1107;912;64901;23928;24.7;9.1
82;2021-04-30;1042;884;65943;24812;25.1;9.4
82;2021-05-01;1143;258;67086;25070;25.5;9.5
82;2021-05-02;697;145;67783;25215;25.8;9.6
82;2021-05-03;410;1215;68193;26430;26.0;10.1
82;2021-05-04;862;1167;69055;27597;26.3;10.5
82;2021-05-05;568;1172;69623;28769;26.5;11.0
82;2021-05-06;848;1409;70471;30178;26.8;11.5
82;2021-05-07;734;1456;71205;31634;27.1;12.0
82;2021-05-08;934;518;72139;32152;27.5;12.2
82;2021-05-09;753;578;72892;32730;27.8;12.5
82;2021-05-10;850;1363;73742;34093;28.1;13.0
82;2021-05-11;1157;1347;74899;35440;28.5;13.5
82;2021-05-12;1015;1344;75914;36784;28.9;14.0
82;2021-05-13;1454;432;77368;37216;29.5;14.2
82;2021-05-14;1690;1239;79058;38455;30.1;14.6
82;2021-05-15;1934;696;80992;39151;30.8;14.9
82;2021-05-16;558;114;81550;39265;31.1;15.0
82;2021-05-17;1090;1172;82640;40437;31.5;15.4
82;2021-05-18;1465;1189;84105;41626;32.0;15.9
82;2021-05-19;1272;974;85377;42600;32.5;16.2
82;2021-05-20;1408;1160;86785;43760;33.0;16.7
82;2021-05-21;1411;1218;88196;44978;33.6;17.1
82;2021-05-22;2067;623;90263;45601;34.4;17.4
82;2021-05-23;705;117;90968;45718;34.6;17.4
82;2021-05-24;1441;265;92409;45983;35.2;17.5
82;2021-05-25;1444;963;93853;46946;35.7;17.9
82;2021-05-26;1411;919;95264;47865;36.3;18.2
82;2021-05-27;1460;1025;96724;48890;36.8;18.6
82;2021-05-28;1540;1139;98264;50029;37.4;19.1
82;2021-05-29;1496;543;99760;50572;38.0;19.3
82;2021-05-30;402;101;100162;50673;38.1;19.3
82;2021-05-31;1490;990;101652;51663;38.7;19.7
82;2021-06-01;1750;1048;103402;52711;39.4;20.1
82;2021-06-02;1477;1005;104879;53716;39.9;20.5
82;2021-06-03;1489;1181;106368;54897;40.5;20.9
82;2021-06-04;2250;1305;108618;56202;41.4;21.4
82;2021-06-05;2267;984;110885;57186;42.2;21.8
82;2021-06-06;329;133;111214;57319;42.3;21.8
82;2021-06-07;957;1275;112171;58594;42.7;22.3
82;2021-06-08;1445;1138;113616;59732;43.3;22.7
82;2021-06-09;1707;1142;115323;60874;43.9;23.2
82;2021-06-10;1441;1208;116764;62082;44.5;23.6
82;2021-06-11;1922;1128;118686;63210;45.2;24.1
82;2021-06-12;2392;1393;121078;64603;46.1;24.6
82;2021-06-13;379;113;121457;64716;46.2;24.6
82;2021-06-14;1213;1082;122670;65798;46.7;25.1
82;2021-06-15;1462;1245;124132;67043;47.3;25.5
82;2021-06-16;1749;1168;125881;68211;47.9;26.0
82;2021-06-17;1219;1472;127100;69683;48.4;26.5
82;2021-06-18;1469;1439;128569;71122;49.0;27.1
82;2021-06-19;2269;981;130838;72103;49.8;27.5
82;2021-06-20;269;173;131107;72276;49.9;27.5
82;2021-06-21;484;1361;131591;73637;50.1;28.0
82;2021-06-22;892;1710;132483;75347;50.4;28.7
82;2021-06-23;1238;1586;133721;76933;50.9;29.3
82;2021-06-24;756;1904;134477;78837;51.2;30.0
82;2021-06-25;739;1936;135216;80773;51.5;30.8
82;2021-06-26;1239;2145;136455;82918;52.0;31.6
82;2021-06-27;195;440;136650;83358;52.0;31.7
82;2021-06-28;329;1411;136979;84769;52.2;32.3
82;2021-06-29;518;1840;137497;86609;52.4;33.0
82;2021-06-30;947;1912;138444;88521;52.7;33.7
82;2021-07-01;658;1632;139102;90153;53.0;34.3
82;2021-07-02;931;2293;140033;92446;53.3;35.2
82;2021-07-03;858;2340;140891;94786;53.6;36.1
82;2021-07-04;120;439;141011;95225;53.7;36.3
82;2021-07-05;445;1561;141456;96786;53.9;36.9
82;2021-07-06;513;1866;141969;98652;54.1;37.6
82;2021-07-07;793;1772;142762;100424;54.4;38.2
82;2021-07-08;504;1504;143266;101928;54.6;38.8
82;2021-07-09;781;2154;144047;104082;54.9;39.6
82;2021-07-10;706;2215;144753;106297;55.1;40.5
82;2021-07-11;39;380;144792;106677;55.1;40.6
82;2021-07-12;578;1884;145370;108561;55.4;41.3
82;2021-07-13;714;2003;146084;110564;55.6;42.1
82;2021-07-14;617;741;146701;111305;55.9;42.4
82;2021-07-15;858;1748;147559;113053;56.2;43.0
82;2021-07-16;1436;2636;148995;115689;56.7;44.1
82;2021-07-17;560;2182;149555;117871;56.9;44.9
82;2021-07-18;14;41;149569;117912;57.0;44.9
82;2021-07-19;736;2072;150305;119984;57.2;45.7
82;2021-07-20;920;1883;151225;121867;57.6;46.4
82;2021-07-21;1289;1759;152514;123626;58.1;47.1
82;2021-07-22;1083;1765;153597;125391;58.5;47.7
82;2021-07-23;1056;2990;154653;128381;58.9;48.9
82;2021-07-24;1102;1490;155755;129871;59.3;49.5
82;2021-07-25;303;73;156058;129944;59.4;49.5
82;2021-07-26;950;1896;157008;131840;59.8;50.2
82;2021-07-27;1324;1640;158332;133480;60.3;50.8
82;2021-07-28;1469;1499;159801;134979;60.8;51.4
82;2021-07-29;1331;1534;161132;136513;61.4;52.0
82;2021-07-30;1537;2474;162669;138987;61.9;52.9
82;2021-07-31;459;295;163128;139282;62.1;53.0
82;2021-08-01;273;50;163401;139332;62.2;53.1
82;2021-08-02;1271;878;164672;140210;62.7;53.4
82;2021-08-03;1435;832;166107;141042;63.3;53.7
82;2021-08-04;1363;1029;167470;142071;63.8;54.1
82;2021-08-05;1491;600;168961;142671;64.3;54.3
82;2021-08-06;995;646;169956;143317;64.7;54.6
82;2021-08-07;923;1196;170879;144513;65.1;55.0
82;2021-08-08;157;65;171036;144578;65.1;55.1
82;2021-08-09;1071;899;172107;145477;65.5;55.4
82;2021-08-10;1290;915;173397;146392;66.0;55.7
82;2021-08-11;1264;1123;174661;147515;66.5;56.2
82;2021-08-12;1473;946;176134;148461;67.1;56.5
82;2021-08-13;1413;997;177547;149458;67.6;56.9
82;2021-08-14;313;485;177860;149943;67.7;57.1
82;2021-08-15;61;38;177921;149981;67.7;57.1
82;2021-08-16;781;1459;178702;151440;68.0;57.7
82;2021-08-17;1064;1236;179766;152676;68.5;58.1
82;2021-08-18;616;848;180382;153524;68.7;58.5
82;2021-08-19;1012;1146;181394;154670;69.1;58.9
82;2021-08-20;1033;1907;182427;156577;69.5;59.6
82;2021-08-21;495;990;182922;157567;69.7;60.0
82;2021-08-22;21;55;182943;157622;69.7;60.0
82;2021-08-23;745;1292;183688;158914;69.9;60.5
82;2021-08-24;863;1117;184551;160031;70.3;60.9
82;2021-08-25;849;1538;185400;161569;70.6;61.5
82;2021-08-26;598;1108;185998;162677;70.8;61.9
82;2021-08-27;898;1685;186896;164362;71.2;62.6
82;2021-08-28;211;616;187107;164978;71.2;62.8
82;2021-08-29;44;49;187151;165027;71.3;62.8
82;2021-08-30;430;1024;187581;166051;71.4;63.2
82;2021-08-31;339;1028;187920;167079;71.6;63.6
82;2021-09-01;721;1406;188641;168485;71.8;64.2
82;2021-09-02;406;1294;189047;169779;72.0;64.6
82;2021-09-03;500;1882;189547;171661;72.2;65.4
82;2021-09-04;426;741;189973;172402;72.3;65.6
82;2021-09-05;6;23;189979;172425;72.3;65.7
82;2021-09-06;374;1289;190353;173714;72.5;66.1
82;2021-09-07;209;961;190562;174675;72.6;66.5
82;2021-09-08;495;1259;191057;175934;72.8;67.0
82;2021-09-09;249;1045;191306;176979;72.8;67.4
82;2021-09-10;487;1458;191793;178437;73.0;67.9
82;2021-09-11;212;521;192005;178958;73.1;68.1
82;2021-09-12;10;29;192015;178987;73.1;68.2
82;2021-09-13;297;1115;192312;180102;73.2;68.6
82;2021-09-14;210;945;192522;181047;73.3;68.9
82;2021-09-15;306;1166;192828;182213;73.4;69.4
82;2021-09-16;220;495;193048;182708;73.5;69.6
82;2021-09-17;187;495;193235;183203;73.6;69.8
82;2021-09-18;326;1082;193561;184285;73.7;70.2
82;2021-09-19;1;14;193562;184299;73.7;70.2
82;2021-09-20;140;415;193702;184714;73.8;70.3
82;2021-09-21;94;382;193796;185096;73.8;70.5
82;2021-09-22;136;455;193932;185551;73.8;70.7
82;2021-09-23;112;382;194044;185933;73.9;70.8
82;2021-09-24;209;599;194253;186532;74.0;71.0
82;2021-09-25;231;658;194484;187190;74.1;71.3
82;2021-09-26;5;10;194489;187200;74.1;71.3
82;2021-09-27;100;453;194589;187653;74.1;71.5
82;2021-09-28;90;229;194679;187882;74.1;71.5
82;2021-09-29;231;479;194910;188361;74.2;71.7
82;2021-09-30;110;250;195020;188611;74.3;71.8
82;2021-10-01;195;372;195215;188983;74.3;72.0
82;2021-10-02;130;271;195345;189254;74.4;72.1
82;2021-10-03;0;1;195345;189255;74.4;72.1
83;2020-12-27;1;0;1;0;0.0;0.0
83;2020-12-28;0;0;1;0;0.0;0.0
83;2020-12-29;2;0;3;0;0.0;0.0
83;2020-12-30;3;0;6;0;0.0;0.0
83;2020-12-31;0;0;6;0;0.0;0.0
83;2021-01-01;1;0;7;0;0.0;0.0
83;2021-01-02;0;0;7;0;0.0;0.0
83;2021-01-03;1;0;8;0;0.0;0.0
83;2021-01-04;1;0;9;0;0.0;0.0
83;2021-01-05;4;0;13;0;0.0;0.0
83;2021-01-06;69;0;82;0;0.0;0.0
83;2021-01-07;324;0;406;0;0.0;0.0
83;2021-01-08;421;0;827;0;0.1;0.0
83;2021-01-09;48;0;875;0;0.1;0.0
83;2021-01-10;1;0;876;0;0.1;0.0
83;2021-01-11;475;0;1351;0;0.1;0.0
83;2021-01-12;1015;4;2366;4;0.2;0.0
83;2021-01-13;963;7;3329;11;0.3;0.0
83;2021-01-14;847;5;4176;16;0.4;0.0
83;2021-01-15;714;2;4890;18;0.5;0.0
83;2021-01-16;42;1;4932;19;0.5;0.0
83;2021-01-17;1;0;4933;19;0.5;0.0
83;2021-01-18;1227;4;6160;23;0.6;0.0
83;2021-01-19;2019;6;8179;29;0.8;0.0
83;2021-01-20;1661;7;9840;36;0.9;0.0
83;2021-01-21;2098;7;11938;43;1.1;0.0
83;2021-01-22;1662;6;13600;49;1.3;0.0
83;2021-01-23;246;0;13846;49;1.3;0.0
83;2021-01-24;21;1;13867;50;1.3;0.0
83;2021-01-25;1557;7;15424;57;1.4;0.0
83;2021-01-26;1758;12;17182;69;1.6;0.0
83;2021-01-27;2154;79;19336;148;1.8;0.0
83;2021-01-28;5098;342;24434;490;2.3;0.0
83;2021-01-29;2951;317;27385;807;2.6;0.1
83;2021-01-30;237;42;27622;849;2.6;0.1
83;2021-01-31;46;0;27668;849;2.6;0.1
83;2021-02-01;1283;380;28951;1229;2.7;0.1
83;2021-02-02;1440;682;30391;1911;2.8;0.2
83;2021-02-03;1527;587;31918;2498;3.0;0.2
83;2021-02-04;1485;702;33403;3200;3.1;0.3
83;2021-02-05;1226;610;34629;3810;3.2;0.4
83;2021-02-06;23;12;34652;3822;3.2;0.4
83;2021-02-07;1;0;34653;3822;3.2;0.4
83;2021-02-08;1090;550;35743;4372;3.3;0.4
83;2021-02-09;1325;757;37068;5129;3.5;0.5
83;2021-02-10;1536;722;38604;5851;3.6;0.5
83;2021-02-11;1612;975;40216;6826;3.7;0.6
83;2021-02-12;1349;768;41565;7594;3.9;0.7
83;2021-02-13;55;21;41620;7615;3.9;0.7
83;2021-02-14;0;0;41620;7615;3.9;0.7
83;2021-02-15;677;768;42297;8383;3.9;0.8
83;2021-02-16;544;1073;42841;9456;4.0;0.9
83;2021-02-17;804;1502;43645;10958;4.1;1.0
83;2021-02-18;1630;3349;45275;14307;4.2;1.3
83;2021-02-19;1482;1999;46757;16306;4.4;1.5
83;2021-02-20;63;155;46820;16461;4.4;1.5
83;2021-02-21;25;33;46845;16494;4.4;1.5
83;2021-02-22;507;1382;47352;17876;4.4;1.7
83;2021-02-23;671;1133;48023;19009;4.5;1.8
83;2021-02-24;725;1175;48748;20184;4.5;1.9
83;2021-02-25;1251;1106;49999;21290;4.7;2.0
83;2021-02-26;1298;979;51297;22269;4.8;2.1
83;2021-02-27;552;50;51849;22319;4.8;2.1
83;2021-02-28;10;12;51859;22331;4.8;2.1
83;2021-03-01;808;986;52667;23317;4.9;2.2
83;2021-03-02;992;1067;53659;24384;5.0;2.3
83;2021-03-03;1440;1283;55099;25667;5.1;2.4
83;2021-03-04;1891;1165;56990;26832;5.3;2.5
83;2021-03-05;2221;1064;59211;27896;5.5;2.6
83;2021-03-06;3010;111;62221;28007;5.8;2.6
83;2021-03-07;2227;44;64448;28051;6.0;2.6
83;2021-03-08;851;1104;65299;29155;6.1;2.7
83;2021-03-09;1938;1037;67237;30192;6.3;2.8
83;2021-03-10;2381;1230;69618;31422;6.5;2.9
83;2021-03-11;3677;2041;73295;33463;6.8;3.1
83;2021-03-12;3661;1379;76956;34842;7.2;3.2
83;2021-03-13;4614;174;81570;35016;7.6;3.3
83;2021-03-14;2341;55;83911;35071;7.8;3.3
83;2021-03-15;3339;650;87250;35721;8.1;3.3
83;2021-03-16;2601;663;89851;36384;8.4;3.4
83;2021-03-17;2846;740;92697;37124;8.6;3.5
83;2021-03-18;3550;783;96247;37907;9.0;3.5
83;2021-03-19;4175;581;100422;38488;9.4;3.6
83;2021-03-20;3477;71;103899;38559;9.7;3.6
83;2021-03-21;2011;32;105910;38591;9.9;3.6
83;2021-03-22;3965;886;109875;39477;10.2;3.7
83;2021-03-23;4751;579;114626;40056;10.7;3.7
83;2021-03-24;5050;708;119676;40764;11.1;3.8
83;2021-03-25;6534;844;126210;41608;11.8;3.9
83;2021-03-26;7174;749;133384;42357;12.4;3.9
83;2021-03-27;3969;383;137353;42740;12.8;4.0
83;2021-03-28;2183;34;139536;42774;13.0;4.0
83;2021-03-29;4557;760;144093;43534;13.4;4.1
83;2021-03-30;5970;939;150063;44473;14.0;4.1
83;2021-03-31;5554;1071;155617;45544;14.5;4.2
83;2021-04-01;5980;1250;161597;46794;15.0;4.4
83;2021-04-02;5762;1069;167359;47863;15.6;4.5
83;2021-04-03;1800;628;169159;48491;15.8;4.5
83;2021-04-04;854;345;170013;48836;15.8;4.5
83;2021-04-05;190;64;170203;48900;15.8;4.6
83;2021-04-06;4731;1392;174934;50292;16.3;4.7
83;2021-04-07;5832;1657;180766;51949;16.8;4.8
83;2021-04-08;7893;2001;188659;53950;17.6;5.0
83;2021-04-09;7598;2200;196257;56150;18.3;5.2
83;2021-04-10;2948;2643;199205;58793;18.6;5.5
83;2021-04-11;1715;2131;200920;60924;18.7;5.7
83;2021-04-12;4951;2855;205871;63779;19.2;5.9
83;2021-04-13;5408;2992;211279;66771;19.7;6.2
83;2021-04-14;5896;2932;217175;69703;20.2;6.5
83;2021-04-15;6774;3034;223949;72737;20.9;6.8
83;2021-04-16;6127;3515;230076;76252;21.4;7.1
83;2021-04-17;3510;2185;233586;78437;21.8;7.3
83;2021-04-18;2179;1292;235765;79729;22.0;7.4
83;2021-04-19;4111;3898;239876;83627;22.3;7.8
83;2021-04-20;4360;3866;244236;87493;22.7;8.1
83;2021-04-21;4300;4144;248536;91637;23.1;8.5
83;2021-04-22;5008;4292;253544;95929;23.6;8.9
83;2021-04-23;4528;4562;258072;100491;24.0;9.4
83;2021-04-24;2629;2711;260701;103202;24.3;9.6
83;2021-04-25;1925;1571;262626;104773;24.5;9.8
83;2021-04-26;3568;3848;266194;108621;24.8;10.1
83;2021-04-27;4140;4536;270334;113157;25.2;10.5
83;2021-04-28;4314;4359;274648;117516;25.6;10.9
83;2021-04-29;5823;5108;280471;122624;26.1;11.4
83;2021-04-30;5785;4286;286256;126910;26.7;11.8
83;2021-05-01;1693;429;287949;127339;26.8;11.9
83;2021-05-02;1237;758;289186;128097;26.9;11.9
83;2021-05-03;3750;4282;292936;132379;27.3;12.3
83;2021-05-04;3346;5096;296282;137475;27.6;12.8
83;2021-05-05;3643;4972;299925;142447;27.9;13.3
83;2021-05-06;4676;4949;304601;147396;28.4;13.7
83;2021-05-07;4166;5307;308767;152703;28.8;14.2
83;2021-05-08;2764;1012;311531;153715;29.0;14.3
83;2021-05-09;2151;1236;313682;154951;29.2;14.4
83;2021-05-10;3201;5416;316883;160367;29.5;14.9
83;2021-05-11;5126;5684;322009;166051;30.0;15.5
83;2021-05-12;6292;4846;328301;170897;30.6;15.9
83;2021-05-13;6580;1343;334881;172240;31.2;16.0
83;2021-05-14;7422;4116;342303;176356;31.9;16.4
83;2021-05-15;7751;2204;350054;178560;32.6;16.6
83;2021-05-16;6625;1248;356679;179808;33.2;16.7
83;2021-05-17;4892;4209;361571;184017;33.7;17.1
83;2021-05-18;5534;3862;367105;187879;34.2;17.5
83;2021-05-19;6205;3409;373310;191288;34.8;17.8
83;2021-05-20;6752;3805;380062;195093;35.4;18.2
83;2021-05-21;7905;3864;387967;198957;36.1;18.5
83;2021-05-22;6086;1719;394053;200676;36.7;18.7
83;2021-05-23;4682;713;398735;201389;37.1;18.8
83;2021-05-24;5809;973;404544;202362;37.7;18.8
83;2021-05-25;5510;4755;410054;207117;38.2;19.3
83;2021-05-26;4857;4444;414911;211561;38.6;19.7
83;2021-05-27;5068;5250;419979;216811;39.1;20.2
83;2021-05-28;4503;5755;424482;222566;39.5;20.7
83;2021-05-29;2704;4264;427186;226830;39.8;21.1
83;2021-05-30;1256;1372;428442;228202;39.9;21.3
83;2021-05-31;5487;4763;433929;232965;40.4;21.7
83;2021-06-01;5732;5290;439661;238255;40.9;22.2
83;2021-06-02;5262;4581;444923;242836;41.4;22.6
83;2021-06-03;5744;5128;450667;247964;42.0;23.1
83;2021-06-04;5444;6040;456111;254004;42.5;23.7
83;2021-06-05;3919;3197;460030;257201;42.8;24.0
83;2021-06-06;1933;1383;461963;258584;43.0;24.1
83;2021-06-07;3913;5088;465876;263672;43.4;24.6
83;2021-06-08;4174;4816;470050;268488;43.8;25.0
83;2021-06-09;4007;4700;474057;273188;44.1;25.4
83;2021-06-10;3999;4261;478056;277449;44.5;25.8
83;2021-06-11;3657;5446;481713;282895;44.9;26.3
83;2021-06-12;2913;2982;484626;285877;45.1;26.6
83;2021-06-13;995;1390;485621;287267;45.2;26.8
83;2021-06-14;2853;5651;488474;292918;45.5;27.3
83;2021-06-15;3166;4858;491640;297776;45.8;27.7
83;2021-06-16;2963;4503;494603;302279;46.1;28.1
83;2021-06-17;2784;5287;497387;307566;46.3;28.6
83;2021-06-18;3160;5964;500547;313530;46.6;29.2
83;2021-06-19;2323;4100;502870;317630;46.8;29.6
83;2021-06-20;676;1889;503546;319519;46.9;29.8
83;2021-06-21;2108;7585;505654;327104;47.1;30.5
83;2021-06-22;2103;7162;507757;334266;47.3;31.1
83;2021-06-23;1935;6929;509692;341195;47.5;31.8
83;2021-06-24;1962;7364;511654;348559;47.6;32.5
83;2021-06-25;2111;8394;513765;356953;47.8;33.2
83;2021-06-26;1462;6808;515227;363761;48.0;33.9
83;2021-06-27;692;3184;515919;366945;48.0;34.2
83;2021-06-28;1570;7881;517489;374826;48.2;34.9
83;2021-06-29;1907;7808;519396;382634;48.4;35.6
83;2021-06-30;2240;7272;521636;389906;48.6;36.3
83;2021-07-01;2562;6565;524198;396471;48.8;36.9
83;2021-07-02;2265;7798;526463;404269;49.0;37.6
83;2021-07-03;1508;5686;527971;409955;49.2;38.2
83;2021-07-04;572;2752;528543;412707;49.2;38.4
83;2021-07-05;1925;7531;530468;420238;49.4;39.1
83;2021-07-06;2571;5939;533039;426177;49.6;39.7
83;2021-07-07;2686;4667;535725;430844;49.9;40.1
83;2021-07-08;3246;4471;538971;435315;50.2;40.5
83;2021-07-09;3045;6963;542016;442278;50.5;41.2
83;2021-07-10;1579;4926;543595;447204;50.6;41.6
83;2021-07-11;1009;1766;544604;448970;50.7;41.8
83;2021-07-12;2142;7687;546746;456657;50.9;42.5
83;2021-07-13;4042;7093;550788;463750;51.3;43.2
83;2021-07-14;2094;1321;552882;465071;51.5;43.3
83;2021-07-15;4578;6843;557460;471914;51.9;43.9
83;2021-07-16;5274;7117;562734;479031;52.4;44.6
83;2021-07-17;3648;4999;566382;484030;52.7;45.1
83;2021-07-18;1604;1311;567986;485341;52.9;45.2
83;2021-07-19;3954;6316;571940;491657;53.3;45.8
83;2021-07-20;5986;6188;577926;497845;53.8;46.4
83;2021-07-21;6031;5214;583957;503059;54.4;46.8
83;2021-07-22;7117;5538;591074;508597;55.0;47.4
83;2021-07-23;7098;5917;598172;514514;55.7;47.9
83;2021-07-24;4650;4560;602822;519074;56.1;48.3
83;2021-07-25;1329;737;604151;519811;56.3;48.4
83;2021-07-26;5545;4936;609696;524747;56.8;48.9
83;2021-07-27;6833;4903;616529;529650;57.4;49.3
83;2021-07-28;6601;4426;623130;534076;58.0;49.7
83;2021-07-29;7499;4858;630629;538934;58.7;50.2
83;2021-07-30;6968;4760;637597;543694;59.4;50.6
83;2021-07-31;4667;3217;642264;546911;59.8;50.9
83;2021-08-01;1066;850;643330;547761;59.9;51.0
83;2021-08-02;5771;3707;649101;551468;60.4;51.4
83;2021-08-03;6384;3996;655485;555464;61.0;51.7
83;2021-08-04;5914;3712;661399;559176;61.6;52.1
83;2021-08-05;6182;4088;667581;563264;62.2;52.5
83;2021-08-06;6162;4914;673743;568178;62.7;52.9
83;2021-08-07;3750;3557;677493;571735;63.1;53.2
83;2021-08-08;1064;823;678557;572558;63.2;53.3
83;2021-08-09;4717;4646;683274;577204;63.6;53.8
83;2021-08-10;5235;5146;688509;582350;64.1;54.2
83;2021-08-11;4592;5067;693101;587417;64.5;54.7
83;2021-08-12;4926;5568;698027;592985;65.0;55.2
83;2021-08-13;4938;5741;702965;598726;65.5;55.8
83;2021-08-14;3223;3892;706188;602618;65.8;56.1
83;2021-08-15;208;392;706396;603010;65.8;56.2
83;2021-08-16;3629;5482;710025;608492;66.1;56.7
83;2021-08-17;3576;5271;713601;613763;66.5;57.2
83;2021-08-18;3604;5001;717205;618764;66.8;57.6
83;2021-08-19;4178;6261;721383;625025;67.2;58.2
83;2021-08-20;3641;6516;725024;631541;67.5;58.8
83;2021-08-21;2347;4489;727371;636030;67.7;59.2
83;2021-08-22;635;1033;728006;637063;67.8;59.3
83;2021-08-23;2507;5786;730513;642849;68.0;59.9
83;2021-08-24;2924;5921;733437;648770;68.3;60.4
83;2021-08-25;2583;5294;736020;654064;68.5;60.9
83;2021-08-26;2797;5844;738817;659908;68.8;61.5
83;2021-08-27;2918;5922;741735;665830;69.1;62.0
83;2021-08-28;1935;4538;743670;670368;69.3;62.4
83;2021-08-29;476;1161;744146;671529;69.3;62.5
83;2021-08-30;2383;4974;746529;676503;69.5;63.0
83;2021-08-31;2507;5479;749036;681982;69.8;63.5
83;2021-09-01;2545;5084;751581;687066;70.0;64.0
83;2021-09-02;2482;4970;754063;692036;70.2;64.4
83;2021-09-03;2326;5251;756389;697287;70.4;64.9
83;2021-09-04;1924;4644;758313;701931;70.6;65.4
83;2021-09-05;568;543;758881;702474;70.7;65.4
83;2021-09-06;1641;4111;760522;706585;70.8;65.8
83;2021-09-07;1659;3875;762181;710460;71.0;66.2
83;2021-09-08;1927;3861;764108;714321;71.2;66.5
83;2021-09-09;1489;3923;765597;718244;71.3;66.9
83;2021-09-10;1775;4336;767372;722580;71.5;67.3
83;2021-09-11;1371;3884;768743;726464;71.6;67.7
83;2021-09-12;204;497;768947;726961;71.6;67.7
83;2021-09-13;1213;3367;770160;730328;71.7;68.0
83;2021-09-14;1315;3489;771475;733817;71.8;68.3
83;2021-09-15;1353;2537;772828;736354;72.0;68.6
83;2021-09-16;1036;2173;773864;738527;72.1;68.8
83;2021-09-17;1029;2523;774893;741050;72.2;69.0
83;2021-09-18;1020;3000;775913;744050;72.3;69.3
83;2021-09-19;97;399;776010;744449;72.3;69.3
83;2021-09-20;673;2033;776683;746482;72.3;69.5
83;2021-09-21;718;1807;777401;748289;72.4;69.7
83;2021-09-22;760;2493;778161;750782;72.5;69.9
83;2021-09-23;711;2111;778872;752893;72.5;70.1
83;2021-09-24;721;2193;779593;755086;72.6;70.3
83;2021-09-25;735;2665;780328;757751;72.7;70.6
83;2021-09-26;71;449;780399;758200;72.7;70.6
83;2021-09-27;591;1729;780990;759929;72.7;70.8
83;2021-09-28;541;1503;781531;761432;72.8;70.9
83;2021-09-29;714;1879;782245;763311;72.8;71.1
83;2021-09-30;634;1503;782879;764814;72.9;71.2
83;2021-10-01;733;1525;783612;766339;73.0;71.4
83;2021-10-02;678;1610;784290;767949;73.0;71.5
83;2021-10-03;102;253;784392;768202;73.0;71.5
84;2020-12-27;1;0;1;0;0.0;0.0
84;2020-12-28;1;0;2;0;0.0;0.0
84;2020-12-29;3;0;5;0;0.0;0.0
84;2020-12-30;2;0;7;0;0.0;0.0
84;2020-12-31;2;0;9;0;0.0;0.0
84;2021-01-01;0;0;9;0;0.0;0.0
84;2021-01-02;0;0;9;0;0.0;0.0
84;2021-01-03;0;0;9;0;0.0;0.0
84;2021-01-04;0;0;9;0;0.0;0.0
84;2021-01-05;0;0;9;0;0.0;0.0
84;2021-01-06;0;0;9;0;0.0;0.0
84;2021-01-07;69;0;78;0;0.0;0.0
84;2021-01-08;84;0;162;0;0.0;0.0
84;2021-01-09;31;0;193;0;0.0;0.0
84;2021-01-10;0;0;193;0;0.0;0.0
84;2021-01-11;219;0;412;0;0.1;0.0
84;2021-01-12;624;2;1036;2;0.2;0.0
84;2021-01-13;359;0;1395;2;0.2;0.0
84;2021-01-14;959;12;2354;14;0.4;0.0
84;2021-01-15;619;9;2973;23;0.5;0.0
84;2021-01-16;167;0;3140;23;0.6;0.0
84;2021-01-17;29;1;3169;24;0.6;0.0
84;2021-01-18;697;2;3866;26;0.7;0.0
84;2021-01-19;881;2;4747;28;0.8;0.0
84;2021-01-20;1023;3;5770;31;1.0;0.0
84;2021-01-21;1050;5;6820;36;1.2;0.0
84;2021-01-22;1135;1;7955;37;1.4;0.0
84;2021-01-23;250;0;8205;37;1.5;0.0
84;2021-01-24;3;0;8208;37;1.5;0.0
84;2021-01-25;809;0;9017;37;1.6;0.0
84;2021-01-26;940;4;9957;41;1.8;0.0
84;2021-01-27;1073;2;11030;43;2.0;0.0
84;2021-01-28;1622;17;12652;60;2.3;0.0
84;2021-01-29;1203;57;13855;117;2.5;0.0
84;2021-01-30;171;16;14026;133;2.5;0.0
84;2021-01-31;7;0;14033;133;2.5;0.0
84;2021-02-01;660;124;14693;257;2.6;0.0
84;2021-02-02;789;245;15482;502;2.8;0.1
84;2021-02-03;762;228;16244;730;2.9;0.1
84;2021-02-04;912;370;17156;1100;3.1;0.2
84;2021-02-05;727;377;17883;1477;3.2;0.3
84;2021-02-06;127;40;18010;1517;3.2;0.3
84;2021-02-07;1;0;18011;1517;3.2;0.3
84;2021-02-08;569;231;18580;1748;3.3;0.3
84;2021-02-09;694;610;19274;2358;3.4;0.4
84;2021-02-10;560;491;19834;2849;3.5;0.5
84;2021-02-11;549;491;20383;3340;3.6;0.6
84;2021-02-12;561;592;20944;3932;3.7;0.7
84;2021-02-13;48;138;20992;4070;3.7;0.7
84;2021-02-14;3;0;20995;4070;3.7;0.7
84;2021-02-15;207;717;21202;4787;3.8;0.9
84;2021-02-16;222;672;21424;5459;3.8;1.0
84;2021-02-17;448;651;21872;6110;3.9;1.1
84;2021-02-18;557;936;22429;7046;4.0;1.3
84;2021-02-19;739;979;23168;8025;4.1;1.4
84;2021-02-20;68;114;23236;8139;4.1;1.5
84;2021-02-21;6;35;23242;8174;4.1;1.5
84;2021-02-22;369;613;23611;8787;4.2;1.6
84;2021-02-23;272;604;23883;9391;4.3;1.7
84;2021-02-24;395;603;24278;9994;4.3;1.8
84;2021-02-25;714;699;24992;10693;4.5;1.9
84;2021-02-26;823;568;25815;11261;4.6;2.0
84;2021-02-27;133;100;25948;11361;4.6;2.0
84;2021-02-28;17;0;25965;11361;4.6;2.0
84;2021-03-01;458;549;26423;11910;4.7;2.1
84;2021-03-02;633;696;27056;12606;4.8;2.2
84;2021-03-03;820;815;27876;13421;5.0;2.4
84;2021-03-04;1099;612;28975;14033;5.2;2.5
84;2021-03-05;1313;474;30288;14507;5.4;2.6
84;2021-03-06;1460;64;31748;14571;5.7;2.6
84;2021-03-07;481;16;32229;14587;5.7;2.6
84;2021-03-08;812;539;33041;15126;5.9;2.7
84;2021-03-09;1388;700;34429;15826;6.1;2.8
84;2021-03-10;1475;604;35904;16430;6.4;2.9
84;2021-03-11;1983;600;37887;17030;6.8;3.0
84;2021-03-12;2081;576;39968;17606;7.1;3.1
84;2021-03-13;747;36;40715;17642;7.3;3.1
84;2021-03-14;247;53;40962;17695;7.3;3.2
84;2021-03-15;1071;300;42033;17995;7.5;3.2
84;2021-03-16;1180;314;43213;18309;7.7;3.3
84;2021-03-17;1147;423;44360;18732;7.9;3.3
84;2021-03-18;1457;387;45817;19119;8.2;3.4
84;2021-03-19;2179;453;47996;19572;8.6;3.5
84;2021-03-20;841;27;48837;19599;8.7;3.5
84;2021-03-21;151;11;48988;19610;8.7;3.5
84;2021-03-22;1162;461;50150;20071;8.9;3.6
84;2021-03-23;1914;428;52064;20499;9.3;3.7
84;2021-03-24;2176;394;54240;20893;9.7;3.7
84;2021-03-25;3655;392;57895;21285;10.3;3.8
84;2021-03-26;3319;473;61214;21758;10.9;3.9
84;2021-03-27;915;58;62129;21816;11.1;3.9
84;2021-03-28;74;2;62203;21818;11.1;3.9
84;2021-03-29;1717;528;63920;22346;11.4;4.0
84;2021-03-30;2674;688;66594;23034;11.9;4.1
84;2021-03-31;2405;638;68999;23672;12.3;4.2
84;2021-04-01;3021;575;72020;24247;12.8;4.3
84;2021-04-02;2452;526;74472;24773;13.3;4.4
84;2021-04-03;510;29;74982;24802;13.4;4.4
84;2021-04-04;14;0;74996;24802;13.4;4.4
84;2021-04-05;814;100;75810;24902;13.5;4.4
84;2021-04-06;2144;840;77954;25742;13.9;4.6
84;2021-04-07;2405;862;80359;26604;14.3;4.7
84;2021-04-08;3653;1043;84012;27647;15.0;4.9
84;2021-04-09;4116;947;88128;28594;15.7;5.1
84;2021-04-10;1308;131;89436;28725;15.9;5.1
84;2021-04-11;37;12;89473;28737;15.9;5.1
84;2021-04-12;2093;806;91566;29543;16.3;5.3
84;2021-04-13;2940;1364;94506;30907;16.8;5.5
84;2021-04-14;2811;1350;97317;32257;17.3;5.7
84;2021-04-15;3272;1417;100589;33674;17.9;6.0
84;2021-04-16;3431;1551;104020;35225;18.5;6.3
84;2021-04-17;1666;200;105686;35425;18.8;6.3
84;2021-04-18;38;1;105724;35426;18.8;6.3
84;2021-04-19;2507;921;108231;36347;19.3;6.5
84;2021-04-20;2627;1527;110858;37874;19.8;6.8
84;2021-04-21;2651;1482;113509;39356;20.2;7.0
84;2021-04-22;3013;1740;116522;41096;20.8;7.3
84;2021-04-23;3042;1909;119564;43005;21.3;7.7
84;2021-04-24;1530;288;121094;43293;21.6;7.7
84;2021-04-25;27;2;121121;43295;21.6;7.7
84;2021-04-26;2198;1364;123319;44659;22.0;8.0
84;2021-04-27;2556;1977;125875;46636;22.4;8.3
84;2021-04-28;2818;1842;128693;48478;22.9;8.6
84;2021-04-29;3420;2047;132113;50525;23.5;9.0
84;2021-04-30;3134;2424;135247;52949;24.1;9.4
84;2021-05-01;457;259;135704;53208;24.2;9.5
84;2021-05-02;2;0;135706;53208;24.2;9.5
84;2021-05-03;2161;1626;137867;54834;24.6;9.8
84;2021-05-04;2488;2535;140355;57369;25.0;10.2
84;2021-05-05;2353;2226;142708;59595;25.4;10.6
84;2021-05-06;3223;2259;145931;61854;26.0;11.0
84;2021-05-07;2766;2559;148697;64413;26.5;11.5
84;2021-05-08;1158;527;149855;64940;26.7;11.6
84;2021-05-09;8;53;149863;64993;26.7;11.6
84;2021-05-10;2159;2466;152022;67459;27.1;12.0
84;2021-05-11;2905;3153;154927;70612;27.6;12.6
84;2021-05-12;2849;2920;157776;73532;28.1;13.1
84;2021-05-13;2160;848;159936;74380;28.5;13.3
84;2021-05-14;2728;2037;162664;76417;29.0;13.6
84;2021-05-15;2001;986;164665;77403;29.4;13.8
84;2021-05-16;1340;187;166005;77590;29.6;13.8
84;2021-05-17;2224;2156;168229;79746;30.0;14.2
84;2021-05-18;2904;2113;171133;81859;30.5;14.6
84;2021-05-19;3230;1665;174363;83524;31.1;14.9
84;2021-05-20;3698;2208;178061;85732;31.7;15.3
84;2021-05-21;3471;2331;181532;88063;32.4;15.7
84;2021-05-22;1582;682;183114;88745;32.6;15.8
84;2021-05-23;6;9;183120;88754;32.6;15.8
84;2021-05-24;1840;425;184960;89179;33.0;15.9
84;2021-05-25;2984;2187;187944;91366;33.5;16.3
84;2021-05-26;3075;2090;191019;93456;34.0;16.7
84;2021-05-27;3857;2314;194876;95770;34.7;17.1
84;2021-05-28;3179;3303;198055;99073;35.3;17.7
84;2021-05-29;1093;1649;199148;100722;35.5;18.0
84;2021-05-30;10;85;199158;100807;35.5;18.0
84;2021-05-31;2191;2638;201349;103445;35.9;18.4
84;2021-06-01;3141;3158;204490;106603;36.5;19.0
84;2021-06-02;3170;2631;207660;109234;37.0;19.5
84;2021-06-03;4115;2999;211775;112233;37.7;20.0
84;2021-06-04;3613;3021;215388;115254;38.4;20.5
84;2021-06-05;1781;1501;217169;116755;38.7;20.8
84;2021-06-06;984;208;218153;116963;38.9;20.8
84;2021-06-07;2451;2758;220604;119721;39.3;21.3
84;2021-06-08;3317;3055;223921;122776;39.9;21.9
84;2021-06-09;3033;2687;226954;125463;40.5;22.4
84;2021-06-10;3512;2794;230466;128257;41.1;22.9
84;2021-06-11;3032;3069;233498;131326;41.6;23.4
84;2021-06-12;1965;1308;235463;132634;42.0;23.6
84;2021-06-13;413;213;235876;132847;42.0;23.7
84;2021-06-14;1930;3153;237806;136000;42.4;24.2
84;2021-06-15;2573;3453;240379;139453;42.8;24.9
84;2021-06-16;2527;2962;242906;142415;43.3;25.4
84;2021-06-17;2992;3479;245898;145894;43.8;26.0
84;2021-06-18;2424;3553;248322;149447;44.3;26.6
84;2021-06-19;1287;1551;249609;150998;44.5;26.9
84;2021-06-20;546;354;250155;151352;44.6;27.0
84;2021-06-21;1569;3135;251724;154487;44.9;27.5
84;2021-06-22;2163;4010;253887;158497;45.3;28.3
84;2021-06-23;2117;3306;256004;161803;45.6;28.8
84;2021-06-24;2201;3483;258205;165286;46.0;29.5
84;2021-06-25;1836;3889;260041;169175;46.4;30.2
84;2021-06-26;1133;1817;261174;170992;46.6;30.5
84;2021-06-27;297;345;261471;171337;46.6;30.5
84;2021-06-28;1207;3224;262678;174561;46.8;31.1
84;2021-06-29;1477;4051;264155;178612;47.1;31.8
84;2021-06-30;1716;3969;265871;182581;47.4;32.5
84;2021-07-01;1819;3956;267690;186537;47.7;33.3
84;2021-07-02;1764;3898;269454;190435;48.0;33.9
84;2021-07-03;1102;2030;270556;192465;48.2;34.3
84;2021-07-04;395;417;270951;192882;48.3;34.4
84;2021-07-05;1550;3540;272501;196422;48.6;35.0
84;2021-07-06;1638;4164;274139;200586;48.9;35.8
84;2021-07-07;1676;3102;275815;203688;49.2;36.3
84;2021-07-08;2158;3742;277973;207430;49.5;37.0
84;2021-07-09;1874;3970;279847;211400;49.9;37.7
84;2021-07-10;1253;2162;281100;213562;50.1;38.1
84;2021-07-11;354;300;281454;213862;50.2;38.1
84;2021-07-12;1409;3836;282863;217698;50.4;38.8
84;2021-07-13;2334;5008;285197;222706;50.8;39.7
84;2021-07-14;1885;1249;287082;223955;51.2;39.9
84;2021-07-15;2708;4557;289790;228512;51.7;40.7
84;2021-07-16;2778;4603;292568;233115;52.2;41.6
84;2021-07-17;1588;2449;294156;235564;52.4;42.0
84;2021-07-18;1017;552;295173;236116;52.6;42.1
84;2021-07-19;2415;3743;297588;239859;53.0;42.8
84;2021-07-20;2954;4168;300542;244027;53.6;43.5
84;2021-07-21;3187;3653;303729;247680;54.1;44.1
84;2021-07-22;3778;3791;307507;251471;54.8;44.8
84;2021-07-23;3520;3680;311027;255151;55.4;45.5
84;2021-07-24;1469;2248;312496;257399;55.7;45.9
84;2021-07-25;1033;513;313529;257912;55.9;46.0
84;2021-07-26;2725;3038;316254;260950;56.4;46.5
84;2021-07-27;3443;3568;319697;264518;57.0;47.2
84;2021-07-28;3866;3307;323563;267825;57.7;47.7
84;2021-07-29;4224;3158;327787;270983;58.4;48.3
84;2021-07-30;4027;3326;331814;274309;59.1;48.9
84;2021-07-31;2000;1694;333814;276003;59.5;49.2
84;2021-08-01;819;437;334633;276440;59.6;49.3
84;2021-08-02;2992;2695;337625;279135;60.2;49.8
84;2021-08-03;4108;2795;341733;281930;60.9;50.3
84;2021-08-04;3918;2611;345651;284541;61.6;50.7
84;2021-08-05;3888;2586;349539;287127;62.3;51.2
84;2021-08-06;3695;2868;353234;289995;63.0;51.7
84;2021-08-07;2078;1744;355312;291739;63.3;52.0
84;2021-08-08;386;735;355698;292474;63.4;52.1
84;2021-08-09;2939;2603;358637;295077;63.9;52.6
84;2021-08-10;3745;2956;362382;298033;64.6;53.1
84;2021-08-11;3269;2676;365651;300709;65.2;53.6
84;2021-08-12;3173;2978;368824;303687;65.7;54.1
84;2021-08-13;2924;2702;371748;306389;66.3;54.6
84;2021-08-14;1735;1746;373483;308135;66.6;54.9
84;2021-08-15;314;227;373797;308362;66.6;55.0
84;2021-08-16;2451;3086;376248;311448;67.1;55.5
84;2021-08-17;2736;3260;378984;314708;67.6;56.1
84;2021-08-18;2418;2800;381402;317508;68.0;56.6
84;2021-08-19;2278;3120;383680;320628;68.4;57.2
84;2021-08-20;2199;3306;385879;323934;68.8;57.7
84;2021-08-21;1228;1886;387107;325820;69.0;58.1
84;2021-08-22;167;738;387274;326558;69.0;58.2
84;2021-08-23;1776;3297;389050;329855;69.3;58.8
84;2021-08-24;1924;3469;390974;333324;69.7;59.4
84;2021-08-25;1844;3352;392818;336676;70.0;60.0
84;2021-08-26;1639;3627;394457;340303;70.3;60.7
84;2021-08-27;1630;3813;396087;344116;70.6;61.3
84;2021-08-28;921;2181;397008;346297;70.8;61.7
84;2021-08-29;174;607;397182;346904;70.8;61.8
84;2021-08-30;1390;3278;398572;350182;71.0;62.4
84;2021-08-31;1365;4153;399937;354335;71.3;63.2
84;2021-09-01;1250;3595;401187;357930;71.5;63.8
84;2021-09-02;1210;3208;402397;361138;71.7;64.4
84;2021-09-03;1277;3550;403674;364688;72.0;65.0
84;2021-09-04;767;2178;404441;366866;72.1;65.4
84;2021-09-05;124;475;404565;367341;72.1;65.5
84;2021-09-06;814;2476;405379;369817;72.3;65.9
84;2021-09-07;1027;2752;406406;372569;72.4;66.4
84;2021-09-08;910;2914;407316;375483;72.6;66.9
84;2021-09-09;887;2437;408203;377920;72.8;67.4
84;2021-09-10;926;2909;409129;380829;72.9;67.9
84;2021-09-11;575;1915;409704;382744;73.0;68.2
84;2021-09-12;116;302;409820;383046;73.1;68.3
84;2021-09-13;697;1935;410517;384981;73.2;68.6
84;2021-09-14;812;2041;411329;387022;73.3;69.0
84;2021-09-15;820;1932;412149;388954;73.5;69.3
84;2021-09-16;600;1334;412749;390288;73.6;69.6
84;2021-09-17;612;1613;413361;391901;73.7;69.9
84;2021-09-18;516;1497;413877;393398;73.8;70.1
84;2021-09-19;46;177;413923;393575;73.8;70.2
84;2021-09-20;326;891;414249;394466;73.8;70.3
84;2021-09-21;363;1112;414612;395578;73.9;70.5
84;2021-09-22;419;1589;415031;397167;74.0;70.8
84;2021-09-23;396;1115;415427;398282;74.1;71.0
84;2021-09-24;396;1250;415823;399532;74.1;71.2
84;2021-09-25;323;1246;416146;400778;74.2;71.4
84;2021-09-26;53;142;416199;400920;74.2;71.5
84;2021-09-27;314;788;416513;401708;74.2;71.6
84;2021-09-28;310;756;416823;402464;74.3;71.7
84;2021-09-29;350;1220;417173;403684;74.4;72.0
84;2021-09-30;371;917;417544;404601;74.4;72.1
84;2021-10-01;438;852;417982;405453;74.5;72.3
84;2021-10-02;249;751;418231;406204;74.6;72.4
84;2021-10-03;36;93;418267;406297;74.6;72.4
85;2020-12-27;1;0;1;0;0.0;0.0
85;2020-12-28;0;0;1;0;0.0;0.0
85;2020-12-29;0;0;1;0;0.0;0.0
85;2020-12-30;0;0;1;0;0.0;0.0
85;2020-12-31;0;0;1;0;0.0;0.0
85;2021-01-01;0;0;1;0;0.0;0.0
85;2021-01-02;0;0;1;0;0.0;0.0
85;2021-01-03;1;0;2;0;0.0;0.0
85;2021-01-04;26;0;28;0;0.0;0.0
85;2021-01-05;62;0;90;0;0.0;0.0
85;2021-01-06;107;1;197;1;0.0;0.0
85;2021-01-07;203;0;400;1;0.1;0.0
85;2021-01-08;293;2;693;3;0.1;0.0
85;2021-01-09;288;1;981;4;0.1;0.0
85;2021-01-10;59;0;1040;4;0.2;0.0
85;2021-01-11;453;0;1493;4;0.2;0.0
85;2021-01-12;584;1;2077;5;0.3;0.0
85;2021-01-13;545;2;2622;7;0.4;0.0
85;2021-01-14;684;4;3306;11;0.5;0.0
85;2021-01-15;439;3;3745;14;0.5;0.0
85;2021-01-16;264;2;4009;16;0.6;0.0
85;2021-01-17;37;0;4046;16;0.6;0.0
85;2021-01-18;999;1;5045;17;0.7;0.0
85;2021-01-19;1429;10;6474;27;0.9;0.0
85;2021-01-20;1891;2;8365;29;1.2;0.0
85;2021-01-21;3221;7;11586;36;1.7;0.0
85;2021-01-22;1700;16;13286;52;1.9;0.0
85;2021-01-23;466;1;13752;53;2.0;0.0
85;2021-01-24;50;0;13802;53;2.0;0.0
85;2021-01-25;577;0;14379;53;2.1;0.0
85;2021-01-26;877;33;15256;86;2.2;0.0
85;2021-01-27;1809;32;17065;118;2.5;0.0
85;2021-01-28;1636;39;18701;157;2.7;0.0
85;2021-01-29;875;63;19576;220;2.9;0.0
85;2021-01-30;149;5;19725;225;2.9;0.0
85;2021-01-31;2;40;19727;265;2.9;0.0
85;2021-02-01;484;98;20211;363;3.0;0.1
85;2021-02-02;535;170;20746;533;3.0;0.1
85;2021-02-03;415;248;21161;781;3.1;0.1
85;2021-02-04;623;252;21784;1033;3.2;0.2
85;2021-02-05;624;253;22408;1286;3.3;0.2
85;2021-02-06;157;211;22565;1497;3.3;0.2
85;2021-02-07;1;0;22566;1497;3.3;0.2
85;2021-02-08;388;497;22954;1994;3.4;0.3
85;2021-02-09;663;981;23617;2975;3.5;0.4
85;2021-02-10;583;1035;24200;4010;3.5;0.6
85;2021-02-11;1524;2784;25724;6794;3.8;1.0
85;2021-02-12;1015;1162;26739;7956;3.9;1.2
85;2021-02-13;251;432;26990;8388;4.0;1.2
85;2021-02-14;2;84;26992;8472;4.0;1.2
85;2021-02-15;336;646;27328;9118;4.0;1.3
85;2021-02-16;569;957;27897;10075;4.1;1.5
85;2021-02-17;784;1451;28681;11526;4.2;1.7
85;2021-02-18;1277;1719;29958;13245;4.4;1.9
85;2021-02-19;956;1087;30914;14332;4.5;2.1
85;2021-02-20;174;186;31088;14518;4.6;2.1
85;2021-02-21;1;11;31089;14529;4.6;2.1
85;2021-02-22;815;745;31904;15274;4.7;2.2
85;2021-02-23;826;373;32730;15647;4.8;2.3
85;2021-02-24;757;237;33487;15884;4.9;2.3
85;2021-02-25;1336;313;34823;16197;5.1;2.4
85;2021-02-26;1229;248;36052;16445;5.3;2.4
85;2021-02-27;402;77;36454;16522;5.3;2.4
85;2021-02-28;7;1;36461;16523;5.3;2.4
85;2021-03-01;766;350;37227;16873;5.4;2.5
85;2021-03-02;1099;669;38326;17542;5.6;2.6
85;2021-03-03;844;438;39170;17980;5.7;2.6
85;2021-03-04;1577;1082;40747;19062;6.0;2.8
85;2021-03-05;1741;742;42488;19804;6.2;2.9
85;2021-03-06;1227;116;43715;19920;6.4;2.9
85;2021-03-07;333;28;44048;19948;6.4;2.9
85;2021-03-08;1741;405;45789;20353;6.7;3.0
85;2021-03-09;2239;516;48028;20869;7.0;3.1
85;2021-03-10;1862;617;49890;21486;7.3;3.1
85;2021-03-11;3118;1030;53008;22516;7.8;3.3
85;2021-03-12;2730;817;55738;23333;8.2;3.4
85;2021-03-13;1372;155;57110;23488;8.4;3.4
85;2021-03-14;182;3;57292;23491;8.4;3.4
85;2021-03-15;1919;507;59211;23998;8.7;3.5
85;2021-03-16;1631;513;60842;24511;8.9;3.6
85;2021-03-17;980;524;61822;25035;9.0;3.7
85;2021-03-18;1904;449;63726;25484;9.3;3.7
85;2021-03-19;2199;366;65925;25850;9.6;3.8
85;2021-03-20;1069;178;66994;26028;9.8;3.8
85;2021-03-21;272;5;67266;26033;9.8;3.8
85;2021-03-22;1764;555;69030;26588;10.1;3.9
85;2021-03-23;2420;729;71450;27317;10.5;4.0
85;2021-03-24;2206;520;73656;27837;10.8;4.1
85;2021-03-25;3649;596;77305;28433;11.3;4.2
85;2021-03-26;3357;645;80662;29078;11.8;4.3
85;2021-03-27;1729;124;82391;29202;12.1;4.3
85;2021-03-28;540;4;82931;29206;12.1;4.3
85;2021-03-29;2414;758;85345;29964;12.5;4.4
85;2021-03-30;2866;1022;88211;30986;12.9;4.5
85;2021-03-31;2200;676;90411;31662;13.2;4.6
85;2021-04-01;3880;913;94291;32575;13.8;4.8
85;2021-04-02;2710;1104;97001;33679;14.2;4.9
85;2021-04-03;1411;322;98412;34001;14.4;5.0
85;2021-04-04;324;29;98736;34030;14.5;5.0
85;2021-04-05;104;175;98840;34205;14.5;5.0
85;2021-04-06;2196;1592;101036;35797;14.8;5.2
85;2021-04-07;3094;1189;104130;36986;15.2;5.4
85;2021-04-08;4544;1602;108674;38588;15.9;5.6
85;2021-04-09;4604;1225;113278;39813;16.6;5.8
85;2021-04-10;1866;401;115144;40214;16.9;5.9
85;2021-04-11;27;10;115171;40224;16.9;5.9
85;2021-04-12;4283;1490;119454;41714;17.5;6.1
85;2021-04-13;4836;1868;124290;43582;18.2;6.4
85;2021-04-14;3961;1011;128251;44593;18.8;6.5
85;2021-04-15;5517;1740;133768;46333;19.6;6.8
85;2021-04-16;5240;1541;139008;47874;20.3;7.0
85;2021-04-17;1382;436;140390;48310;20.5;7.1
85;2021-04-18;351;12;140741;48322;20.6;7.1
85;2021-04-19;3368;1698;144109;50020;21.1;7.3
85;2021-04-20;3694;1928;147803;51948;21.6;7.6
85;2021-04-21;2693;1693;150496;53641;22.0;7.9
85;2021-04-22;3805;2231;154301;55872;22.6;8.2
85;2021-04-23;3902;2090;158203;57962;23.2;8.5
85;2021-04-24;1663;1532;159866;59494;23.4;8.7
85;2021-04-25;981;565;160847;60059;23.5;8.8
85;2021-04-26;3589;2353;164436;62412;24.1;9.1
85;2021-04-27;4393;2152;168829;64564;24.7;9.5
85;2021-04-28;5747;1257;174576;65821;25.6;9.6
85;2021-04-29;5635;1996;180211;67817;26.4;9.9
85;2021-04-30;5574;1663;185785;69480;27.2;10.2
85;2021-05-01;1736;638;187521;70118;27.4;10.3
85;2021-05-02;873;471;188394;70589;27.6;10.3
85;2021-05-03;3494;2387;191888;72976;28.1;10.7
85;2021-05-04;3487;3082;195375;76058;28.6;11.1
85;2021-05-05;4532;2166;199907;78224;29.3;11.4
85;2021-05-06;4922;2598;204829;80822;30.0;11.8
85;2021-05-07;3933;3850;208762;84672;30.6;12.4
85;2021-05-08;2246;232;211008;84904;30.9;12.4
85;2021-05-09;1507;183;212515;85087;31.1;12.5
85;2021-05-10;3209;4914;215724;90001;31.6;13.2
85;2021-05-11;4027;4964;219751;94965;32.2;13.9
85;2021-05-12;5019;3933;224770;98898;32.9;14.5
85;2021-05-13;5144;613;229914;99511;33.7;14.6
85;2021-05-14;4356;3166;234270;102677;34.3;15.0
85;2021-05-15;2325;771;236595;103448;34.6;15.1
85;2021-05-16;2212;162;238807;103610;35.0;15.2
85;2021-05-17;4145;3376;242952;106986;35.6;15.7
85;2021-05-18;5215;2853;248167;109839;36.3;16.1
85;2021-05-19;6493;1770;254660;111609;37.3;16.3
85;2021-05-20;6773;2175;261433;113784;38.3;16.7
85;2021-05-21;5497;2734;266930;116518;39.1;17.1
85;2021-05-22;2584;749;269514;117267;39.4;17.2
85;2021-05-23;1329;161;270843;117428;39.6;17.2
85;2021-05-24;4572;436;275415;117864;40.3;17.3
85;2021-05-25;4516;3564;279931;121428;41.0;17.8
85;2021-05-26;4945;2678;284876;124106;41.7;18.2
85;2021-05-27;4959;3694;289835;127800;42.4;18.7
85;2021-05-28;5251;4054;295086;131854;43.2;19.3
85;2021-05-29;3962;1530;299048;133384;43.8;19.5
85;2021-05-30;1291;126;300339;133510;44.0;19.5
85;2021-05-31;4689;3378;305028;136888;44.6;20.0
85;2021-06-01;5405;3397;310433;140285;45.4;20.5
85;2021-06-02;5554;2515;315987;142800;46.3;20.9
85;2021-06-03;5915;3231;321902;146031;47.1;21.4
85;2021-06-04;5837;3807;327739;149838;48.0;21.9
85;2021-06-05;2848;1934;330587;151772;48.4;22.2
85;2021-06-06;1511;804;332098;152576;48.6;22.3
85;2021-06-07;3236;4859;335334;157435;49.1;23.0
85;2021-06-08;4090;4523;339424;161958;49.7;23.7
85;2021-06-09;4844;3501;344268;165459;50.4;24.2
85;2021-06-10;5199;3698;349467;169157;51.2;24.8
85;2021-06-11;4506;4657;353973;173814;51.8;25.4
85;2021-06-12;1491;1795;355464;175609;52.0;25.7
85;2021-06-13;1219;672;356683;176281;52.2;25.8
85;2021-06-14;2682;5093;359365;181374;52.6;26.5
85;2021-06-15;3715;4928;363080;186302;53.1;27.3
85;2021-06-16;4083;3907;367163;190209;53.7;27.8
85;2021-06-17;3940;3902;371103;194111;54.3;28.4
85;2021-06-18;3625;5684;374728;199795;54.8;29.2
85;2021-06-19;1213;2029;375941;201824;55.0;29.5
85;2021-06-20;140;520;376081;202344;55.0;29.6
85;2021-06-21;2375;5810;378456;208154;55.4;30.5
85;2021-06-22;2849;5728;381305;213882;55.8;31.3
85;2021-06-23;3390;4499;384695;218381;56.3;32.0
85;2021-06-24;3642;4561;388337;222942;56.8;32.6
85;2021-06-25;2289;6180;390626;229122;57.2;33.5
85;2021-06-26;791;3757;391417;232879;57.3;34.1
85;2021-06-27;125;1369;391542;234248;57.3;34.3
85;2021-06-28;1186;6713;392728;240961;57.5;35.3
85;2021-06-29;1757;6870;394485;247831;57.7;36.3
85;2021-06-30;2212;6208;396697;254039;58.1;37.2
85;2021-07-01;2842;6056;399539;260095;58.5;38.1
85;2021-07-02;2268;7015;401807;267110;58.8;39.1
85;2021-07-03;618;3165;402425;270275;58.9;39.6
85;2021-07-04;145;1084;402570;271359;58.9;39.7
85;2021-07-05;1064;6649;403634;278008;59.1;40.7
85;2021-07-06;1582;6453;405216;284461;59.3;41.6
85;2021-07-07;1649;5859;406865;290320;59.6;42.5
85;2021-07-08;2164;5435;409029;295755;59.9;43.3
85;2021-07-09;1646;7094;410675;302849;60.1;44.3
85;2021-07-10;566;2835;411241;305684;60.2;44.7
85;2021-07-11;529;1287;411770;306971;60.3;44.9
85;2021-07-12;1408;7046;413178;314017;60.5;46.0
85;2021-07-13;2059;7383;415237;321400;60.8;47.0
85;2021-07-14;1451;2047;416688;323447;61.0;47.3
85;2021-07-15;2681;6937;419369;330384;61.4;48.4
85;2021-07-16;3432;6829;422801;337213;61.9;49.4
85;2021-07-17;1565;2148;424366;339361;62.1;49.7
85;2021-07-18;1150;1154;425516;340515;62.3;49.8
85;2021-07-19;3559;6221;429075;346736;62.8;50.8
85;2021-07-20;4300;6213;433375;352949;63.4;51.7
85;2021-07-21;3996;6192;437371;359141;64.0;52.6
85;2021-07-22;3908;6188;441279;365329;64.6;53.5
85;2021-07-23;4530;6703;445809;372032;65.3;54.5
85;2021-07-24;1045;2293;446854;374325;65.4;54.8
85;2021-07-25;491;303;447345;374628;65.5;54.8
85;2021-07-26;4514;5361;451859;379989;66.1;55.6
85;2021-07-27;5320;5396;457179;385385;66.9;56.4
85;2021-07-28;4963;4969;462142;390354;67.6;57.1
85;2021-07-29;5879;4730;468021;395084;68.5;57.8
85;2021-07-30;6028;4952;474049;400036;69.4;58.6
85;2021-07-31;1226;1576;475275;401612;69.6;58.8
85;2021-08-01;470;195;475745;401807;69.6;58.8
85;2021-08-02;4949;3950;480694;405757;70.4;59.4
85;2021-08-03;6523;3352;487217;409109;71.3;59.9
85;2021-08-04;6631;3421;493848;412530;72.3;60.4
85;2021-08-05;6198;3601;500046;416131;73.2;60.9
85;2021-08-06;5810;4513;505856;420644;74.0;61.6
85;2021-08-07;1505;1179;507361;421823;74.3;61.7
85;2021-08-08;331;232;507692;422055;74.3;61.8
85;2021-08-09;4155;3275;511847;425330;74.9;62.3
85;2021-08-10;4830;3419;516677;428749;75.6;62.8
85;2021-08-11;4672;4216;521349;432965;76.3;63.4
85;2021-08-12;4473;4298;525822;437263;77.0;64.0
85;2021-08-13;3898;3648;529720;440911;77.5;64.5
85;2021-08-14;1028;1088;530748;441999;77.7;64.7
85;2021-08-15;160;237;530908;442236;77.7;64.7
85;2021-08-16;2843;4773;533751;447009;78.1;65.4
85;2021-08-17;2977;4359;536728;451368;78.6;66.1
85;2021-08-18;3154;4107;539882;455475;79.0;66.7
85;2021-08-19;2730;4279;542612;459754;79.4;67.3
85;2021-08-20;2481;5229;545093;464983;79.8;68.1
85;2021-08-21;701;1398;545794;466381;79.9;68.3
85;2021-08-22;344;1019;546138;467400;79.9;68.4
85;2021-08-23;1874;5373;548012;472773;80.2;69.2
85;2021-08-24;1823;4873;549835;477646;80.5;69.9
85;2021-08-25;1648;4833;551483;482479;80.7;70.6
85;2021-08-26;1542;4765;553025;487244;80.9;71.3
85;2021-08-27;1702;5519;554727;492763;81.2;72.1
85;2021-08-28;573;1343;555300;494106;81.3;72.3
85;2021-08-29;128;989;555428;495095;81.3;72.5
85;2021-08-30;1121;4948;556549;500043;81.5;73.2
85;2021-08-31;1132;5439;557681;505482;81.6;74.0
85;2021-09-01;1138;5169;558819;510651;81.8;74.7
85;2021-09-02;992;4372;559811;515023;81.9;75.4
85;2021-09-03;1243;4537;561054;519560;82.1;76.0
85;2021-09-04;370;1385;561424;520945;82.2;76.3
85;2021-09-05;42;195;561466;521140;82.2;76.3
85;2021-09-06;851;3824;562317;524964;82.3;76.8
85;2021-09-07;842;3314;563159;528278;82.4;77.3
85;2021-09-08;869;3657;564028;531935;82.6;77.9
85;2021-09-09;651;2981;564679;534916;82.7;78.3
85;2021-09-10;793;3644;565472;538560;82.8;78.8
85;2021-09-11;243;1403;565715;539963;82.8;79.0
85;2021-09-12;17;58;565732;540021;82.8;79.0
85;2021-09-13;543;2609;566275;542630;82.9;79.4
85;2021-09-14;543;2375;566818;545005;83.0;79.8
85;2021-09-15;607;2529;567425;547534;83.1;80.1
85;2021-09-16;400;1362;567825;548896;83.1;80.3
85;2021-09-17;737;2387;568562;551283;83.2;80.7
85;2021-09-18;189;915;568751;552198;83.2;80.8
85;2021-09-19;5;22;568756;552220;83.3;80.8
85;2021-09-20;352;1355;569108;553575;83.3;81.0
85;2021-09-21;429;1068;569537;554643;83.4;81.2
85;2021-09-22;435;1903;569972;556546;83.4;81.5
85;2021-09-23;810;983;570782;557529;83.5;81.6
85;2021-09-24;591;1928;571373;559457;83.6;81.9
85;2021-09-25;153;879;571526;560336;83.7;82.0
85;2021-09-26;0;12;571526;560348;83.7;82.0
85;2021-09-27;364;929;571890;561277;83.7;82.2
85;2021-09-28;231;565;572121;561842;83.7;82.2
85;2021-09-29;396;1288;572517;563130;83.8;82.4
85;2021-09-30;366;798;572883;563928;83.9;82.5
85;2021-10-01;421;919;573304;564847;83.9;82.7
85;2021-10-02;178;506;573482;565353;83.9;82.8
85;2021-10-03;4;12;573486;565365;83.9;82.8
86;2020-12-27;0;0;0;0;0.0;0.0
86;2020-12-28;1;0;1;0;0.0;0.0
86;2020-12-29;1;0;2;0;0.0;0.0
86;2020-12-30;0;0;2;0;0.0;0.0
86;2020-12-31;0;0;2;0;0.0;0.0
86;2021-01-01;0;0;2;0;0.0;0.0
86;2021-01-02;1;0;3;0;0.0;0.0
86;2021-01-03;2;0;5;0;0.0;0.0
86;2021-01-04;0;0;5;0;0.0;0.0
86;2021-01-05;1;0;6;0;0.0;0.0
86;2021-01-06;178;0;184;0;0.0;0.0
86;2021-01-07;672;0;856;0;0.2;0.0
86;2021-01-08;609;2;1465;2;0.3;0.0
86;2021-01-09;0;0;1465;2;0.3;0.0
86;2021-01-10;173;0;1638;2;0.4;0.0
86;2021-01-11;305;0;1943;2;0.4;0.0
86;2021-01-12;460;0;2403;2;0.5;0.0
86;2021-01-13;337;0;2740;2;0.6;0.0
86;2021-01-14;552;1;3292;3;0.8;0.0
86;2021-01-15;544;0;3836;3;0.9;0.0
86;2021-01-16;2;0;3838;3;0.9;0.0
86;2021-01-17;0;0;3838;3;0.9;0.0
86;2021-01-18;564;0;4402;3;1.0;0.0
86;2021-01-19;1917;1;6319;4;1.4;0.0
86;2021-01-20;1464;10;7783;14;1.8;0.0
86;2021-01-21;1292;0;9075;14;2.1;0.0
86;2021-01-22;834;0;9909;14;2.3;0.0
86;2021-01-23;314;0;10223;14;2.3;0.0
86;2021-01-24;0;0;10223;14;2.3;0.0
86;2021-01-25;586;102;10809;116;2.5;0.0
86;2021-01-26;751;108;11560;224;2.6;0.1
86;2021-01-27;765;141;12325;365;2.8;0.1
86;2021-01-28;1055;381;13380;746;3.1;0.2
86;2021-01-29;880;195;14260;941;3.3;0.2
86;2021-01-30;276;94;14536;1035;3.3;0.2
86;2021-01-31;57;157;14593;1192;3.3;0.3
86;2021-02-01;434;193;15027;1385;3.4;0.3
86;2021-02-02;573;368;15600;1753;3.6;0.4
86;2021-02-03;525;213;16125;1966;3.7;0.4
86;2021-02-04;479;349;16604;2315;3.8;0.5
86;2021-02-05;437;664;17041;2979;3.9;0.7
86;2021-02-06;148;171;17189;3150;3.9;0.7
86;2021-02-07;120;8;17309;3158;4.0;0.7
86;2021-02-08;362;246;17671;3404;4.0;0.8
86;2021-02-09;754;957;18425;4361;4.2;1.0
86;2021-02-10;972;819;19397;5180;4.4;1.2
86;2021-02-11;1009;871;20406;6051;4.7;1.4
86;2021-02-12;746;308;21152;6359;4.8;1.5
86;2021-02-13;193;69;21345;6428;4.9;1.5
86;2021-02-14;1;34;21346;6462;4.9;1.5
86;2021-02-15;243;346;21589;6808;4.9;1.6
86;2021-02-16;384;629;21973;7437;5.0;1.7
86;2021-02-17;453;774;22426;8211;5.1;1.9
86;2021-02-18;422;761;22848;8972;5.2;2.1
86;2021-02-19;602;509;23450;9481;5.4;2.2
86;2021-02-20;115;132;23565;9613;5.4;2.2
86;2021-02-21;1;0;23566;9613;5.4;2.2
86;2021-02-22;241;333;23807;9946;5.4;2.3
86;2021-02-23;369;497;24176;10443;5.5;2.4
86;2021-02-24;409;487;24585;10930;5.6;2.5
86;2021-02-25;903;569;25488;11499;5.8;2.6
86;2021-02-26;1029;466;26517;11965;6.1;2.7
86;2021-02-27;460;126;26977;12091;6.2;2.8
86;2021-02-28;3;2;26980;12093;6.2;2.8
86;2021-03-01;232;450;27212;12543;6.2;2.9
86;2021-03-02;1142;742;28354;13285;6.5;3.0
86;2021-03-03;794;552;29148;13837;6.7;3.2
86;2021-03-04;1496;588;30644;14425;7.0;3.3
86;2021-03-05;1577;291;32221;14716;7.4;3.4
86;2021-03-06;995;150;33216;14866;7.6;3.4
86;2021-03-07;371;29;33587;14895;7.7;3.4
86;2021-03-08;473;493;34060;15388;7.8;3.5
86;2021-03-09;1368;485;35428;15873;8.1;3.6
86;2021-03-10;949;571;36377;16444;8.3;3.8
86;2021-03-11;1798;450;38175;16894;8.7;3.9
86;2021-03-12;2208;414;40383;17308;9.2;4.0
86;2021-03-13;1444;96;41827;17404;9.6;4.0
86;2021-03-14;133;16;41960;17420;9.6;4.0
86;2021-03-15;784;151;42744;17571;9.8;4.0
86;2021-03-16;847;194;43591;17765;10.0;4.1
86;2021-03-17;786;200;44377;17965;10.1;4.1
86;2021-03-18;1005;101;45382;18066;10.4;4.1
86;2021-03-19;2146;309;47528;18375;10.9;4.2
86;2021-03-20;592;130;48120;18505;11.0;4.2
86;2021-03-21;10;0;48130;18505;11.0;4.2
86;2021-03-22;852;273;48982;18778;11.2;4.3
86;2021-03-23;2016;324;50998;19102;11.7;4.4
86;2021-03-24;1557;287;52555;19389;12.0;4.4
86;2021-03-25;2489;343;55044;19732;12.6;4.5
86;2021-03-26;3044;362;58088;20094;13.3;4.6
86;2021-03-27;733;142;58821;20236;13.4;4.6
86;2021-03-28;5;124;58826;20360;13.4;4.7
86;2021-03-29;1260;384;60086;20744;13.7;4.7
86;2021-03-30;2404;820;62490;21564;14.3;4.9
86;2021-03-31;1512;624;64002;22188;14.6;5.1
86;2021-04-01;2246;939;66248;23127;15.1;5.3
86;2021-04-02;1902;552;68150;23679;15.6;5.4
86;2021-04-03;826;325;68976;24004;15.8;5.5
86;2021-04-04;83;109;69059;24113;15.8;5.5
86;2021-04-05;314;5;69373;24118;15.9;5.5
86;2021-04-06;1532;960;70905;25078;16.2;5.7
86;2021-04-07;1633;620;72538;25698;16.6;5.9
86;2021-04-08;2569;761;75107;26459;17.2;6.0
86;2021-04-09;3250;650;78357;27109;17.9;6.2
86;2021-04-10;1662;192;80019;27301;18.3;6.2
86;2021-04-11;442;11;80461;27312;18.4;6.2
86;2021-04-12;820;762;81281;28074;18.6;6.4
86;2021-04-13;2454;938;83735;29012;19.1;6.6
86;2021-04-14;1870;875;85605;29887;19.6;6.8
86;2021-04-15;2276;726;87881;30613;20.1;7.0
86;2021-04-16;2471;1227;90352;31840;20.7;7.3
86;2021-04-17;1040;264;91392;32104;20.9;7.3
86;2021-04-18;119;4;91511;32108;20.9;7.3
86;2021-04-19;745;797;92256;32905;21.1;7.5
86;2021-04-20;2301;1503;94557;34408;21.6;7.9
86;2021-04-21;2108;1126;96665;35534;22.1;8.1
86;2021-04-22;2329;1438;98994;36972;22.6;8.5
86;2021-04-23;2392;1577;101386;38549;23.2;8.8
86;2021-04-24;1299;511;102685;39060;23.5;8.9
86;2021-04-25;825;27;103510;39087;23.7;8.9
86;2021-04-26;2080;889;105590;39976;24.1;9.1
86;2021-04-27;3155;1661;108745;41637;24.9;9.5
86;2021-04-28;3002;1508;111747;43145;25.5;9.9
86;2021-04-29;3558;1829;115305;44974;26.4;10.3
86;2021-04-30;2969;1478;118274;46452;27.0;10.6
86;2021-05-01;1580;197;119854;46649;27.4;10.7
86;2021-05-02;1279;45;121133;46694;27.7;10.7
86;2021-05-03;2563;1006;123696;47700;28.3;10.9
86;2021-05-04;3508;1894;127204;49594;29.1;11.3
86;2021-05-05;3989;1484;131193;51078;30.0;11.7
86;2021-05-06;4289;1650;135482;52728;31.0;12.1
86;2021-05-07;4043;1824;139525;54552;31.9;12.5
86;2021-05-08;1976;396;141501;54948;32.4;12.6
86;2021-05-09;1641;203;143142;55151;32.7;12.6
86;2021-05-10;1958;1173;145100;56324;33.2;12.9
86;2021-05-11;3603;2681;148703;59005;34.0;13.5
86;2021-05-12;2252;1649;150955;60654;34.5;13.9
86;2021-05-13;1687;299;152642;60953;34.9;13.9
86;2021-05-14;2097;788;154739;61741;35.4;14.1
86;2021-05-15;1466;499;156205;62240;35.7;14.2
86;2021-05-16;778;164;156983;62404;35.9;14.3
86;2021-05-17;3218;1056;160201;63460;36.6;14.5
86;2021-05-18;4306;1662;164507;65122;37.6;14.9
86;2021-05-19;3587;1433;168094;66555;38.4;15.2
86;2021-05-20;4371;1618;172465;68173;39.4;15.6
86;2021-05-21;3438;1771;175903;69944;40.2;16.0
86;2021-05-22;2076;664;177979;70608;40.7;16.1
86;2021-05-23;1438;183;179417;70791;41.0;16.2
86;2021-05-24;1845;204;181262;70995;41.4;16.2
86;2021-05-25;2851;1640;184113;72635;42.1;16.6
86;2021-05-26;2725;1529;186838;74164;42.7;17.0
86;2021-05-27;3546;1848;190384;76012;43.5;17.4
86;2021-05-28;2164;2532;192548;78544;44.0;18.0
86;2021-05-29;1527;1286;194075;79830;44.4;18.3
86;2021-05-30;934;132;195009;79962;44.6;18.3
86;2021-05-31;1922;1818;196931;81780;45.0;18.7
86;2021-06-01;2665;2579;199596;84359;45.6;19.3
86;2021-06-02;2306;2659;201902;87018;46.2;19.9
86;2021-06-03;3337;2407;205239;89425;46.9;20.4
86;2021-06-04;2237;2857;207476;92282;47.4;21.1
86;2021-06-05;1502;1575;208978;93857;47.8;21.5
86;2021-06-06;820;900;209798;94757;48.0;21.7
86;2021-06-07;1120;2465;210918;97222;48.2;22.2
86;2021-06-08;1990;3695;212908;100917;48.7;23.1
86;2021-06-09;1901;3314;214809;104231;49.1;23.8
86;2021-06-10;2349;3240;217158;107471;49.6;24.6
86;2021-06-11;1517;2783;218675;110254;50.0;25.2
86;2021-06-12;746;2242;219421;112496;50.2;25.7
86;2021-06-13;214;1477;219635;113973;50.2;26.1
86;2021-06-14;1158;2901;220793;116874;50.5;26.7
86;2021-06-15;1690;4258;222483;121132;50.9;27.7
86;2021-06-16;1808;3135;224291;124267;51.3;28.4
86;2021-06-17;1777;4445;226068;128712;51.7;29.4
86;2021-06-18;1882;4585;227950;133297;52.1;30.5
86;2021-06-19;636;2097;228586;135394;52.3;31.0
86;2021-06-20;172;1319;228758;136713;52.3;31.3
86;2021-06-21;1105;2234;229863;138947;52.6;31.8
86;2021-06-22;1298;3458;231161;142405;52.8;32.6
86;2021-06-23;1364;2399;232525;144804;53.2;33.1
86;2021-06-24;1590;2725;234115;147529;53.5;33.7
86;2021-06-25;1192;3543;235307;151072;53.8;34.5
86;2021-06-26;391;2650;235698;153722;53.9;35.1
86;2021-06-27;138;1633;235836;155355;53.9;35.5
86;2021-06-28;270;3339;236106;158694;54.0;36.3
86;2021-06-29;858;4602;236964;163296;54.2;37.3
86;2021-06-30;1051;2974;238015;166270;54.4;38.0
86;2021-07-01;1549;3003;239564;169273;54.8;38.7
86;2021-07-02;1111;3636;240675;172909;55.0;39.5
86;2021-07-03;516;2393;241191;175302;55.1;40.1
86;2021-07-04;115;1346;241306;176648;55.2;40.4
86;2021-07-05;472;2832;241778;179480;55.3;41.0
86;2021-07-06;988;4108;242766;183588;55.5;42.0
86;2021-07-07;1260;2627;244026;186215;55.8;42.6
86;2021-07-08;1618;3149;245644;189364;56.2;43.3
86;2021-07-09;1746;3080;247390;192444;56.6;44.0
86;2021-07-10;1304;1954;248694;194398;56.9;44.4
86;2021-07-11;482;839;249176;195237;57.0;44.6
86;2021-07-12;848;2400;250024;197637;57.2;45.2
86;2021-07-13;1780;3367;251804;201004;57.6;46.0
86;2021-07-14;785;1232;252589;202236;57.7;46.2
86;2021-07-15;1882;3289;254471;205525;58.2;47.0
86;2021-07-16;1671;2660;256142;208185;58.6;47.6
86;2021-07-17;1352;1601;257494;209786;58.9;48.0
86;2021-07-18;381;908;257875;210694;59.0;48.2
86;2021-07-19;1377;1887;259252;212581;59.3;48.6
86;2021-07-20;2353;2733;261605;215314;59.8;49.2
86;2021-07-21;2305;2162;263910;217476;60.3;49.7
86;2021-07-22;2902;2799;266812;220275;61.0;50.4
86;2021-07-23;2465;2163;269277;222438;61.6;50.9
86;2021-07-24;1546;1225;270823;223663;61.9;51.1
86;2021-07-25;718;322;271541;223985;62.1;51.2
86;2021-07-26;1588;2103;273129;226088;62.4;51.7
86;2021-07-27;3558;2755;276687;228843;63.3;52.3
86;2021-07-28;3284;2140;279971;230983;64.0;52.8
86;2021-07-29;3266;2544;283237;233527;64.8;53.4
86;2021-07-30;2247;2370;285484;235897;65.3;53.9
86;2021-07-31;1429;1059;286913;236956;65.6;54.2
86;2021-08-01;651;338;287564;237294;65.7;54.3
86;2021-08-02;1944;1679;289508;238973;66.2;54.6
86;2021-08-03;3290;1991;292798;240964;66.9;55.1
86;2021-08-04;2739;1786;295537;242750;67.6;55.5
86;2021-08-05;3572;2055;299109;244805;68.4;56.0
86;2021-08-06;2420;1761;301529;246566;68.9;56.4
86;2021-08-07;1576;997;303105;247563;69.3;56.6
86;2021-08-08;958;553;304063;248116;69.5;56.7
86;2021-08-09;1885;1305;305948;249421;69.9;57.0
86;2021-08-10;2683;1779;308631;251200;70.6;57.4
86;2021-08-11;2366;1437;310997;252637;71.1;57.8
86;2021-08-12;2485;1832;313482;254469;71.7;58.2
86;2021-08-13;1838;1487;315320;255956;72.1;58.5
86;2021-08-14;1331;1153;316651;257109;72.4;58.8
86;2021-08-15;562;623;317213;257732;72.5;58.9
86;2021-08-16;1142;1788;318355;259520;72.8;59.3
86;2021-08-17;1559;2215;319914;261735;73.1;59.8
86;2021-08-18;1266;1861;321180;263596;73.4;60.3
86;2021-08-19;1501;2634;322681;266230;73.8;60.9
86;2021-08-20;1257;2609;323938;268839;74.1;61.5
86;2021-08-21;888;2008;324826;270847;74.3;61.9
86;2021-08-22;350;721;325176;271568;74.3;62.1
86;2021-08-23;724;1824;325900;273392;74.5;62.5
86;2021-08-24;1081;2752;326981;276144;74.8;63.1
86;2021-08-25;934;2064;327915;278208;75.0;63.6
86;2021-08-26;919;2813;328834;281021;75.2;64.2
86;2021-08-27;862;2174;329696;283195;75.4;64.7
86;2021-08-28;555;1775;330251;284970;75.5;65.2
86;2021-08-29;114;828;330365;285798;75.5;65.3
86;2021-08-30;686;2123;331051;287921;75.7;65.8
86;2021-08-31;961;3204;332012;291125;75.9;66.6
86;2021-09-01;570;2750;332582;293875;76.0;67.2
86;2021-09-02;753;2830;333335;296705;76.2;67.8
86;2021-09-03;758;2403;334093;299108;76.4;68.4
86;2021-09-04;366;2219;334459;301327;76.5;68.9
86;2021-09-05;27;918;334486;302245;76.5;69.1
86;2021-09-06;357;1753;334843;303998;76.6;69.5
86;2021-09-07;508;2207;335351;306205;76.7;70.0
86;2021-09-08;561;2400;335912;308605;76.8;70.6
86;2021-09-09;577;2028;336489;310633;76.9;71.0
86;2021-09-10;521;2135;337010;312768;77.0;71.5
86;2021-09-11;356;1893;337366;314661;77.1;71.9
86;2021-09-12;102;797;337468;315458;77.2;72.1
86;2021-09-13;320;1433;337788;316891;77.2;72.4
86;2021-09-14;400;2011;338188;318902;77.3;72.9
86;2021-09-15;472;1555;338660;320457;77.4;73.3
86;2021-09-16;437;1011;339097;321468;77.5;73.5
86;2021-09-17;488;1062;339585;322530;77.6;73.7
86;2021-09-18;294;1271;339879;323801;77.7;74.0
86;2021-09-19;85;415;339964;324216;77.7;74.1
86;2021-09-20;223;641;340187;324857;77.8;74.3
86;2021-09-21;266;825;340453;325682;77.8;74.5
86;2021-09-22;336;1184;340789;326866;77.9;74.7
86;2021-09-23;353;580;341142;327446;78.0;74.9
86;2021-09-24;308;840;341450;328286;78.1;75.1
86;2021-09-25;289;1063;341739;329349;78.1;75.3
86;2021-09-26;45;166;341784;329515;78.1;75.3
86;2021-09-27;159;359;341943;329874;78.2;75.4
86;2021-09-28;239;368;342182;330242;78.2;75.5
86;2021-09-29;230;686;342412;330928;78.3;75.7
86;2021-09-30;254;496;342666;331424;78.3;75.8
86;2021-10-01;253;523;342919;331947;78.4;75.9
86;2021-10-02;274;575;343193;332522;78.5;76.0
86;2021-10-03;19;73;343212;332595;78.5;76.0
87;2020-12-27;0;0;0;0;0.0;0.0
87;2020-12-28;3;0;3;0;0.0;0.0
87;2020-12-29;0;0;3;0;0.0;0.0
87;2020-12-30;0;0;3;0;0.0;0.0
87;2020-12-31;0;0;3;0;0.0;0.0
87;2021-01-01;0;0;3;0;0.0;0.0
87;2021-01-02;0;0;3;0;0.0;0.0
87;2021-01-03;0;0;3;0;0.0;0.0
87;2021-01-04;2;0;5;0;0.0;0.0
87;2021-01-05;1;0;6;0;0.0;0.0
87;2021-01-06;10;0;16;0;0.0;0.0
87;2021-01-07;301;0;317;0;0.1;0.0
87;2021-01-08;407;0;724;0;0.2;0.0
87;2021-01-09;65;0;789;0;0.2;0.0
87;2021-01-10;35;0;824;0;0.2;0.0
87;2021-01-11;424;0;1248;0;0.3;0.0
87;2021-01-12;653;0;1901;0;0.5;0.0
87;2021-01-13;660;2;2561;2;0.7;0.0
87;2021-01-14;517;10;3078;12;0.8;0.0
87;2021-01-15;534;3;3612;15;1.0;0.0
87;2021-01-16;204;1;3816;16;1.0;0.0
87;2021-01-17;1;0;3817;16;1.0;0.0
87;2021-01-18;645;5;4462;21;1.2;0.0
87;2021-01-19;657;1;5119;22;1.4;0.0
87;2021-01-20;674;3;5793;25;1.6;0.0
87;2021-01-21;717;0;6510;25;1.8;0.0
87;2021-01-22;758;4;7268;29;2.0;0.0
87;2021-01-23;287;0;7555;29;2.0;0.0
87;2021-01-24;1;0;7556;29;2.0;0.0
87;2021-01-25;620;10;8176;39;2.2;0.0
87;2021-01-26;570;47;8746;86;2.4;0.0
87;2021-01-27;572;36;9318;122;2.5;0.0
87;2021-01-28;856;91;10174;213;2.7;0.1
87;2021-01-29;741;239;10915;452;2.9;0.1
87;2021-01-30;325;66;11240;518;3.0;0.1
87;2021-01-31;34;71;11274;589;3.0;0.2
87;2021-02-01;413;280;11687;869;3.2;0.2
87;2021-02-02;452;407;12139;1276;3.3;0.3
87;2021-02-03;540;350;12679;1626;3.4;0.4
87;2021-02-04;613;528;13292;2154;3.6;0.6
87;2021-02-05;344;352;13636;2506;3.7;0.7
87;2021-02-06;55;109;13691;2615;3.7;0.7
87;2021-02-07;20;0;13711;2615;3.7;0.7
87;2021-02-08;246;369;13957;2984;3.8;0.8
87;2021-02-09;219;439;14176;3423;3.8;0.9
87;2021-02-10;262;462;14438;3885;3.9;1.0
87;2021-02-11;286;408;14724;4293;4.0;1.2
87;2021-02-12;287;402;15011;4695;4.0;1.3
87;2021-02-13;25;135;15036;4830;4.1;1.3
87;2021-02-14;0;2;15036;4832;4.1;1.3
87;2021-02-15;237;300;15273;5132;4.1;1.4
87;2021-02-16;332;235;15605;5367;4.2;1.4
87;2021-02-17;329;296;15934;5663;4.3;1.5
87;2021-02-18;478;537;16412;6200;4.4;1.7
87;2021-02-19;405;390;16817;6590;4.5;1.8
87;2021-02-20;124;143;16941;6733;4.6;1.8
87;2021-02-21;2;9;16943;6742;4.6;1.8
87;2021-02-22;440;444;17383;7186;4.7;1.9
87;2021-02-23;557;492;17940;7678;4.8;2.1
87;2021-02-24;451;465;18391;8143;5.0;2.2
87;2021-02-25;790;581;19181;8724;5.2;2.4
87;2021-02-26;841;379;20022;9103;5.4;2.5
87;2021-02-27;405;150;20427;9253;5.5;2.5
87;2021-02-28;3;0;20430;9253;5.5;2.5
87;2021-03-01;518;303;20948;9556;5.6;2.6
87;2021-03-02;1031;319;21979;9875;5.9;2.7
87;2021-03-03;1174;281;23153;10156;6.2;2.7
87;2021-03-04;1406;307;24559;10463;6.6;2.8
87;2021-03-05;1770;241;26329;10704;7.1;2.9
87;2021-03-06;1048;37;27377;10741;7.4;2.9
87;2021-03-07;257;6;27634;10747;7.5;2.9
87;2021-03-08;863;207;28497;10954;7.7;3.0
87;2021-03-09;1288;207;29785;11161;8.0;3.0
87;2021-03-10;1299;215;31084;11376;8.4;3.1
87;2021-03-11;1754;236;32838;11612;8.9;3.1
87;2021-03-12;2128;253;34966;11865;9.4;3.2
87;2021-03-13;1309;22;36275;11887;9.8;3.2
87;2021-03-14;80;1;36355;11888;9.8;3.2
87;2021-03-15;987;348;37342;12236;10.1;3.3
87;2021-03-16;1060;231;38402;12467;10.4;3.4
87;2021-03-17;1070;219;39472;12686;10.6;3.4
87;2021-03-18;1186;336;40658;13022;11.0;3.5
87;2021-03-19;1685;277;42343;13299;11.4;3.6
87;2021-03-20;926;86;43269;13385;11.7;3.6
87;2021-03-21;32;0;43301;13385;11.7;3.6
87;2021-03-22;1049;365;44350;13750;12.0;3.7
87;2021-03-23;1386;426;45736;14176;12.3;3.8
87;2021-03-24;1508;363;47244;14539;12.7;3.9
87;2021-03-25;2500;397;49744;14936;13.4;4.0
87;2021-03-26;2532;451;52276;15387;14.1;4.1
87;2021-03-27;891;123;53167;15510;14.3;4.2
87;2021-03-28;270;18;53437;15528;14.4;4.2
87;2021-03-29;1119;412;54556;15940;14.7;4.3
87;2021-03-30;1907;660;56463;16600;15.2;4.5
87;2021-03-31;1660;692;58123;17292;15.7;4.7
87;2021-04-01;2237;572;60360;17864;16.3;4.8
87;2021-04-02;1843;628;62203;18492;16.8;5.0
87;2021-04-03;455;266;62658;18758;16.9;5.1
87;2021-04-04;2;0;62660;18758;16.9;5.1
87;2021-04-05;82;1;62742;18759;16.9;5.1
87;2021-04-06;1004;904;63746;19663;17.2;5.3
87;2021-04-07;1487;922;65233;20585;17.6;5.6
87;2021-04-08;1785;1030;67018;21615;18.1;5.8
87;2021-04-09;2647;740;69665;22355;18.8;6.0
87;2021-04-10;1189;307;70854;22662;19.1;6.1
87;2021-04-11;69;0;70923;22662;19.1;6.1
87;2021-04-12;1619;827;72542;23489;19.6;6.3
87;2021-04-13;2288;1064;74830;24553;20.2;6.6
87;2021-04-14;2529;1185;77359;25738;20.9;6.9
87;2021-04-15;2223;1073;79582;26811;21.5;7.2
87;2021-04-16;2735;1068;82317;27879;22.2;7.5
87;2021-04-17;731;388;83048;28267;22.4;7.6
87;2021-04-18;111;139;83159;28406;22.4;7.7
87;2021-04-19;1661;838;84820;29244;22.9;7.9
87;2021-04-20;2084;884;86904;30128;23.4;8.1
87;2021-04-21;2295;990;89199;31118;24.1;8.4
87;2021-04-22;2564;1164;91763;32282;24.7;8.7
87;2021-04-23;1997;1180;93760;33462;25.3;9.0
87;2021-04-24;824;619;94584;34081;25.5;9.2
87;2021-04-25;64;103;94648;34184;25.5;9.2
87;2021-04-26;1356;910;96004;35094;25.9;9.5
87;2021-04-27;2398;1196;98402;36290;26.5;9.8
87;2021-04-28;3867;1431;102269;37721;27.6;10.2
87;2021-04-29;3078;1827;105347;39548;28.4;10.7
87;2021-04-30;3172;1345;108519;40893;29.3;11.0
87;2021-05-01;614;59;109133;40952;29.4;11.0
87;2021-05-02;361;5;109494;40957;29.5;11.0
87;2021-05-03;2322;931;111816;41888;30.2;11.3
87;2021-05-04;2902;1067;114718;42955;30.9;11.6
87;2021-05-05;2989;1505;117707;44460;31.7;12.0
87;2021-05-06;2531;1699;120238;46159;32.4;12.4
87;2021-05-07;2945;1710;123183;47869;33.2;12.9
87;2021-05-08;772;291;123955;48160;33.4;13.0
87;2021-05-09;18;133;123973;48293;33.4;13.0
87;2021-05-10;1938;1584;125911;49877;34.0;13.5
87;2021-05-11;2465;1902;128376;51779;34.6;14.0
87;2021-05-12;2623;2062;130999;53841;35.3;14.5
87;2021-05-13;1085;292;132084;54133;35.6;14.6
87;2021-05-14;2245;1773;134329;55906;36.2;15.1
87;2021-05-15;950;409;135279;56315;36.5;15.2
87;2021-05-16;141;73;135420;56388;36.5;15.2
87;2021-05-17;1628;1761;137048;58149;37.0;15.7
87;2021-05-18;2632;1818;139680;59967;37.7;16.2
87;2021-05-19;2822;1553;142502;61520;38.4;16.6
87;2021-05-20;3302;1724;145804;63244;39.3;17.1
87;2021-05-21;2764;1841;148568;65085;40.1;17.6
87;2021-05-22;1457;628;150025;65713;40.5;17.7
87;2021-05-23;211;92;150236;65805;40.5;17.7
87;2021-05-24;1055;141;151291;65946;40.8;17.8
87;2021-05-25;2117;1810;153408;67756;41.4;18.3
87;2021-05-26;3219;2476;156627;70232;42.2;18.9
87;2021-05-27;3022;2354;159649;72586;43.1;19.6
87;2021-05-28;2675;2511;162324;75097;43.8;20.3
87;2021-05-29;1061;1306;163385;76403;44.1;20.6
87;2021-05-30;258;60;163643;76463;44.1;20.6
87;2021-05-31;2287;1358;165930;77821;44.8;21.0
87;2021-06-01;2547;1858;168477;79679;45.4;21.5
87;2021-06-02;2525;1851;171002;81530;46.1;22.0
87;2021-06-03;3212;2525;174214;84055;47.0;22.7
87;2021-06-04;2838;2053;177052;86108;47.8;23.2
87;2021-06-05;1310;569;178362;86677;48.1;23.4
87;2021-06-06;261;95;178623;86772;48.2;23.4
87;2021-06-07;2098;1894;180721;88666;48.7;23.9
87;2021-06-08;2958;2597;183679;91263;49.5;24.6
87;2021-06-09;2303;2809;185982;94072;50.2;25.4
87;2021-06-10;2974;2552;188956;96624;51.0;26.1
87;2021-06-11;2363;3062;191319;99686;51.6;26.9
87;2021-06-12;1219;1099;192538;100785;51.9;27.2
87;2021-06-13;294;485;192832;101270;52.0;27.3
87;2021-06-14;980;2729;193812;103999;52.3;28.0
87;2021-06-15;1361;3317;195173;107316;52.6;28.9
87;2021-06-16;1650;3424;196823;110740;53.1;29.9
87;2021-06-17;2438;2313;199261;113053;53.7;30.5
87;2021-06-18;1791;3013;201052;116066;54.2;31.3
87;2021-06-19;1047;1177;202099;117243;54.5;31.6
87;2021-06-20;205;206;202304;117449;54.6;31.7
87;2021-06-21;1040;2647;203344;120096;54.8;32.4
87;2021-06-22;1029;2879;204373;122975;55.1;33.2
87;2021-06-23;1256;3081;205629;126056;55.5;34.0
87;2021-06-24;1616;2561;207245;128617;55.9;34.7
87;2021-06-25;1448;2708;208693;131325;56.3;35.4
87;2021-06-26;529;1199;209222;132524;56.4;35.7
87;2021-06-27;26;212;209248;132736;56.4;35.8
87;2021-06-28;717;2575;209965;135311;56.6;36.5
87;2021-06-29;1156;3415;211121;138726;56.9;37.4
87;2021-06-30;1125;2651;212246;141377;57.2;38.1
87;2021-07-01;1482;2552;213728;143929;57.6;38.8
87;2021-07-02;1204;3461;214932;147390;58.0;39.8
87;2021-07-03;415;1512;215347;148902;58.1;40.2
87;2021-07-04;24;384;215371;149286;58.1;40.3
87;2021-07-05;685;2391;216056;151677;58.3;40.9
87;2021-07-06;583;3220;216639;154897;58.4;41.8
87;2021-07-07;862;3343;217501;158240;58.7;42.7
87;2021-07-08;1119;3671;218620;161911;59.0;43.7
87;2021-07-09;1113;3701;219733;165612;59.3;44.7
87;2021-07-10;290;1360;220023;166972;59.3;45.0
87;2021-07-11;49;284;220072;167256;59.4;45.1
87;2021-07-12;559;3192;220631;170448;59.5;46.0
87;2021-07-13;833;3509;221464;173957;59.7;46.9
87;2021-07-14;517;538;221981;174495;59.9;47.1
87;2021-07-15;1361;3461;223342;177956;60.2;48.0
87;2021-07-16;1731;3593;225073;181549;60.7;49.0
87;2021-07-17;655;1373;225728;182922;60.9;49.3
87;2021-07-18;81;285;225809;183207;60.9;49.4
87;2021-07-19;1434;3400;227243;186607;61.3;50.3
87;2021-07-20;1805;3590;229048;190197;61.8;51.3
87;2021-07-21;1451;3149;230499;193346;62.2;52.1
87;2021-07-22;1877;3244;232376;196590;62.7;53.0
87;2021-07-23;1875;3171;234251;199761;63.2;53.9
87;2021-07-24;816;1284;235067;201045;63.4;54.2
87;2021-07-25;106;241;235173;201286;63.4;54.3
87;2021-07-26;1541;2328;236714;203614;63.8;54.9
87;2021-07-27;2556;2062;239270;205676;64.5;55.5
87;2021-07-28;2390;2005;241660;207681;65.2;56.0
87;2021-07-29;3011;1998;244671;209679;66.0;56.6
87;2021-07-30;2543;2072;247214;211751;66.7;57.1
87;2021-07-31;1103;837;248317;212588;67.0;57.3
87;2021-08-01;283;151;248600;212739;67.0;57.4
87;2021-08-02;2119;1519;250719;214258;67.6;57.8
87;2021-08-03;2496;1331;253215;215589;68.3;58.1
87;2021-08-04;2314;1061;255529;216650;68.9;58.4
87;2021-08-05;2528;1412;258057;218062;69.6;58.8
87;2021-08-06;2144;1659;260201;219721;70.2;59.3
87;2021-08-07;1110;783;261311;220504;70.5;59.5
87;2021-08-08;208;124;261519;220628;70.5;59.5
87;2021-08-09;1818;1526;263337;222154;71.0;59.9
87;2021-08-10;2199;1533;265536;223687;71.6;60.3
87;2021-08-11;1912;1273;267448;224960;72.1;60.7
87;2021-08-12;2106;1481;269554;226441;72.7;61.1
87;2021-08-13;1724;1620;271278;228061;73.2;61.5
87;2021-08-14;671;733;271949;228794;73.3;61.7
87;2021-08-15;72;104;272021;228898;73.4;61.7
87;2021-08-16;1505;1739;273526;230637;73.8;62.2
87;2021-08-17;1354;1669;274880;232306;74.1;62.7
87;2021-08-18;1245;1998;276125;234304;74.5;63.2
87;2021-08-19;1223;1798;277348;236102;74.8;63.7
87;2021-08-20;917;2205;278265;238307;75.0;64.3
87;2021-08-21;318;965;278583;239272;75.1;64.5
87;2021-08-22;92;235;278675;239507;75.2;64.6
87;2021-08-23;746;2393;279421;241900;75.4;65.2
87;2021-08-24;765;2135;280186;244035;75.6;65.8
87;2021-08-25;710;2062;280896;246097;75.8;66.4
87;2021-08-26;858;2156;281754;248253;76.0;67.0
87;2021-08-27;789;2668;282543;250921;76.2;67.7
87;2021-08-28;331;1300;282874;252221;76.3;68.0
87;2021-08-29;65;244;282939;252465;76.3;68.1
87;2021-08-30;472;2215;283411;254680;76.4;68.7
87;2021-08-31;608;1932;284019;256612;76.6;69.2
87;2021-09-01;749;2469;284768;259081;76.8;69.9
87;2021-09-02;556;2342;285324;261423;77.0;70.5
87;2021-09-03;648;2485;285972;263908;77.1;71.2
87;2021-09-04;276;1130;286248;265038;77.2;71.5
87;2021-09-05;9;7;286257;265045;77.2;71.5
87;2021-09-06;395;1987;286652;267032;77.3;72.0
87;2021-09-07;385;1524;287037;268556;77.4;72.4
87;2021-09-08;458;1820;287495;270376;77.5;72.9
87;2021-09-09;324;1285;287819;271661;77.6;73.3
87;2021-09-10;466;1695;288285;273356;77.8;73.7
87;2021-09-11;320;973;288605;274329;77.8;74.0
87;2021-09-12;3;13;288608;274342;77.8;74.0
87;2021-09-13;310;1106;288918;275448;77.9;74.3
87;2021-09-14;284;1019;289202;276467;78.0;74.6
87;2021-09-15;367;963;289569;277430;78.1;74.8
87;2021-09-16;347;789;289916;278219;78.2;75.0
87;2021-09-17;404;884;290320;279103;78.3;75.3
87;2021-09-18;286;727;290606;279830;78.4;75.5
87;2021-09-19;4;14;290610;279844;78.4;75.5
87;2021-09-20;203;465;290813;280309;78.4;75.6
87;2021-09-21;261;507;291074;280816;78.5;75.7
87;2021-09-22;235;758;291309;281574;78.6;75.9
87;2021-09-23;218;529;291527;282103;78.6;76.1
87;2021-09-24;293;740;291820;282843;78.7;76.3
87;2021-09-25;167;511;291987;283354;78.8;76.4
87;2021-09-26;1;5;291988;283359;78.8;76.4
87;2021-09-27;195;401;292183;283760;78.8;76.5
87;2021-09-28;204;321;292387;284081;78.9;76.6
87;2021-09-29;171;398;292558;284479;78.9;76.7
87;2021-09-30;140;268;292698;284747;78.9;76.8
87;2021-10-01;205;514;292903;285261;79.0;76.9
87;2021-10-02;156;399;293059;285660;79.0;77.0
87;2021-10-03;3;3;293062;285663;79.0;77.0
88;2020-12-27;0;0;0;0;0.0;0.0
88;2020-12-28;0;0;0;0;0.0;0.0
88;2020-12-29;0;0;0;0;0.0;0.0
88;2020-12-30;0;0;0;0;0.0;0.0
88;2020-12-31;0;0;0;0;0.0;0.0
88;2021-01-01;2;0;2;0;0.0;0.0
88;2021-01-02;0;0;2;0;0.0;0.0
88;2021-01-03;0;0;2;0;0.0;0.0
88;2021-01-04;0;0;2;0;0.0;0.0
88;2021-01-05;1;0;3;0;0.0;0.0
88;2021-01-06;3;0;6;0;0.0;0.0
88;2021-01-07;71;1;77;1;0.0;0.0
88;2021-01-08;189;2;266;3;0.1;0.0
88;2021-01-09;190;2;456;5;0.1;0.0
88;2021-01-10;0;0;456;5;0.1;0.0
88;2021-01-11;227;0;683;5;0.2;0.0
88;2021-01-12;422;0;1105;5;0.3;0.0
88;2021-01-13;491;2;1596;7;0.4;0.0
88;2021-01-14;347;2;1943;9;0.5;0.0
88;2021-01-15;380;1;2323;10;0.6;0.0
88;2021-01-16;62;0;2385;10;0.7;0.0
88;2021-01-17;1;0;2386;10;0.7;0.0
88;2021-01-18;461;0;2847;10;0.8;0.0
88;2021-01-19;451;0;3298;10;0.9;0.0
88;2021-01-20;462;1;3760;11;1.0;0.0
88;2021-01-21;1547;5;5307;16;1.5;0.0
88;2021-01-22;1182;2;6489;18;1.8;0.0
88;2021-01-23;285;0;6774;18;1.9;0.0
88;2021-01-24;298;2;7072;20;2.0;0.0
88;2021-01-25;937;4;8009;24;2.2;0.0
88;2021-01-26;388;5;8397;29;2.3;0.0
88;2021-01-27;4;0;8401;29;2.3;0.0
88;2021-01-28;162;35;8563;64;2.4;0.0
88;2021-01-29;526;145;9089;209;2.5;0.1
88;2021-01-30;288;79;9377;288;2.6;0.1
88;2021-01-31;0;0;9377;288;2.6;0.1
88;2021-02-01;406;261;9783;549;2.7;0.2
88;2021-02-02;333;346;10116;895;2.8;0.2
88;2021-02-03;437;223;10553;1118;2.9;0.3
88;2021-02-04;315;210;10868;1328;3.0;0.4
88;2021-02-05;457;236;11325;1564;3.2;0.4
88;2021-02-06;110;49;11435;1613;3.2;0.4
88;2021-02-07;0;0;11435;1613;3.2;0.4
88;2021-02-08;361;160;11796;1773;3.3;0.5
88;2021-02-09;291;237;12087;2010;3.4;0.6
88;2021-02-10;416;299;12503;2309;3.5;0.6
88;2021-02-11;850;953;13353;3262;3.7;0.9
88;2021-02-12;939;658;14292;3920;4.0;1.1
88;2021-02-13;162;202;14454;4122;4.0;1.1
88;2021-02-14;81;195;14535;4317;4.0;1.2
88;2021-02-15;639;891;15174;5208;4.2;1.4
88;2021-02-16;472;532;15646;5740;4.4;1.6
88;2021-02-17;455;341;16101;6081;4.5;1.7
88;2021-02-18;516;270;16617;6351;4.6;1.8
88;2021-02-19;536;383;17153;6734;4.8;1.9
88;2021-02-20;156;86;17309;6820;4.8;1.9
88;2021-02-21;1;25;17310;6845;4.8;1.9
88;2021-02-22;425;252;17735;7097;4.9;2.0
88;2021-02-23;403;187;18138;7284;5.0;2.0
88;2021-02-24;505;168;18643;7452;5.2;2.1
88;2021-02-25;675;220;19318;7672;5.4;2.1
88;2021-02-26;863;230;20181;7902;5.6;2.2
88;2021-02-27;269;31;20450;7933;5.7;2.2
88;2021-02-28;30;1;20480;7934;5.7;2.2
88;2021-03-01;358;379;20838;8313;5.8;2.3
88;2021-03-02;431;389;21269;8702;5.9;2.4
88;2021-03-03;650;364;21919;9066;6.1;2.5
88;2021-03-04;1044;660;22963;9726;6.4;2.7
88;2021-03-05;933;626;23896;10352;6.6;2.9
88;2021-03-06;1873;112;25769;10464;7.2;2.9
88;2021-03-07;1060;77;26829;10541;7.5;2.9
88;2021-03-08;726;625;27555;11166;7.7;3.1
88;2021-03-09;1095;468;28650;11634;8.0;3.2
88;2021-03-10;1083;451;29733;12085;8.3;3.4
88;2021-03-11;1441;362;31174;12447;8.7;3.5
88;2021-03-12;1309;460;32483;12907;9.0;3.6
88;2021-03-13;1210;129;33693;13036;9.4;3.6
88;2021-03-14;166;5;33859;13041;9.4;3.6
88;2021-03-15;928;436;34787;13477;9.7;3.7
88;2021-03-16;1024;337;35811;13814;10.0;3.8
88;2021-03-17;906;414;36717;14228;10.2;4.0
88;2021-03-18;1303;398;38020;14626;10.6;4.1
88;2021-03-19;1465;500;39485;15126;11.0;4.2
88;2021-03-20;1319;55;40804;15181;11.3;4.2
88;2021-03-21;37;0;40841;15181;11.4;4.2
88;2021-03-22;1233;541;42074;15722;11.7;4.4
88;2021-03-23;1780;443;43854;16165;12.2;4.5
88;2021-03-24;1877;466;45731;16631;12.7;4.6
88;2021-03-25;2497;490;48228;17121;13.4;4.8
88;2021-03-26;2480;443;50708;17564;14.1;4.9
88;2021-03-27;884;297;51592;17861;14.4;5.0
88;2021-03-28;61;3;51653;17864;14.4;5.0
88;2021-03-29;1305;436;52958;18300;14.7;5.1
88;2021-03-30;2062;392;55020;18692;15.3;5.2
88;2021-03-31;1619;575;56639;19267;15.8;5.4
88;2021-04-01;2117;718;58756;19985;16.3;5.6
88;2021-04-02;2812;647;61568;20632;17.1;5.7
88;2021-04-03;745;215;62313;20847;17.3;5.8
88;2021-04-04;16;1;62329;20848;17.3;5.8
88;2021-04-05;23;2;62352;20850;17.3;5.8
88;2021-04-06;1140;678;63492;21528;17.7;6.0
88;2021-04-07;1600;714;65092;22242;18.1;6.2
88;2021-04-08;1857;788;66949;23030;18.6;6.4
88;2021-04-09;3078;741;70027;23771;19.5;6.6
88;2021-04-10;724;648;70751;24419;19.7;6.8
88;2021-04-11;33;1;70784;24420;19.7;6.8
88;2021-04-12;1537;987;72321;25407;20.1;7.1
88;2021-04-13;2035;1088;74356;26495;20.7;7.4
88;2021-04-14;1910;949;76266;27444;21.2;7.6
88;2021-04-15;1967;1244;78233;28688;21.8;8.0
88;2021-04-16;2109;1048;80342;29736;22.3;8.3
88;2021-04-17;1430;765;81772;30501;22.7;8.5
88;2021-04-18;268;23;82040;30524;22.8;8.5
88;2021-04-19;1172;1238;83212;31762;23.1;8.8
88;2021-04-20;1190;1396;84402;33158;23.5;9.2
88;2021-04-21;1503;1296;85905;34454;23.9;9.6
88;2021-04-22;1900;1633;87805;36087;24.4;10.0
88;2021-04-23;1825;2046;89630;38133;24.9;10.6
88;2021-04-24;1184;783;90814;38916;25.3;10.8
88;2021-04-25;34;2;90848;38918;25.3;10.8
88;2021-04-26;1182;1170;92030;40088;25.6;11.2
88;2021-04-27;1277;1727;93307;41815;26.0;11.6
88;2021-04-28;1634;1496;94941;43311;26.4;12.0
88;2021-04-29;2082;1456;97023;44767;27.0;12.5
88;2021-04-30;2450;1624;99473;46391;27.7;12.9
88;2021-05-01;2008;290;101481;46681;28.2;13.0
88;2021-05-02;1301;119;102782;46800;28.6;13.0
88;2021-05-03;1559;1218;104341;48018;29.0;13.4
88;2021-05-04;1444;1464;105785;49482;29.4;13.8
88;2021-05-05;2426;1598;108211;51080;30.1;14.2
88;2021-05-06;3211;1205;111422;52285;31.0;14.5
88;2021-05-07;2938;1345;114360;53630;31.8;14.9
88;2021-05-08;1532;467;115892;54097;32.2;15.0
88;2021-05-09;1734;163;117626;54260;32.7;15.1
88;2021-05-10;1763;1568;119389;55828;33.2;15.5
88;2021-05-11;2655;1909;122044;57737;33.9;16.1
88;2021-05-12;2532;1853;124576;59590;34.7;16.6
88;2021-05-13;3258;683;127834;60273;35.6;16.8
88;2021-05-14;2500;1539;130334;61812;36.3;17.2
88;2021-05-15;1624;744;131958;62556;36.7;17.4
88;2021-05-16;1332;103;133290;62659;37.1;17.4
88;2021-05-17;1987;944;135277;63603;37.6;17.7
88;2021-05-18;2255;1116;137532;64719;38.3;18.0
88;2021-05-19;2721;1148;140253;65867;39.0;18.3
88;2021-05-20;3348;1237;143601;67104;39.9;18.7
88;2021-05-21;2875;1149;146476;68253;40.7;19.0
88;2021-05-22;1431;713;147907;68966;41.1;19.2
88;2021-05-23;558;74;148465;69040;41.3;19.2
88;2021-05-24;1675;435;150140;69475;41.8;19.3
88;2021-05-25;1646;1174;151786;70649;42.2;19.7
88;2021-05-26;2368;1140;154154;71789;42.9;20.0
88;2021-05-27;2200;1361;156354;73150;43.5;20.3
88;2021-05-28;1891;1963;158245;75113;44.0;20.9
88;2021-05-29;1230;1755;159475;76868;44.4;21.4
88;2021-05-30;587;418;160062;77286;44.5;21.5
88;2021-05-31;1327;1849;161389;79135;44.9;22.0
88;2021-06-01;1720;1983;163109;81118;45.4;22.6
88;2021-06-02;2076;1871;165185;82989;45.9;23.1
88;2021-06-03;2738;1612;167923;84601;46.7;23.5
88;2021-06-04;2042;1926;169965;86527;47.3;24.1
88;2021-06-05;1531;1135;171496;87662;47.7;24.4
88;2021-06-06;692;156;172188;87818;47.9;24.4
88;2021-06-07;1290;1710;173478;89528;48.3;24.9
88;2021-06-08;1666;1933;175144;91461;48.7;25.4
88;2021-06-09;1619;1909;176763;93370;49.2;26.0
88;2021-06-10;1781;2047;178544;95417;49.7;26.5
88;2021-06-11;1549;2211;180093;97628;50.1;27.2
88;2021-06-12;669;1657;180762;99285;50.3;27.6
88;2021-06-13;464;377;181226;99662;50.4;27.7
88;2021-06-14;1030;2249;182256;101911;50.7;28.3
88;2021-06-15;1927;2458;184183;104369;51.2;29.0
88;2021-06-16;1485;2873;185668;107242;51.6;29.8
88;2021-06-17;1601;2732;187269;109974;52.1;30.6
88;2021-06-18;1355;2460;188624;112434;52.5;31.3
88;2021-06-19;701;1089;189325;113523;52.7;31.6
88;2021-06-20;78;79;189403;113602;52.7;31.6
88;2021-06-21;672;2578;190075;116180;52.9;32.3
88;2021-06-22;869;3433;190944;119613;53.1;33.3
88;2021-06-23;1144;2876;192088;122489;53.4;34.1
88;2021-06-24;702;2604;192790;125093;53.6;34.8
88;2021-06-25;1435;3179;194225;128272;54.0;35.7
88;2021-06-26;903;2073;195128;130345;54.3;36.3
88;2021-06-27;543;635;195671;130980;54.4;36.4
88;2021-06-28;758;2514;196429;133494;54.6;37.1
88;2021-06-29;960;3353;197389;136847;54.9;38.1
88;2021-06-30;1136;3114;198525;139961;55.2;38.9
88;2021-07-01;1056;2686;199581;142647;55.5;39.7
88;2021-07-02;992;3144;200573;145791;55.8;40.6
88;2021-07-03;692;1699;201265;147490;56.0;41.0
88;2021-07-04;258;815;201523;148305;56.1;41.3
88;2021-07-05;993;2020;202516;150325;56.3;41.8
88;2021-07-06;1021;2414;203537;152739;56.6;42.5
88;2021-07-07;1177;2586;204714;155325;56.9;43.2
88;2021-07-08;1082;2063;205796;157388;57.2;43.8
88;2021-07-09;1583;2704;207379;160092;57.7;44.5
88;2021-07-10;721;1818;208100;161910;57.9;45.0
88;2021-07-11;468;696;208568;162606;58.0;45.2
88;2021-07-12;1055;2520;209623;165126;58.3;45.9
88;2021-07-13;1313;2654;210936;167780;58.7;46.7
88;2021-07-14;1207;799;212143;168579;59.0;46.9
88;2021-07-15;1744;3307;213887;171886;59.5;47.8
88;2021-07-16;1469;2960;215356;174846;59.9;48.6
88;2021-07-17;802;1587;216158;176433;60.1;49.1
88;2021-07-18;180;679;216338;177112;60.2;49.3
88;2021-07-19;1563;2232;217901;179344;60.6;49.9
88;2021-07-20;2144;2385;220045;181729;61.2;50.5
88;2021-07-21;1939;2217;221984;183946;61.7;51.2
88;2021-07-22;1699;2107;223683;186053;62.2;51.8
88;2021-07-23;2508;2778;226191;188831;62.9;52.5
88;2021-07-24;1059;1186;227250;190017;63.2;52.9
88;2021-07-25;432;608;227682;190625;63.3;53.0
88;2021-07-26;1715;2074;229397;192699;63.8;53.6
88;2021-07-27;2351;2060;231748;194759;64.5;54.2
88;2021-07-28;2210;2248;233958;197007;65.1;54.8
88;2021-07-29;3033;1635;236991;198642;65.9;55.3
88;2021-07-30;2272;2294;239263;200936;66.6;55.9
88;2021-07-31;1105;1036;240368;201972;66.9;56.2
88;2021-08-01;450;461;240818;202433;67.0;56.3
88;2021-08-02;2376;1770;243194;204203;67.6;56.8
88;2021-08-03;2875;1591;246069;205794;68.4;57.2
88;2021-08-04;2519;1530;248588;207324;69.1;57.7
88;2021-08-05;1994;1378;250582;208702;69.7;58.1
88;2021-08-06;2948;2010;253530;210712;70.5;58.6
88;2021-08-07;1175;912;254705;211624;70.8;58.9
88;2021-08-08;751;319;255456;211943;71.1;59.0
88;2021-08-09;1550;1648;257006;213591;71.5;59.4
88;2021-08-10;1941;2040;258947;215631;72.0;60.0
88;2021-08-11;1869;1756;260816;217387;72.5;60.5
88;2021-08-12;1670;1349;262486;218736;73.0;60.8
88;2021-08-13;1952;2136;264438;220872;73.6;61.4
88;2021-08-14;580;912;265018;221784;73.7;61.7
88;2021-08-15;337;520;265355;222304;73.8;61.8
88;2021-08-16;1149;1988;266504;224292;74.1;62.4
88;2021-08-17;1267;2058;267771;226350;74.5;63.0
88;2021-08-18;1208;1925;268979;228275;74.8;63.5
88;2021-08-19;1042;1582;270021;229857;75.1;63.9
88;2021-08-20;1020;2330;271041;232187;75.4;64.6
88;2021-08-21;405;1144;271446;233331;75.5;64.9
88;2021-08-22;100;479;271546;233810;75.5;65.0
88;2021-08-23;734;1640;272280;235450;75.7;65.5
88;2021-08-24;918;1973;273198;237423;76.0;66.0
88;2021-08-25;891;2459;274089;239882;76.2;66.7
88;2021-08-26;868;2049;274957;241931;76.5;67.3
88;2021-08-27;844;2711;275801;244642;76.7;68.0
88;2021-08-28;490;1351;276291;245993;76.8;68.4
88;2021-08-29;130;693;276421;246686;76.9;68.6
88;2021-08-30;699;2383;277120;249069;77.1;69.3
88;2021-08-31;781;2375;277901;251444;77.3;69.9
88;2021-09-01;686;2075;278587;253519;77.5;70.5
88;2021-09-02;666;1746;279253;255265;77.7;71.0
88;2021-09-03;728;2259;279981;257524;77.9;71.6
88;2021-09-04;426;1159;280407;258683;78.0;72.0
88;2021-09-05;188;425;280595;259108;78.0;72.1
88;2021-09-06;505;1362;281100;260470;78.2;72.4
88;2021-09-07;566;1412;281666;261882;78.3;72.8
88;2021-09-08;458;1491;282124;263373;78.5;73.3
88;2021-09-09;540;1102;282664;264475;78.6;73.6
88;2021-09-10;590;1582;283254;266057;78.8;74.0
88;2021-09-11;349;851;283603;266908;78.9;74.2
88;2021-09-12;70;142;283673;267050;78.9;74.3
88;2021-09-13;427;1074;284100;268124;79.0;74.6
88;2021-09-14;550;1259;284650;269383;79.2;74.9
88;2021-09-15;424;971;285074;270354;79.3;75.2
88;2021-09-16;255;536;285329;270890;79.4;75.3
88;2021-09-17;432;1026;285761;271916;79.5;75.6
88;2021-09-18;233;680;285994;272596;79.5;75.8
88;2021-09-19;51;164;286045;272760;79.6;75.9
88;2021-09-20;222;564;286267;273324;79.6;76.0
88;2021-09-21;207;596;286474;273920;79.7;76.2
88;2021-09-22;206;780;286680;274700;79.7;76.4
88;2021-09-23;287;626;286967;275326;79.8;76.6
88;2021-09-24;280;801;287247;276127;79.9;76.8
88;2021-09-25;126;563;287373;276690;79.9;77.0
88;2021-09-26;18;159;287391;276849;79.9;77.0
88;2021-09-27;165;455;287556;277304;80.0;77.1
88;2021-09-28;175;523;287731;277827;80.0;77.3
88;2021-09-29;174;504;287905;278331;80.1;77.4
88;2021-09-30;127;459;288032;278790;80.1;77.5
88;2021-10-01;203;672;288235;279462;80.2;77.7
88;2021-10-02;124;358;288359;279820;80.2;77.8
88;2021-10-03;22;79;288381;279899;80.2;77.9
89;2020-12-27;0;0;0;0;0.0;0.0
89;2020-12-28;2;0;2;0;0.0;0.0
89;2020-12-29;0;0;2;0;0.0;0.0
89;2020-12-30;0;0;2;0;0.0;0.0
89;2020-12-31;0;0;2;0;0.0;0.0
89;2021-01-01;0;0;2;0;0.0;0.0
89;2021-01-02;0;0;2;0;0.0;0.0
89;2021-01-03;0;0;2;0;0.0;0.0
89;2021-01-04;0;0;2;0;0.0;0.0
89;2021-01-05;0;0;2;0;0.0;0.0
89;2021-01-06;48;0;50;0;0.0;0.0
89;2021-01-07;201;0;251;0;0.1;0.0
89;2021-01-08;48;0;299;0;0.1;0.0
89;2021-01-09;1;0;300;0;0.1;0.0
89;2021-01-10;0;0;300;0;0.1;0.0
89;2021-01-11;221;0;521;0;0.2;0.0
89;2021-01-12;349;0;870;0;0.3;0.0
89;2021-01-13;533;3;1403;3;0.4;0.0
89;2021-01-14;711;7;2114;10;0.6;0.0
89;2021-01-15;278;2;2392;12;0.7;0.0
89;2021-01-16;90;3;2482;15;0.7;0.0
89;2021-01-17;0;0;2482;15;0.7;0.0
89;2021-01-18;503;1;2985;16;0.9;0.0
89;2021-01-19;841;3;3826;19;1.2;0.0
89;2021-01-20;762;0;4588;19;1.4;0.0
89;2021-01-21;939;3;5527;22;1.7;0.0
89;2021-01-22;1020;1;6547;23;2.0;0.0
89;2021-01-23;200;0;6747;23;2.0;0.0
89;2021-01-24;107;0;6854;23;2.1;0.0
89;2021-01-25;483;3;7337;26;2.2;0.0
89;2021-01-26;582;13;7919;39;2.4;0.0
89;2021-01-27;473;37;8392;76;2.5;0.0
89;2021-01-28;551;123;8943;199;2.7;0.1
89;2021-01-29;958;39;9901;238;3.0;0.1
89;2021-01-30;184;13;10085;251;3.0;0.1
89;2021-01-31;24;1;10109;252;3.0;0.1
89;2021-02-01;255;138;10364;390;3.1;0.1
89;2021-02-02;283;312;10647;702;3.2;0.2
89;2021-02-03;292;318;10939;1020;3.3;0.3
89;2021-02-04;434;559;11373;1579;3.4;0.5
89;2021-02-05;387;178;11760;1757;3.5;0.5
89;2021-02-06;77;66;11837;1823;3.6;0.5
89;2021-02-07;0;0;11837;1823;3.6;0.5
89;2021-02-08;287;158;12124;1981;3.7;0.6
89;2021-02-09;284;397;12408;2378;3.7;0.7
89;2021-02-10;396;277;12804;2655;3.9;0.8
89;2021-02-11;332;526;13136;3181;4.0;1.0
89;2021-02-12;432;561;13568;3742;4.1;1.1
89;2021-02-13;51;122;13619;3864;4.1;1.2
89;2021-02-14;21;116;13640;3980;4.1;1.2
89;2021-02-15;217;306;13857;4286;4.2;1.3
89;2021-02-16;134;426;13991;4712;4.2;1.4
89;2021-02-17;263;334;14254;5046;4.3;1.5
89;2021-02-18;225;420;14479;5466;4.4;1.6
89;2021-02-19;245;568;14724;6034;4.4;1.8
89;2021-02-20;33;126;14757;6160;4.4;1.9
89;2021-02-21;0;10;14757;6170;4.4;1.9
89;2021-02-22;233;355;14990;6525;4.5;2.0
89;2021-02-23;170;383;15160;6908;4.6;2.1
89;2021-02-24;343;290;15503;7198;4.7;2.2
89;2021-02-25;370;371;15873;7569;4.8;2.3
89;2021-02-26;385;279;16258;7848;4.9;2.4
89;2021-02-27;138;62;16396;7910;4.9;2.4
89;2021-02-28;6;12;16402;7922;4.9;2.4
89;2021-03-01;541;198;16943;8120;5.1;2.4
89;2021-03-02;754;307;17697;8427;5.3;2.5
89;2021-03-03;647;231;18344;8658;5.5;2.6
89;2021-03-04;633;335;18977;8993;5.7;2.7
89;2021-03-05;728;454;19705;9447;5.9;2.8
89;2021-03-06;549;121;20254;9568;6.1;2.9
89;2021-03-07;288;40;20542;9608;6.2;2.9
89;2021-03-08;559;300;21101;9908;6.4;3.0
89;2021-03-09;1003;241;22104;10149;6.7;3.1
89;2021-03-10;984;232;23088;10381;7.0;3.1
89;2021-03-11;1076;284;24164;10665;7.3;3.2
89;2021-03-12;1280;308;25444;10973;7.7;3.3
89;2021-03-13;637;44;26081;11017;7.9;3.3
89;2021-03-14;1;0;26082;11017;7.9;3.3
89;2021-03-15;816;310;26898;11327;8.1;3.4
89;2021-03-16;948;218;27846;11545;8.4;3.5
89;2021-03-17;920;266;28766;11811;8.7;3.6
89;2021-03-18;885;253;29651;12064;8.9;3.6
89;2021-03-19;1149;196;30800;12260;9.3;3.7
89;2021-03-20;844;30;31644;12290;9.5;3.7
89;2021-03-21;173;6;31817;12296;9.6;3.7
89;2021-03-22;1044;221;32861;12517;9.9;3.8
89;2021-03-23;1744;257;34605;12774;10.4;3.8
89;2021-03-24;1968;325;36573;13099;11.0;3.9
89;2021-03-25;1821;170;38394;13269;11.6;4.0
89;2021-03-26;2628;184;41022;13453;12.4;4.1
89;2021-03-27;1775;49;42797;13502;12.9;4.1
89;2021-03-28;32;3;42829;13505;12.9;4.1
89;2021-03-29;965;570;43794;14075;13.2;4.2
89;2021-03-30;1156;568;44950;14643;13.5;4.4
89;2021-03-31;2004;471;46954;15114;14.1;4.6
89;2021-04-01;2121;459;49075;15573;14.8;4.7
89;2021-04-02;2140;446;51215;16019;15.4;4.8
89;2021-04-03;1004;243;52219;16262;15.7;4.9
89;2021-04-04;16;1;52235;16263;15.7;4.9
89;2021-04-05;92;2;52327;16265;15.8;4.9
89;2021-04-06;1032;754;53359;17019;16.1;5.1
89;2021-04-07;1027;799;54386;17818;16.4;5.4
89;2021-04-08;1731;728;56117;18546;16.9;5.6
89;2021-04-09;2164;767;58281;19313;17.5;5.8
89;2021-04-10;891;180;59172;19493;17.8;5.9
89;2021-04-11;38;51;59210;19544;17.8;5.9
89;2021-04-12;1010;791;60220;20335;18.1;6.1
89;2021-04-13;1356;1081;61576;21416;18.5;6.4
89;2021-04-14;1214;1036;62790;22452;18.9;6.8
89;2021-04-15;1412;942;64202;23394;19.3;7.0
89;2021-04-16;1330;939;65532;24333;19.7;7.3
89;2021-04-17;1070;455;66602;24788;20.1;7.5
89;2021-04-18;27;154;66629;24942;20.1;7.5
89;2021-04-19;748;1039;67377;25981;20.3;7.8
89;2021-04-20;1016;1533;68393;27514;20.6;8.3
89;2021-04-21;814;1100;69207;28614;20.8;8.6
89;2021-04-22;1106;1164;70313;29778;21.2;9.0
89;2021-04-23;1820;1964;72133;31742;21.7;9.6
89;2021-04-24;1173;1173;73306;32915;22.1;9.9
89;2021-04-25;139;6;73445;32921;22.1;9.9
89;2021-04-26;1503;775;74948;33696;22.6;10.1
89;2021-04-27;1733;1053;76681;34749;23.1;10.5
89;2021-04-28;1598;1853;78279;36602;23.6;11.0
89;2021-04-29;1970;1923;80249;38525;24.2;11.6
89;2021-04-30;1803;1767;82052;40292;24.7;12.1
89;2021-05-01;846;721;82898;41013;25.0;12.3
89;2021-05-02;134;31;83032;41044;25.0;12.4
89;2021-05-03;1606;761;84638;41805;25.5;12.6
89;2021-05-04;1619;1125;86257;42930;26.0;12.9
89;2021-05-05;2319;1265;88576;44195;26.7;13.3
89;2021-05-06;2411;1382;90987;45577;27.4;13.7
89;2021-05-07;2718;1313;93705;46890;28.2;14.1
89;2021-05-08;1787;534;95492;47424;28.8;14.3
89;2021-05-09;196;18;95688;47442;28.8;14.3
89;2021-05-10;1201;960;96889;48402;29.2;14.6
89;2021-05-11;2491;1463;99380;49865;29.9;15.0
89;2021-05-12;2058;1215;101438;51080;30.5;15.4
89;2021-05-13;415;332;101853;51412;30.7;15.5
89;2021-05-14;1880;1095;103733;52507;31.2;15.8
89;2021-05-15;2247;394;105980;52901;31.9;15.9
89;2021-05-16;10;35;105990;52936;31.9;15.9
89;2021-05-17;2091;635;108081;53571;32.5;16.1
89;2021-05-18;2324;830;110405;54401;33.2;16.4
89;2021-05-19;2861;882;113266;55283;34.1;16.6
89;2021-05-20;2927;886;116193;56169;35.0;16.9
89;2021-05-21;2481;877;118674;57046;35.7;17.2
89;2021-05-22;1430;560;120104;57606;36.2;17.3
89;2021-05-23;108;10;120212;57616;36.2;17.3
89;2021-05-24;288;226;120500;57842;36.3;17.4
89;2021-05-25;1558;982;122058;58824;36.8;17.7
89;2021-05-26;1815;1024;123873;59848;37.3;18.0
89;2021-05-27;2118;1358;125991;61206;37.9;18.4
89;2021-05-28;2143;1418;128134;62624;38.6;18.9
89;2021-05-29;541;658;128675;63282;38.7;19.1
89;2021-05-30;25;22;128700;63304;38.8;19.1
89;2021-05-31;1248;971;129948;64275;39.1;19.4
89;2021-06-01;1505;979;131453;65254;39.6;19.6
89;2021-06-02;1946;1278;133399;66532;40.2;20.0
89;2021-06-03;2428;1522;135827;68054;40.9;20.5
89;2021-06-04;2140;1884;137967;69938;41.5;21.1
89;2021-06-05;1185;1223;139152;71161;41.9;21.4
89;2021-06-06;23;37;139175;71198;41.9;21.4
89;2021-06-07;2107;1448;141282;72646;42.5;21.9
89;2021-06-08;2196;1447;143478;74093;43.2;22.3
89;2021-06-09;2321;1510;145799;75603;43.9;22.8
89;2021-06-10;2790;1598;148589;77201;44.7;23.2
89;2021-06-11;1950;1746;150539;78947;45.3;23.8
89;2021-06-12;1103;757;151642;79704;45.7;24.0
89;2021-06-13;156;417;151798;80121;45.7;24.1
89;2021-06-14;1311;1825;153109;81946;46.1;24.7
89;2021-06-15;1402;2011;154511;83957;46.5;25.3
89;2021-06-16;1128;2582;155639;86539;46.9;26.1
89;2021-06-17;1433;2335;157072;88874;47.3;26.8
89;2021-06-18;1623;2877;158695;91751;47.8;27.6
89;2021-06-19;686;1660;159381;93411;48.0;28.1
89;2021-06-20;55;125;159436;93536;48.0;28.2
89;2021-06-21;758;1528;160194;95064;48.2;28.6
89;2021-06-22;1049;2679;161243;97743;48.6;29.4
89;2021-06-23;1154;1797;162397;99540;48.9;30.0
89;2021-06-24;1077;1497;163474;101037;49.2;30.4
89;2021-06-25;1008;2425;164482;103462;49.5;31.2
89;2021-06-26;560;2482;165042;105944;49.7;31.9
89;2021-06-27;14;28;165056;105972;49.7;31.9
89;2021-06-28;1033;2494;166089;108466;50.0;32.7
89;2021-06-29;691;2403;166780;110869;50.2;33.4
89;2021-06-30;1083;3182;167863;114051;50.5;34.3
89;2021-07-01;1022;2989;168885;117040;50.9;35.2
89;2021-07-02;1108;2748;169993;119788;51.2;36.1
89;2021-07-03;554;1575;170547;121363;51.4;36.5
89;2021-07-04;11;36;170558;121399;51.4;36.6
89;2021-07-05;1296;1838;171854;123237;51.7;37.1
89;2021-07-06;1052;2312;172906;125549;52.1;37.8
89;2021-07-07;670;1787;173576;127336;52.3;38.3
89;2021-07-08;794;1873;174370;129209;52.5;38.9
89;2021-07-09;1140;2606;175510;131815;52.8;39.7
89;2021-07-10;719;816;176229;132631;53.1;39.9
89;2021-07-11;26;39;176255;132670;53.1;39.9
89;2021-07-12;1425;1899;177680;134569;53.5;40.5
89;2021-07-13;2142;2745;179822;137314;54.1;41.3
89;2021-07-14;316;324;180138;137638;54.2;41.4
89;2021-07-15;2250;3156;182388;140794;54.9;42.4
89;2021-07-16;2391;2864;184779;143658;55.6;43.3
89;2021-07-17;1235;1229;186014;144887;56.0;43.6
89;2021-07-18;277;97;186291;144984;56.1;43.7
89;2021-07-19;1566;2811;187857;147795;56.6;44.5
89;2021-07-20;1928;3283;189785;151078;57.1;45.5
89;2021-07-21;2080;2725;191865;153803;57.8;46.3
89;2021-07-22;2480;2992;194345;156795;58.5;47.2
89;2021-07-23;2474;3105;196819;159900;59.3;48.1
89;2021-07-24;1241;1247;198060;161147;59.6;48.5
89;2021-07-25;69;185;198129;161332;59.7;48.6
89;2021-07-26;1720;2322;199849;163654;60.2;49.3
89;2021-07-27;2345;1911;202194;165565;60.9;49.9
89;2021-07-28;2538;1339;204732;166904;61.6;50.3
89;2021-07-29;2526;1621;207258;168525;62.4;50.7
89;2021-07-30;2678;1625;209936;170150;63.2;51.2
89;2021-07-31;1121;1073;211057;171223;63.6;51.6
89;2021-08-01;69;31;211126;171254;63.6;51.6
89;2021-08-02;1801;1288;212927;172542;64.1;52.0
89;2021-08-03;2498;1255;215425;173797;64.9;52.3
89;2021-08-04;1535;1641;216960;175438;65.3;52.8
89;2021-08-05;1544;1693;218504;177131;65.8;53.3
89;2021-08-06;2197;1652;220701;178783;66.5;53.8
89;2021-08-07;930;1098;221631;179881;66.7;54.2
89;2021-08-08;56;48;221687;179929;66.8;54.2
89;2021-08-09;1117;1175;222804;181104;67.1;54.5
89;2021-08-10;1825;1816;224629;182920;67.6;55.1
89;2021-08-11;1562;1585;226191;184505;68.1;55.6
89;2021-08-12;1401;1390;227592;185895;68.5;56.0
89;2021-08-13;1330;1953;228922;187848;68.9;56.6
89;2021-08-14;527;1024;229449;188872;69.1;56.9
89;2021-08-15;20;43;229469;188915;69.1;56.9
89;2021-08-16;1031;1968;230500;190883;69.4;57.5
89;2021-08-17;860;1572;231360;192455;69.7;58.0
89;2021-08-18;639;1897;231999;194352;69.9;58.5
89;2021-08-19;689;1388;232688;195740;70.1;58.9
89;2021-08-20;1092;2265;233780;198005;70.4;59.6
89;2021-08-21;297;1003;234077;199008;70.5;59.9
89;2021-08-22;32;34;234109;199042;70.5;59.9
89;2021-08-23;811;2252;234920;201294;70.7;60.6
89;2021-08-24;860;2365;235780;203659;71.0;61.3
89;2021-08-25;593;1429;236373;205088;71.2;61.8
89;2021-08-26;612;2053;236985;207141;71.4;62.4
89;2021-08-27;859;2264;237844;209405;71.6;63.1
89;2021-08-28;379;1303;238223;210708;71.7;63.4
89;2021-08-29;30;70;238253;210778;71.7;63.5
89;2021-08-30;662;2234;238915;213012;71.9;64.1
89;2021-08-31;602;1625;239517;214637;72.1;64.6
89;2021-09-01;523;1373;240040;216010;72.3;65.0
89;2021-09-02;451;1458;240491;217468;72.4;65.5
89;2021-09-03;585;2091;241076;219559;72.6;66.1
89;2021-09-04;494;997;241570;220556;72.7;66.4
89;2021-09-05;21;18;241591;220574;72.7;66.4
89;2021-09-06;419;1859;242010;222433;72.9;67.0
89;2021-09-07;357;1149;242367;223582;73.0;67.3
89;2021-09-08;334;1018;242701;224600;73.1;67.6
89;2021-09-09;270;962;242971;225562;73.2;67.9
89;2021-09-10;465;1560;243436;227122;73.3;68.4
89;2021-09-11;272;823;243708;227945;73.4;68.6
89;2021-09-12;11;45;243719;227990;73.4;68.7
89;2021-09-13;382;1286;244101;229276;73.5;69.0
89;2021-09-14;369;843;244470;230119;73.6;69.3
89;2021-09-15;229;694;244699;230813;73.7;69.5
89;2021-09-16;242;567;244941;231380;73.8;69.7
89;2021-09-17;496;1117;245437;232497;73.9;70.0
89;2021-09-18;178;744;245615;233241;74.0;70.2
89;2021-09-19;4;17;245619;233258;74.0;70.2
89;2021-09-20;248;724;245867;233982;74.0;70.5
89;2021-09-21;293;479;246160;234461;74.1;70.6
89;2021-09-22;197;577;246357;235038;74.2;70.8
89;2021-09-23;226;469;246583;235507;74.3;70.9
89;2021-09-24;301;867;246884;236374;74.3;71.2
89;2021-09-25;107;465;246991;236839;74.4;71.3
89;2021-09-26;3;19;246994;236858;74.4;71.3
89;2021-09-27;193;504;247187;237362;74.4;71.5
89;2021-09-28;240;404;247427;237766;74.5;71.6
89;2021-09-29;178;421;247605;238187;74.6;71.7
89;2021-09-30;157;619;247762;238806;74.6;71.9
89;2021-10-01;248;657;248010;239463;74.7;72.1
89;2021-10-02;112;482;248122;239945;74.7;72.3
89;2021-10-03;7;7;248129;239952;74.7;72.3
90;2020-12-27;0;0;0;0;0.0;0.0
90;2020-12-28;0;0;0;0;0.0;0.0
90;2020-12-29;0;0;0;0;0.0;0.0
90;2020-12-30;1;0;1;0;0.0;0.0
90;2020-12-31;0;0;1;0;0.0;0.0
90;2021-01-01;0;0;1;0;0.0;0.0
90;2021-01-02;1;0;2;0;0.0;0.0
90;2021-01-03;0;0;2;0;0.0;0.0
90;2021-01-04;2;0;4;0;0.0;0.0
90;2021-01-05;0;0;4;0;0.0;0.0
90;2021-01-06;0;0;4;0;0.0;0.0
90;2021-01-07;1;0;5;0;0.0;0.0
90;2021-01-08;170;0;175;0;0.1;0.0
90;2021-01-09;46;0;221;0;0.2;0.0
90;2021-01-10;0;0;221;0;0.2;0.0
90;2021-01-11;200;0;421;0;0.3;0.0
90;2021-01-12;431;1;852;1;0.6;0.0
90;2021-01-13;467;2;1319;3;0.9;0.0
90;2021-01-14;414;2;1733;5;1.2;0.0
90;2021-01-15;404;8;2137;13;1.5;0.0
90;2021-01-16;111;2;2248;15;1.6;0.0
90;2021-01-17;1;0;2249;15;1.6;0.0
90;2021-01-18;365;2;2614;17;1.9;0.0
90;2021-01-19;462;4;3076;21;2.2;0.0
90;2021-01-20;393;2;3469;23;2.5;0.0
90;2021-01-21;351;1;3820;24;2.7;0.0
90;2021-01-22;345;2;4165;26;3.0;0.0
90;2021-01-23;98;0;4263;26;3.0;0.0
90;2021-01-24;0;0;4263;26;3.0;0.0
90;2021-01-25;322;1;4585;27;3.3;0.0
90;2021-01-26;224;0;4809;27;3.4;0.0
90;2021-01-27;254;0;5063;27;3.6;0.0
90;2021-01-28;328;29;5391;56;3.8;0.0
90;2021-01-29;291;155;5682;211;4.1;0.2
90;2021-01-30;176;40;5858;251;4.2;0.2
90;2021-01-31;118;0;5976;251;4.3;0.2
90;2021-02-01;275;103;6251;354;4.5;0.3
90;2021-02-02;290;151;6541;505;4.7;0.4
90;2021-02-03;256;242;6797;747;4.8;0.5
90;2021-02-04;257;293;7054;1040;5.0;0.7
90;2021-02-05;266;262;7320;1302;5.2;0.9
90;2021-02-06;89;59;7409;1361;5.3;1.0
90;2021-02-07;0;0;7409;1361;5.3;1.0
90;2021-02-08;170;205;7579;1566;5.4;1.1
90;2021-02-09;139;157;7718;1723;5.5;1.2
90;2021-02-10;182;28;7900;1751;5.6;1.2
90;2021-02-11;229;95;8129;1846;5.8;1.3
90;2021-02-12;126;231;8255;2077;5.9;1.5
90;2021-02-13;96;40;8351;2117;6.0;1.5
90;2021-02-14;0;0;8351;2117;6.0;1.5
90;2021-02-15;112;244;8463;2361;6.0;1.7
90;2021-02-16;92;249;8555;2610;6.1;1.9
90;2021-02-17;178;169;8733;2779;6.2;2.0
90;2021-02-18;128;198;8861;2977;6.3;2.1
90;2021-02-19;64;211;8925;3188;6.4;2.3
90;2021-02-20;40;62;8965;3250;6.4;2.3
90;2021-02-21;0;0;8965;3250;6.4;2.3
90;2021-02-22;77;270;9042;3520;6.5;2.5
90;2021-02-23;40;197;9082;3717;6.5;2.7
90;2021-02-24;109;251;9191;3968;6.6;2.8
90;2021-02-25;89;254;9280;4222;6.6;3.0
90;2021-02-26;89;335;9369;4557;6.7;3.3
90;2021-02-27;140;146;9509;4703;6.8;3.4
90;2021-02-28;8;98;9517;4801;6.8;3.4
90;2021-03-01;211;205;9728;5006;6.9;3.6
90;2021-03-02;178;247;9906;5253;7.1;3.7
90;2021-03-03;239;323;10145;5576;7.2;4.0
90;2021-03-04;260;255;10405;5831;7.4;4.2
90;2021-03-05;359;252;10764;6083;7.7;4.3
90;2021-03-06;291;97;11055;6180;7.9;4.4
90;2021-03-07;18;1;11073;6181;7.9;4.4
90;2021-03-08;246;224;11319;6405;8.1;4.6
90;2021-03-09;430;154;11749;6559;8.4;4.7
90;2021-03-10;348;193;12097;6752;8.6;4.8
90;2021-03-11;347;116;12444;6868;8.9;4.9
90;2021-03-12;519;129;12963;6997;9.2;5.0
90;2021-03-13;539;48;13502;7045;9.6;5.0
90;2021-03-14;21;0;13523;7045;9.6;5.0
90;2021-03-15;388;117;13911;7162;9.9;5.1
90;2021-03-16;402;101;14313;7263;10.2;5.2
90;2021-03-17;323;76;14636;7339;10.4;5.2
90;2021-03-18;348;78;14984;7417;10.7;5.3
90;2021-03-19;468;78;15452;7495;11.0;5.3
90;2021-03-20;427;48;15879;7543;11.3;5.4
90;2021-03-21;7;1;15886;7544;11.3;5.4
90;2021-03-22;399;30;16285;7574;11.6;5.4
90;2021-03-23;740;77;17025;7651;12.1;5.5
90;2021-03-24;817;46;17842;7697;12.7;5.5
90;2021-03-25;949;75;18791;7772;13.4;5.5
90;2021-03-26;1226;62;20017;7834;14.3;5.6
90;2021-03-27;439;34;20456;7868;14.6;5.6
90;2021-03-28;34;0;20490;7868;14.6;5.6
90;2021-03-29;712;142;21202;8010;15.1;5.7
90;2021-03-30;675;155;21877;8165;15.6;5.8
90;2021-03-31;728;85;22605;8250;16.1;5.9
90;2021-04-01;602;123;23207;8373;16.6;6.0
90;2021-04-02;657;98;23864;8471;17.0;6.0
90;2021-04-03;370;40;24234;8511;17.3;6.1
90;2021-04-04;1;0;24235;8511;17.3;6.1
90;2021-04-05;0;0;24235;8511;17.3;6.1
90;2021-04-06;529;250;24764;8761;17.7;6.3
90;2021-04-07;485;267;25249;9028;18.0;6.4
90;2021-04-08;510;246;25759;9274;18.4;6.6
90;2021-04-09;751;266;26510;9540;18.9;6.8
90;2021-04-10;224;8;26734;9548;19.1;6.8
90;2021-04-11;7;0;26741;9548;19.1;6.8
90;2021-04-12;557;481;27298;10029;19.5;7.2
90;2021-04-13;632;531;27930;10560;19.9;7.5
90;2021-04-14;526;351;28456;10911;20.3;7.8
90;2021-04-15;905;292;29361;11203;21.0;8.0
90;2021-04-16;370;404;29731;11607;21.2;8.3
90;2021-04-17;189;128;29920;11735;21.3;8.4
90;2021-04-18;21;0;29941;11735;21.4;8.4
90;2021-04-19;435;572;30376;12307;21.7;8.8
90;2021-04-20;493;617;30869;12924;22.0;9.2
90;2021-04-21;353;497;31222;13421;22.3;9.6
90;2021-04-22;569;602;31791;14023;22.7;10.0
90;2021-04-23;504;742;32295;14765;23.0;10.5
90;2021-04-24;305;202;32600;14967;23.3;10.7
90;2021-04-25;1;0;32601;14967;23.3;10.7
90;2021-04-26;509;750;33110;15717;23.6;11.2
90;2021-04-27;640;680;33750;16397;24.1;11.7
90;2021-04-28;765;446;34515;16843;24.6;12.0
90;2021-04-29;1003;449;35518;17292;25.3;12.3
90;2021-04-30;1120;460;36638;17752;26.1;12.7
90;2021-05-01;60;42;36698;17794;26.2;12.7
90;2021-05-02;4;0;36702;17794;26.2;12.7
90;2021-05-03;903;285;37605;18079;26.8;12.9
90;2021-05-04;784;637;38389;18716;27.4;13.4
90;2021-05-05;891;504;39280;19220;28.0;13.7
90;2021-05-06;851;626;40131;19846;28.6;14.2
90;2021-05-07;440;507;40571;20353;28.9;14.5
90;2021-05-08;26;27;40597;20380;29.0;14.5
90;2021-05-09;5;33;40602;20413;29.0;14.6
90;2021-05-10;506;581;41108;20994;29.3;15.0
90;2021-05-11;778;638;41886;21632;29.9;15.4
90;2021-05-12;531;598;42417;22230;30.3;15.9
90;2021-05-13;1113;265;43530;22495;31.1;16.1
90;2021-05-14;865;403;44395;22898;31.7;16.3
90;2021-05-15;14;125;44409;23023;31.7;16.4
90;2021-05-16;2;7;44411;23030;31.7;16.4
90;2021-05-17;792;290;45203;23320;32.3;16.6
90;2021-05-18;1024;472;46227;23792;33.0;17.0
90;2021-05-19;1264;384;47491;24176;33.9;17.3
90;2021-05-20;1201;270;48692;24446;34.7;17.4
90;2021-05-21;1264;434;49956;24880;35.6;17.8
90;2021-05-22;9;131;49965;25011;35.7;17.8
90;2021-05-23;4;0;49969;25011;35.7;17.8
90;2021-05-24;368;265;50337;25276;35.9;18.0
90;2021-05-25;635;791;50972;26067;36.4;18.6
90;2021-05-26;630;569;51602;26636;36.8;19.0
90;2021-05-27;962;380;52564;27016;37.5;19.3
90;2021-05-28;668;827;53232;27843;38.0;19.9
90;2021-05-29;93;296;53325;28139;38.0;20.1
90;2021-05-30;4;1;53329;28140;38.1;20.1
90;2021-05-31;808;713;54137;28853;38.6;20.6
90;2021-06-01;969;739;55106;29592;39.3;21.1
90;2021-06-02;760;676;55866;30268;39.9;21.6
90;2021-06-03;758;744;56624;31012;40.4;22.1
90;2021-06-04;833;971;57457;31983;41.0;22.8
90;2021-06-05;54;427;57511;32410;41.0;23.1
90;2021-06-06;1;16;57512;32426;41.0;23.1
90;2021-06-07;1265;1081;58777;33507;41.9;23.9
90;2021-06-08;1482;939;60259;34446;43.0;24.6
90;2021-06-09;964;659;61223;35105;43.7;25.0
90;2021-06-10;627;498;61850;35603;44.1;25.4
90;2021-06-11;787;1126;62637;36729;44.7;26.2
90;2021-06-12;806;297;63443;37026;45.3;26.4
90;2021-06-13;10;12;63453;37038;45.3;26.4
90;2021-06-14;264;972;63717;38010;45.5;27.1
90;2021-06-15;566;882;64283;38892;45.9;27.8
90;2021-06-16;509;548;64792;39440;46.2;28.1
90;2021-06-17;443;638;65235;40078;46.5;28.6
90;2021-06-18;623;997;65858;41075;47.0;29.3
90;2021-06-19;450;170;66308;41245;47.3;29.4
90;2021-06-20;0;28;66308;41273;47.3;29.5
90;2021-06-21;256;1176;66564;42449;47.5;30.3
90;2021-06-22;384;950;66948;43399;47.8;31.0
90;2021-06-23;415;633;67363;44032;48.1;31.4
90;2021-06-24;317;599;67680;44631;48.3;31.8
90;2021-06-25;431;1270;68111;45901;48.6;32.8
90;2021-06-26;420;561;68531;46462;48.9;33.2
90;2021-06-27;2;6;68533;46468;48.9;33.2
90;2021-06-28;379;1298;68912;47766;49.2;34.1
90;2021-06-29;305;1305;69217;49071;49.4;35.0
90;2021-06-30;485;1227;69702;50298;49.7;35.9
90;2021-07-01;355;920;70057;51218;50.0;36.5
90;2021-07-02;506;1205;70563;52423;50.3;37.4
90;2021-07-03;52;129;70615;52552;50.4;37.5
90;2021-07-04;0;21;70615;52573;50.4;37.5
90;2021-07-05;400;1014;71015;53587;50.7;38.2
90;2021-07-06;514;971;71529;54558;51.0;38.9
90;2021-07-07;381;998;71910;55556;51.3;39.6
90;2021-07-08;304;607;72214;56163;51.5;40.1
90;2021-07-09;439;949;72653;57112;51.8;40.8
90;2021-07-10;32;91;72685;57203;51.9;40.8
90;2021-07-11;7;17;72692;57220;51.9;40.8
90;2021-07-12;246;1074;72938;58294;52.0;41.6
90;2021-07-13;474;1162;73412;59456;52.4;42.4
90;2021-07-14;4;9;73416;59465;52.4;42.4
90;2021-07-15;789;1455;74205;60920;52.9;43.5
90;2021-07-16;826;1681;75031;62601;53.5;44.7
90;2021-07-17;484;955;75515;63556;53.9;45.4
90;2021-07-18;4;2;75519;63558;53.9;45.4
90;2021-07-19;1186;1460;76705;65018;54.7;46.4
90;2021-07-20;1339;1135;78044;66153;55.7;47.2
90;2021-07-21;1395;983;79439;67136;56.7;47.9
90;2021-07-22;1127;697;80566;67833;57.5;48.4
90;2021-07-23;968;1020;81534;68853;58.2;49.1
90;2021-07-24;121;66;81655;68919;58.3;49.2
90;2021-07-25;2;1;81657;68920;58.3;49.2
90;2021-07-26;1072;801;82729;69721;59.0;49.7
90;2021-07-27;1081;746;83810;70467;59.8;50.3
90;2021-07-28;825;712;84635;71179;60.4;50.8
90;2021-07-29;843;441;85478;71620;61.0;51.1
90;2021-07-30;786;506;86264;72126;61.6;51.5
90;2021-07-31;484;313;86748;72439;61.9;51.7
90;2021-08-01;0;3;86748;72442;61.9;51.7
90;2021-08-02;850;510;87598;72952;62.5;52.1
90;2021-08-03;929;494;88527;73446;63.2;52.4
90;2021-08-04;1067;460;89594;73906;63.9;52.7
90;2021-08-05;521;223;90115;74129;64.3;52.9
90;2021-08-06;649;388;90764;74517;64.8;53.2
90;2021-08-07;36;63;90800;74580;64.8;53.2
90;2021-08-08;18;3;90818;74583;64.8;53.2
90;2021-08-09;730;947;91548;75530;65.3;53.9
90;2021-08-10;536;1152;92084;76682;65.7;54.7
90;2021-08-11;537;948;92621;77630;66.1;55.4
90;2021-08-12;449;820;93070;78450;66.4;56.0
90;2021-08-13;544;898;93614;79348;66.8;56.6
90;2021-08-14;30;98;93644;79446;66.8;56.7
90;2021-08-15;2;7;93646;79453;66.8;56.7
90;2021-08-16;451;632;94097;80085;67.1;57.1
90;2021-08-17;347;1167;94444;81252;67.4;58.0
90;2021-08-18;275;881;94719;82133;67.6;58.6
90;2021-08-19;248;627;94967;82760;67.8;59.1
90;2021-08-20;361;771;95328;83531;68.0;59.6
90;2021-08-21;32;71;95360;83602;68.0;59.7
90;2021-08-22;0;7;95360;83609;68.0;59.7
90;2021-08-23;319;489;95679;84098;68.3;60.0
90;2021-08-24;337;958;96016;85056;68.5;60.7
90;2021-08-25;253;915;96269;85971;68.7;61.3
90;2021-08-26;243;675;96512;86646;68.9;61.8
90;2021-08-27;271;737;96783;87383;69.1;62.4
90;2021-08-28;21;64;96804;87447;69.1;62.4
90;2021-08-29;3;6;96807;87453;69.1;62.4
90;2021-08-30;322;640;97129;88093;69.3;62.9
90;2021-08-31;276;1021;97405;89114;69.5;63.6
90;2021-09-01;267;787;97672;89901;69.7;64.1
90;2021-09-02;159;408;97831;90309;69.8;64.4
90;2021-09-03;222;533;98053;90842;70.0;64.8
90;2021-09-04;55;157;98108;90999;70.0;64.9
90;2021-09-05;10;25;98118;91024;70.0;64.9
90;2021-09-06;134;741;98252;91765;70.1;65.5
90;2021-09-07;220;675;98472;92440;70.3;66.0
90;2021-09-08;224;654;98696;93094;70.4;66.4
90;2021-09-09;189;320;98885;93414;70.6;66.7
90;2021-09-10;191;551;99076;93965;70.7;67.0
90;2021-09-11;12;12;99088;93977;70.7;67.1
90;2021-09-12;0;7;99088;93984;70.7;67.1
90;2021-09-13;211;513;99299;94497;70.9;67.4
90;2021-09-14;156;453;99455;94950;71.0;67.8
90;2021-09-15;182;393;99637;95343;71.1;68.0
90;2021-09-16;154;238;99791;95581;71.2;68.2
90;2021-09-17;183;340;99974;95921;71.3;68.4
90;2021-09-18;17;24;99991;95945;71.3;68.5
90;2021-09-19;7;4;99998;95949;71.4;68.5
90;2021-09-20;153;250;100151;96199;71.5;68.6
90;2021-09-21;105;247;100256;96446;71.5;68.8
90;2021-09-22;104;353;100360;96799;71.6;69.1
90;2021-09-23;80;137;100440;96936;71.7;69.2
90;2021-09-24;102;285;100542;97221;71.7;69.4
90;2021-09-25;16;31;100558;97252;71.8;69.4
90;2021-09-26;0;7;100558;97259;71.8;69.4
90;2021-09-27;93;199;100651;97458;71.8;69.5
90;2021-09-28;90;140;100741;97598;71.9;69.6
90;2021-09-29;79;236;100820;97834;71.9;69.8
90;2021-09-30;61;131;100881;97965;72.0;69.9
90;2021-10-01;112;232;100993;98197;72.1;70.1
90;2021-10-02;10;28;101003;98225;72.1;70.1
90;2021-10-03;0;11;101003;98236;72.1;70.1
91;2020-12-27;0;0;0;0;0.0;0.0
91;2020-12-28;0;0;0;0;0.0;0.0
91;2020-12-29;1;0;1;0;0.0;0.0
91;2020-12-30;1;0;2;0;0.0;0.0
91;2020-12-31;0;0;2;0;0.0;0.0
91;2021-01-01;5;0;7;0;0.0;0.0
91;2021-01-02;0;0;7;0;0.0;0.0
91;2021-01-03;0;0;7;0;0.0;0.0
91;2021-01-04;1;0;8;0;0.0;0.0
91;2021-01-05;71;0;79;0;0.0;0.0
91;2021-01-06;188;2;267;2;0.0;0.0
91;2021-01-07;522;6;789;8;0.1;0.0
91;2021-01-08;394;1;1183;9;0.1;0.0
91;2021-01-09;89;2;1272;11;0.1;0.0
91;2021-01-10;1;0;1273;11;0.1;0.0
91;2021-01-11;595;2;1868;13;0.1;0.0
91;2021-01-12;899;8;2767;21;0.2;0.0
91;2021-01-13;703;7;3470;28;0.3;0.0
91;2021-01-14;721;11;4191;39;0.3;0.0
91;2021-01-15;570;4;4761;43;0.4;0.0
91;2021-01-16;316;7;5077;50;0.4;0.0
91;2021-01-17;118;1;5195;51;0.4;0.0
91;2021-01-18;991;3;6186;54;0.5;0.0
91;2021-01-19;1876;13;8062;67;0.6;0.0
91;2021-01-20;2377;17;10439;84;0.8;0.0
91;2021-01-21;2109;16;12548;100;1.0;0.0
91;2021-01-22;1863;10;14411;110;1.1;0.0
91;2021-01-23;413;1;14824;111;1.1;0.0
91;2021-01-24;53;0;14877;111;1.1;0.0
91;2021-01-25;1049;3;15926;114;1.2;0.0
91;2021-01-26;1577;35;17503;149;1.3;0.0
91;2021-01-27;2423;90;19926;239;1.5;0.0
91;2021-01-28;1987;177;21913;416;1.7;0.0
91;2021-01-29;1748;60;23661;476;1.8;0.0
91;2021-01-30;422;6;24083;482;1.8;0.0
91;2021-01-31;54;0;24137;482;1.8;0.0
91;2021-02-01;965;213;25102;695;1.9;0.1
91;2021-02-02;859;346;25961;1041;2.0;0.1
91;2021-02-03;938;541;26899;1582;2.0;0.1
91;2021-02-04;885;267;27784;1849;2.1;0.1
91;2021-02-05;1037;330;28821;2179;2.2;0.2
91;2021-02-06;340;83;29161;2262;2.2;0.2
91;2021-02-07;14;0;29175;2262;2.2;0.2
91;2021-02-08;904;532;30079;2794;2.3;0.2
91;2021-02-09;963;700;31042;3494;2.4;0.3
91;2021-02-10;1065;935;32107;4429;2.4;0.3
91;2021-02-11;1124;939;33231;5368;2.5;0.4
91;2021-02-12;1064;744;34295;6112;2.6;0.5
91;2021-02-13;332;317;34627;6429;2.6;0.5
91;2021-02-14;18;102;34645;6531;2.6;0.5
91;2021-02-15;368;887;35013;7418;2.7;0.6
91;2021-02-16;555;1426;35568;8844;2.7;0.7
91;2021-02-17;814;2257;36382;11101;2.8;0.8
91;2021-02-18;942;1718;37324;12819;2.8;1.0
91;2021-02-19;872;1143;38196;13962;2.9;1.1
91;2021-02-20;168;256;38364;14218;2.9;1.1
91;2021-02-21;13;39;38377;14257;2.9;1.1
91;2021-02-22;335;896;38712;15153;2.9;1.1
91;2021-02-23;398;833;39110;15986;3.0;1.2
91;2021-02-24;473;819;39583;16805;3.0;1.3
91;2021-02-25;736;803;40319;17608;3.1;1.3
91;2021-02-26;1096;832;41415;18440;3.1;1.4
91;2021-02-27;612;244;42027;18684;3.2;1.4
91;2021-02-28;65;59;42092;18743;3.2;1.4
91;2021-03-01;932;846;43024;19589;3.3;1.5
91;2021-03-02;1260;919;44284;20508;3.4;1.6
91;2021-03-03;1467;1101;45751;21609;3.5;1.6
91;2021-03-04;2436;1005;48187;22614;3.7;1.7
91;2021-03-05;3354;993;51541;23607;3.9;1.8
91;2021-03-06;4913;409;56454;24016;4.3;1.8
91;2021-03-07;3208;119;59662;24135;4.5;1.8
91;2021-03-08;1473;913;61135;25048;4.6;1.9
91;2021-03-09;2625;884;63760;25932;4.8;2.0
91;2021-03-10;2627;957;66387;26889;5.0;2.0
91;2021-03-11;3786;1064;70173;27953;5.3;2.1
91;2021-03-12;4792;989;74965;28942;5.7;2.2
91;2021-03-13;5258;330;80223;29272;6.1;2.2
91;2021-03-14;304;28;80527;29300;6.1;2.2
91;2021-03-15;2986;427;83513;29727;6.3;2.3
91;2021-03-16;2617;376;86130;30103;6.5;2.3
91;2021-03-17;2227;341;88357;30444;6.7;2.3
91;2021-03-18;2394;407;90751;30851;6.9;2.3
91;2021-03-19;4093;383;94844;31234;7.2;2.4
91;2021-03-20;3608;182;98452;31416;7.5;2.4
91;2021-03-21;138;21;98590;31437;7.5;2.4
91;2021-03-22;3148;592;101738;32029;7.7;2.4
91;2021-03-23;4139;685;105877;32714;8.0;2.5
91;2021-03-24;3937;496;109814;33210;8.3;2.5
91;2021-03-25;5060;523;114874;33733;8.7;2.6
91;2021-03-26;5550;552;120424;34285;9.1;2.6
91;2021-03-27;4982;343;125406;34628;9.5;2.6
91;2021-03-28;282;57;125688;34685;9.5;2.6
91;2021-03-29;3305;1023;128993;35708;9.8;2.7
91;2021-03-30;4426;1214;133419;36922;10.1;2.8
91;2021-03-31;3368;1328;136787;38250;10.4;2.9
91;2021-04-01;3740;1684;140527;39934;10.7;3.0
91;2021-04-02;3887;2309;144414;42243;10.9;3.2
91;2021-04-03;1874;2856;146288;45099;11.1;3.4
91;2021-04-04;647;1319;146935;46418;11.1;3.5
91;2021-04-05;562;132;147497;46550;11.2;3.5
91;2021-04-06;3403;1779;150900;48329;11.4;3.7
91;2021-04-07;3420;1926;154320;50255;11.7;3.8
91;2021-04-08;4665;2154;158985;52409;12.0;4.0
91;2021-04-09;5349;2161;164334;54570;12.5;4.1
91;2021-04-10;2733;2808;167067;57378;12.7;4.3
91;2021-04-11;191;141;167258;57519;12.7;4.4
91;2021-04-12;2854;2278;170112;59797;12.9;4.5
91;2021-04-13;3758;2643;173870;62440;13.2;4.7
91;2021-04-14;3707;2319;177577;64759;13.5;4.9
91;2021-04-15;4475;2517;182052;67276;13.8;5.1
91;2021-04-16;4549;2801;186601;70077;14.1;5.3
91;2021-04-17;2983;2071;189584;72148;14.4;5.5
91;2021-04-18;269;73;189853;72221;14.4;5.5
91;2021-04-19;2306;2731;192159;74952;14.6;5.7
91;2021-04-20;3178;2978;195337;77930;14.8;5.9
91;2021-04-21;2990;2894;198327;80824;15.0;6.1
91;2021-04-22;3170;3363;201497;84187;15.3;6.4
91;2021-04-23;3717;3329;205214;87516;15.6;6.6
91;2021-04-24;3480;3732;208694;91248;15.8;6.9
91;2021-04-25;2618;643;211312;91891;16.0;7.0
91;2021-04-26;3486;2800;214798;94691;16.3;7.2
91;2021-04-27;4486;2921;219284;97612;16.6;7.4
91;2021-04-28;4569;2693;223853;100305;17.0;7.6
91;2021-04-29;5744;3056;229597;103361;17.4;7.8
91;2021-04-30;5385;2846;234982;106207;17.8;8.0
91;2021-05-01;3517;520;238499;106727;18.1;8.1
91;2021-05-02;628;131;239127;106858;18.1;8.1
91;2021-05-03;5201;2287;244328;109145;18.5;8.3
91;2021-05-04;5589;3170;249917;112315;18.9;8.5
91;2021-05-05;4851;2873;254768;115188;19.3;8.7
91;2021-05-06;5246;3373;260014;118561;19.7;9.0
91;2021-05-07;6122;3740;266136;122301;20.2;9.3
91;2021-05-08;6518;965;272654;123266;20.7;9.3
91;2021-05-09;4804;564;277458;123830;21.0;9.4
91;2021-05-10;5901;3001;283359;126831;21.5;9.6
91;2021-05-11;6826;3833;290185;130664;22.0;9.9
91;2021-05-12;5895;3441;296080;134105;22.4;10.2
91;2021-05-13;4825;1082;300905;135187;22.8;10.2
91;2021-05-14;6549;2395;307454;137582;23.3;10.4
91;2021-05-15;7792;1929;315246;139511;23.9;10.6
91;2021-05-16;4583;371;319829;139882;24.2;10.6
91;2021-05-17;6952;1703;326781;141585;24.8;10.7
91;2021-05-18;8120;1740;334901;143325;25.4;10.9
91;2021-05-19;7098;1694;341999;145019;25.9;11.0
91;2021-05-20;8200;2140;350199;147159;26.5;11.2
91;2021-05-21;8144;2580;358343;149739;27.2;11.3
91;2021-05-22;7660;1538;366003;151277;27.7;11.5
91;2021-05-23;4792;534;370795;151811;28.1;11.5
91;2021-05-24;5014;595;375809;152406;28.5;11.6
91;2021-05-25;7621;2652;383430;155058;29.1;11.8
91;2021-05-26;6874;2942;390304;158000;29.6;12.0
91;2021-05-27;7971;3438;398275;161438;30.2;12.2
91;2021-05-28;7534;4323;405809;165761;30.8;12.6
91;2021-05-29;9301;3499;415110;169260;31.5;12.8
91;2021-05-30;5948;963;421058;170223;31.9;12.9
91;2021-05-31;6738;3696;427796;173919;32.4;13.2
91;2021-06-01;7787;4764;435583;178683;33.0;13.5
91;2021-06-02;7454;3949;443037;182632;33.6;13.8
91;2021-06-03;7859;4777;450896;187409;34.2;14.2
91;2021-06-04;7193;5718;458089;193127;34.7;14.6
91;2021-06-05;6385;5819;464474;198946;35.2;15.1
91;2021-06-06;4087;2512;468561;201458;35.5;15.3
91;2021-06-07;5878;5478;474439;206936;36.0;15.7
91;2021-06-08;7038;5793;481477;212729;36.5;16.1
91;2021-06-09;6469;5139;487946;217868;37.0;16.5
91;2021-06-10;7177;5779;495123;223647;37.5;17.0
91;2021-06-11;6546;7109;501669;230756;38.0;17.5
91;2021-06-12;6218;7367;507887;238123;38.5;18.0
91;2021-06-13;2846;2314;510733;240437;38.7;18.2
91;2021-06-14;4225;7195;514958;247632;39.0;18.8
91;2021-06-15;5576;7260;520534;254892;39.5;19.3
91;2021-06-16;5297;6445;525831;261337;39.9;19.8
91;2021-06-17;6250;7130;532081;268467;40.3;20.3
91;2021-06-18;4629;8737;536710;277204;40.7;21.0
91;2021-06-19;4190;7153;540900;284357;41.0;21.6
91;2021-06-20;1007;4211;541907;288568;41.1;21.9
91;2021-06-21;3232;7237;545139;295805;41.3;22.4
91;2021-06-22;4157;9229;549296;305034;41.6;23.1
91;2021-06-23;4315;7957;553611;312991;42.0;23.7
91;2021-06-24;4912;8482;558523;321473;42.3;24.4
91;2021-06-25;3477;9166;562000;330639;42.6;25.1
91;2021-06-26;2989;8032;564989;338671;42.8;25.7
91;2021-06-27;550;2996;565539;341667;42.9;25.9
91;2021-06-28;3129;8237;568668;349904;43.1;26.5
91;2021-06-29;3588;9632;572256;359536;43.4;27.2
91;2021-06-30;3954;8700;576210;368236;43.7;27.9
91;2021-07-01;4100;8870;580310;377106;44.0;28.6
91;2021-07-02;3774;9316;584084;386422;44.3;29.3
91;2021-07-03;2880;9789;586964;396211;44.5;30.0
91;2021-07-04;852;4725;587816;400936;44.6;30.4
91;2021-07-05;2662;7257;590478;408193;44.8;30.9
91;2021-07-06;3758;9430;594236;417623;45.0;31.7
91;2021-07-07;3806;8591;598042;426214;45.3;32.3
91;2021-07-08;4359;8990;602401;435204;45.7;33.0
91;2021-07-09;3968;9950;606369;445154;46.0;33.7
91;2021-07-10;3397;10236;609766;455390;46.2;34.5
91;2021-07-11;987;4804;610753;460194;46.3;34.9
91;2021-07-12;2803;8887;613556;469081;46.5;35.6
91;2021-07-13;4467;10391;618023;479472;46.8;36.3
91;2021-07-14;2303;3585;620326;483057;47.0;36.6
91;2021-07-15;4537;9824;624863;492881;47.4;37.4
91;2021-07-16;6287;9766;631150;502647;47.8;38.1
91;2021-07-17;5749;9067;636899;511714;48.3;38.8
91;2021-07-18;3402;3685;640301;515399;48.5;39.1
91;2021-07-19;3777;7535;644078;522934;48.8;39.6
91;2021-07-20;6074;9309;650152;532243;49.3;40.3
91;2021-07-21;6250;7733;656402;539976;49.8;40.9
91;2021-07-22;6498;8400;662900;548376;50.2;41.6
91;2021-07-23;6926;8286;669826;556662;50.8;42.2
91;2021-07-24;5013;6476;674839;563138;51.1;42.7
91;2021-07-25;3267;1408;678106;564546;51.4;42.8
91;2021-07-26;4934;6592;683040;571138;51.8;43.3
91;2021-07-27;7566;7082;690606;578220;52.3;43.8
91;2021-07-28;7366;5924;697972;584144;52.9;44.3
91;2021-07-29;7397;5912;705369;590056;53.5;44.7
91;2021-07-30;6913;5784;712282;595840;54.0;45.2
91;2021-07-31;4910;4790;717192;600630;54.4;45.5
91;2021-08-01;2659;1338;719851;601968;54.6;45.6
91;2021-08-02;4774;4235;724625;606203;54.9;45.9
91;2021-08-03;5891;4693;730516;610896;55.4;46.3
91;2021-08-04;5700;4140;736216;615036;55.8;46.6
91;2021-08-05;5605;4271;741821;619307;56.2;46.9
91;2021-08-06;5710;5626;747531;624933;56.7;47.4
91;2021-08-07;3084;2419;750615;627352;56.9;47.5
91;2021-08-08;622;1102;751237;628454;56.9;47.6
91;2021-08-09;3834;3976;755071;632430;57.2;47.9
91;2021-08-10;4650;4554;759721;636984;57.6;48.3
91;2021-08-11;4151;4486;763872;641470;57.9;48.6
91;2021-08-12;4088;4784;767960;646254;58.2;49.0
91;2021-08-13;4301;4865;772261;651119;58.5;49.3
91;2021-08-14;2246;2402;774507;653521;58.7;49.5
91;2021-08-15;95;171;774602;653692;58.7;49.5
91;2021-08-16;3093;4661;777695;658353;58.9;49.9
91;2021-08-17;3652;5819;781347;664172;59.2;50.3
91;2021-08-18;3029;5797;784376;669969;59.4;50.8
91;2021-08-19;3480;5773;787856;675742;59.7;51.2
91;2021-08-20;3217;6957;791073;682699;60.0;51.7
91;2021-08-21;2464;3354;793537;686053;60.1;52.0
91;2021-08-22;738;1297;794275;687350;60.2;52.1
91;2021-08-23;2426;5311;796701;692661;60.4;52.5
91;2021-08-24;2987;6961;799688;699622;60.6;53.0
91;2021-08-25;3435;6723;803123;706345;60.9;53.5
91;2021-08-26;2749;5952;805872;712297;61.1;54.0
91;2021-08-27;2837;7503;808709;719800;61.3;54.6
91;2021-08-28;2388;4836;811097;724636;61.5;54.9
91;2021-08-29;1776;2798;812873;727434;61.6;55.1
91;2021-08-30;1802;5610;814675;733044;61.7;55.6
91;2021-08-31;2257;6098;816932;739142;61.9;56.0
91;2021-09-01;2441;4610;819373;743752;62.1;56.4
91;2021-09-02;1909;3900;821282;747652;62.2;56.7
91;2021-09-03;2164;4975;823446;752627;62.4;57.0
91;2021-09-04;2075;4235;825521;756862;62.6;57.4
91;2021-09-05;747;944;826268;757806;62.6;57.4
91;2021-09-06;1663;3506;827931;761312;62.8;57.7
91;2021-09-07;1551;3287;829482;764599;62.9;58.0
91;2021-09-08;1784;3553;831266;768152;63.0;58.2
91;2021-09-09;1301;3363;832567;771515;63.1;58.5
91;2021-09-10;1788;4034;834355;775549;63.2;58.8
91;2021-09-11;1740;4476;836095;780025;63.4;59.1
91;2021-09-12;626;1035;836721;781060;63.4;59.2
91;2021-09-13;1262;2909;837983;783969;63.5;59.4
91;2021-09-14;1791;3500;839774;787469;63.6;59.7
91;2021-09-15;1616;3286;841390;790755;63.8;59.9
91;2021-09-16;1471;2383;842861;793138;63.9;60.1
91;2021-09-17;1435;2996;844296;796134;64.0;60.3
91;2021-09-18;1384;3666;845680;799800;64.1;60.6
91;2021-09-19;455;1147;846135;800947;64.1;60.7
91;2021-09-20;751;1597;846886;802544;64.2;60.8
91;2021-09-21;881;1746;847767;804290;64.3;61.0
91;2021-09-22;925;2640;848692;806930;64.3;61.2
91;2021-09-23;923;1732;849615;808662;64.4;61.3
91;2021-09-24;894;2196;850509;810858;64.5;61.5
91;2021-09-25;1051;3482;851560;814340;64.5;61.7
91;2021-09-26;219;821;851779;815161;64.6;61.8
91;2021-09-27;724;1568;852503;816729;64.6;61.9
91;2021-09-28;897;1440;853400;818169;64.7;62.0
91;2021-09-29;1012;2225;854412;820394;64.8;62.2
91;2021-09-30;656;1129;855068;821523;64.8;62.3
91;2021-10-01;961;1868;856029;823391;64.9;62.4
91;2021-10-02;1106;2384;857135;825775;65.0;62.6
91;2021-10-03;266;613;857401;826388;65.0;62.6
92;2020-12-27;42;0;42;0;0.0;0.0
92;2020-12-28;29;0;71;0;0.0;0.0
92;2020-12-29;65;0;136;0;0.0;0.0
92;2020-12-30;52;0;188;0;0.0;0.0
92;2020-12-31;13;0;201;0;0.0;0.0
92;2021-01-01;37;0;238;0;0.0;0.0
92;2021-01-02;14;0;252;0;0.0;0.0
92;2021-01-03;19;0;271;0;0.0;0.0
92;2021-01-04;78;1;349;1;0.0;0.0
92;2021-01-05;236;1;585;2;0.0;0.0
92;2021-01-06;419;3;1004;5;0.1;0.0
92;2021-01-07;674;4;1678;9;0.1;0.0
92;2021-01-08;850;4;2528;13;0.2;0.0
92;2021-01-09;130;1;2658;14;0.2;0.0
92;2021-01-10;51;0;2709;14;0.2;0.0
92;2021-01-11;853;5;3562;19;0.2;0.0
92;2021-01-12;1307;9;4869;28;0.3;0.0
92;2021-01-13;1252;13;6121;41;0.4;0.0
92;2021-01-14;1238;16;7359;57;0.5;0.0
92;2021-01-15;986;7;8345;64;0.5;0.0
92;2021-01-16;185;1;8530;65;0.5;0.0
92;2021-01-17;30;0;8560;65;0.5;0.0
92;2021-01-18;1555;20;10115;85;0.6;0.0
92;2021-01-19;1575;20;11690;105;0.7;0.0
92;2021-01-20;1823;11;13513;116;0.8;0.0
92;2021-01-21;3455;21;16968;137;1.1;0.0
92;2021-01-22;2624;40;19592;177;1.2;0.0
92;2021-01-23;153;0;19745;177;1.2;0.0
92;2021-01-24;33;0;19778;177;1.2;0.0
92;2021-01-25;861;13;20639;190;1.3;0.0
92;2021-01-26;1220;10;21859;200;1.4;0.0
92;2021-01-27;2226;90;24085;290;1.5;0.0
92;2021-01-28;4201;175;28286;465;1.8;0.0
92;2021-01-29;2720;232;31006;697;1.9;0.0
92;2021-01-30;326;11;31332;708;1.9;0.0
92;2021-01-31;35;1;31367;709;1.9;0.0
92;2021-02-01;876;290;32243;999;2.0;0.1
92;2021-02-02;1070;320;33313;1319;2.1;0.1
92;2021-02-03;1006;412;34319;1731;2.1;0.1
92;2021-02-04;1056;485;35375;2216;2.2;0.1
92;2021-02-05;1336;457;36711;2673;2.3;0.2
92;2021-02-06;127;18;36838;2691;2.3;0.2
92;2021-02-07;23;13;36861;2704;2.3;0.2
92;2021-02-08;587;625;37448;3329;2.3;0.2
92;2021-02-09;1072;1146;38520;4475;2.4;0.3
92;2021-02-10;1093;1190;39613;5665;2.5;0.4
92;2021-02-11;1518;1690;41131;7355;2.5;0.5
92;2021-02-12;1424;1372;42555;8727;2.6;0.5
92;2021-02-13;80;58;42635;8785;2.6;0.5
92;2021-02-14;30;0;42665;8785;2.6;0.5
92;2021-02-15;584;1227;43249;10012;2.7;0.6
92;2021-02-16;793;1610;44042;11622;2.7;0.7
92;2021-02-17;627;1475;44669;13097;2.8;0.8
92;2021-02-18;1582;2918;46251;16015;2.9;1.0
92;2021-02-19;1735;2270;47986;18285;3.0;1.1
92;2021-02-20;148;337;48134;18622;3.0;1.2
92;2021-02-21;47;49;48181;18671;3.0;1.2
92;2021-02-22;505;964;48686;19635;3.0;1.2
92;2021-02-23;743;1069;49429;20704;3.1;1.3
92;2021-02-24;616;1017;50045;21721;3.1;1.3
92;2021-02-25;931;1422;50976;23143;3.2;1.4
92;2021-02-26;1467;1119;52443;24262;3.2;1.5
92;2021-02-27;507;167;52950;24429;3.3;1.5
92;2021-02-28;75;44;53025;24473;3.3;1.5
92;2021-03-01;1105;813;54130;25286;3.4;1.6
92;2021-03-02;1985;1081;56115;26367;3.5;1.6
92;2021-03-03;2809;898;58924;27265;3.7;1.7
92;2021-03-04;3605;1268;62529;28533;3.9;1.8
92;2021-03-05;4985;1452;67514;29985;4.2;1.9
92;2021-03-06;5725;322;73239;30307;4.5;1.9
92;2021-03-07;2908;228;76147;30535;4.7;1.9
92;2021-03-08;2431;691;78578;31226;4.9;1.9
92;2021-03-09;3449;873;82027;32099;5.1;2.0
92;2021-03-10;3952;873;85979;32972;5.3;2.0
92;2021-03-11;5025;1296;91004;34268;5.6;2.1
92;2021-03-12;6778;1471;97782;35739;6.1;2.2
92;2021-03-13;5163;236;102945;35975;6.4;2.2
92;2021-03-14;1746;76;104691;36051;6.5;2.2
92;2021-03-15;3808;587;108499;36638;6.7;2.3
92;2021-03-16;3699;562;112198;37200;7.0;2.3
92;2021-03-17;3880;417;116078;37617;7.2;2.3
92;2021-03-18;4147;737;120225;38354;7.4;2.4
92;2021-03-19;5934;718;126159;39072;7.8;2.4
92;2021-03-20;2542;76;128701;39148;8.0;2.4
92;2021-03-21;156;29;128857;39177;8.0;2.4
92;2021-03-22;4119;475;132976;39652;8.2;2.5
92;2021-03-23;6110;862;139086;40514;8.6;2.5
92;2021-03-24;6385;657;145471;41171;9.0;2.6
92;2021-03-25;8445;644;153916;41815;9.5;2.6
92;2021-03-26;8361;892;162277;42707;10.1;2.6
92;2021-03-27;2838;282;165115;42989;10.2;2.7
92;2021-03-28;543;39;165658;43028;10.3;2.7
92;2021-03-29;4670;1055;170328;44083;10.6;2.7
92;2021-03-30;6395;1544;176723;45627;11.0;2.8
92;2021-03-31;5556;2233;182279;47860;11.3;3.0
92;2021-04-01;6277;3661;188556;51521;11.7;3.2
92;2021-04-02;5639;3412;194195;54933;12.0;3.4
92;2021-04-03;877;1409;195072;56342;12.1;3.5
92;2021-04-04;492;1053;195564;57395;12.1;3.6
92;2021-04-05;817;158;196381;57553;12.2;3.6
92;2021-04-06;3666;1945;200047;59498;12.4;3.7
92;2021-04-07;5004;2887;205051;62385;12.7;3.9
92;2021-04-08;5992;3183;211043;65568;13.1;4.1
92;2021-04-09;8035;3047;219078;68615;13.6;4.3
92;2021-04-10;2642;1290;221720;69905;13.7;4.3
92;2021-04-11;167;805;221887;70710;13.7;4.4
92;2021-04-12;3688;2511;225575;73221;14.0;4.5
92;2021-04-13;4387;4421;229962;77642;14.3;4.8
92;2021-04-14;4876;4037;234838;81679;14.6;5.1
92;2021-04-15;5302;3951;240140;85630;14.9;5.3
92;2021-04-16;5078;3855;245218;89485;15.2;5.5
92;2021-04-17;1807;1188;247025;90673;15.3;5.6
92;2021-04-18;351;94;247376;90767;15.3;5.6
92;2021-04-19;2819;2842;250195;93609;15.5;5.8
92;2021-04-20;4199;3757;254394;97366;15.8;6.0
92;2021-04-21;4617;4514;259011;101880;16.1;6.3
92;2021-04-22;4662;5121;263673;107001;16.3;6.6
92;2021-04-23;5257;4703;268930;111704;16.7;6.9
92;2021-04-24;4942;1902;273872;113606;17.0;7.0
92;2021-04-25;1794;148;275666;113754;17.1;7.0
92;2021-04-26;4002;3617;279668;117371;17.3;7.3
92;2021-04-27;6048;5253;285716;122624;17.7;7.6
92;2021-04-28;7385;4490;293101;127114;18.2;7.9
92;2021-04-29;7992;4767;301093;131881;18.7;8.2
92;2021-04-30;8847;4839;309940;136720;19.2;8.5
92;2021-05-01;1201;405;311141;137125;19.3;8.5
92;2021-05-02;667;139;311808;137264;19.3;8.5
92;2021-05-03;6786;3879;318594;141143;19.7;8.7
92;2021-05-04;10432;4355;329026;145498;20.4;9.0
92;2021-05-05;10075;5243;339101;150741;21.0;9.3
92;2021-05-06;11427;4897;350528;155638;21.7;9.6
92;2021-05-07;9869;5293;360397;160931;22.3;10.0
92;2021-05-08;7215;1921;367612;162852;22.8;10.1
92;2021-05-09;3786;600;371398;163452;23.0;10.1
92;2021-05-10;9547;3995;380945;167447;23.6;10.4
92;2021-05-11;13978;5682;394923;173129;24.5;10.7
92;2021-05-12;14286;4577;409209;177706;25.4;11.0
92;2021-05-13;9167;903;418376;178609;25.9;11.1
92;2021-05-14;12029;2303;430405;180912;26.7;11.2
92;2021-05-15;8392;1226;438797;182138;27.2;11.3
92;2021-05-16;4142;453;442939;182591;27.4;11.3
92;2021-05-17;10649;2216;453588;184807;28.1;11.5
92;2021-05-18;16411;3118;469999;187925;29.1;11.6
92;2021-05-19;16044;3715;486043;191640;30.1;11.9
92;2021-05-20;16840;3981;502883;195621;31.2;12.1
92;2021-05-21;14071;3612;516954;199233;32.0;12.3
92;2021-05-22;8318;1512;525272;200745;32.5;12.4
92;2021-05-23;4082;454;529354;201199;32.8;12.5
92;2021-05-24;6120;855;535474;202054;33.2;12.5
92;2021-05-25;13110;4563;548584;206617;34.0;12.8
92;2021-05-26;11923;5036;560507;211653;34.7;13.1
92;2021-05-27;12735;6324;573242;217977;35.5;13.5
92;2021-05-28;11233;6277;584475;224254;36.2;13.9
92;2021-05-29;5451;2304;589926;226558;36.6;14.0
92;2021-05-30;2252;389;592178;226947;36.7;14.1
92;2021-05-31;12049;5296;604227;232243;37.4;14.4
92;2021-06-01;12633;7634;616860;239877;38.2;14.9
92;2021-06-02;14378;7203;631238;247080;39.1;15.3
92;2021-06-03;14598;8022;645836;255102;40.0;15.8
92;2021-06-04;12234;8219;658070;263321;40.8;16.3
92;2021-06-05;7383;6229;665453;269550;41.2;16.7
92;2021-06-06;3597;1675;669050;271225;41.5;16.8
92;2021-06-07;11434;7635;680484;278860;42.2;17.3
92;2021-06-08;12764;9603;693248;288463;43.0;17.9
92;2021-06-09;11660;9474;704908;297937;43.7;18.5
92;2021-06-10;11967;10564;716875;308501;44.4;19.1
92;2021-06-11;8154;11033;725029;319534;44.9;19.8
92;2021-06-12;6364;5091;731393;324625;45.3;20.1
92;2021-06-13;3969;2720;735362;327345;45.6;20.3
92;2021-06-14;5211;11170;740573;338515;45.9;21.0
92;2021-06-15;6536;13122;747109;351637;46.3;21.8
92;2021-06-16;6952;12991;754061;364628;46.7;22.6
92;2021-06-17;7429;14000;761490;378628;47.2;23.5
92;2021-06-18;6906;14385;768396;393013;47.6;24.4
92;2021-06-19;3965;9106;772361;402119;47.9;24.9
92;2021-06-20;1968;5606;774329;407725;48.0;25.3
92;2021-06-21;4839;12274;779168;419999;48.3;26.0
92;2021-06-22;5878;17536;785046;437535;48.6;27.1
92;2021-06-23;5483;15990;790529;453525;49.0;28.1
92;2021-06-24;6208;15119;796737;468644;49.4;29.0
92;2021-06-25;5120;16097;801857;484741;49.7;30.0
92;2021-06-26;4070;10454;805927;495195;49.9;30.7
92;2021-06-27;1858;6046;807785;501241;50.1;31.1
92;2021-06-28;3673;12047;811458;513288;50.3;31.8
92;2021-06-29;4679;18154;816137;531442;50.6;32.9
92;2021-06-30;4455;16226;820592;547668;50.8;33.9
92;2021-07-01;5527;16305;826119;563973;51.2;34.9
92;2021-07-02;4941;15278;831060;579251;51.5;35.9
92;2021-07-03;3305;10185;834365;589436;51.7;36.5
92;2021-07-04;1124;4208;835489;593644;51.8;36.8
92;2021-07-05;4825;12330;840314;605974;52.1;37.6
92;2021-07-06;5287;15811;845601;621785;52.4;38.5
92;2021-07-07;4267;11461;849868;633246;52.7;39.2
92;2021-07-08;5408;14637;855276;647883;53.0;40.1
92;2021-07-09;5900;14204;861176;662087;53.4;41.0
92;2021-07-10;4378;8457;865554;670544;53.6;41.6
92;2021-07-11;1487;2615;867041;673159;53.7;41.7
92;2021-07-12;4416;14642;871457;687801;54.0;42.6
92;2021-07-13;7882;17455;879339;705256;54.5;43.7
92;2021-07-14;5113;5745;884452;711001;54.8;44.1
92;2021-07-15;9570;16255;894022;727256;55.4;45.1
92;2021-07-16;9066;14187;903088;741443;56.0;45.9
92;2021-07-17;6581;7603;909669;749046;56.4;46.4
92;2021-07-18;1841;2482;911510;751528;56.5;46.6
92;2021-07-19;6480;13198;917990;764726;56.9;47.4
92;2021-07-20;10091;14105;928081;778831;57.5;48.3
92;2021-07-21;10466;12121;938547;790952;58.2;49.0
92;2021-07-22;12058;12993;950605;803945;58.9;49.8
92;2021-07-23;11590;11356;962195;815301;59.6;50.5
92;2021-07-24;6733;6267;968928;821568;60.0;50.9
92;2021-07-25;2778;2329;971706;823897;60.2;51.1
92;2021-07-26;9491;9180;981197;833077;60.8;51.6
92;2021-07-27;11521;9619;992718;842696;61.5;52.2
92;2021-07-28;12950;8206;1005668;850902;62.3;52.7
92;2021-07-29;10452;8636;1016120;859538;63.0;53.3
92;2021-07-30;9131;8359;1025251;867897;63.5;53.8
92;2021-07-31;5702;4823;1030953;872720;63.9;54.1
92;2021-08-01;2217;1300;1033170;874020;64.0;54.2
92;2021-08-02;4685;4934;1037855;878954;64.3;54.5
92;2021-08-03;5143;6147;1042998;885101;64.6;54.8
92;2021-08-04;4774;4874;1047772;889975;64.9;55.1
92;2021-08-05;4527;5689;1052299;895664;65.2;55.5
92;2021-08-06;4549;5973;1056848;901637;65.5;55.9
92;2021-08-07;2836;4182;1059684;905819;65.7;56.1
92;2021-08-08;963;1082;1060647;906901;65.7;56.2
92;2021-08-09;3212;4252;1063859;911153;65.9;56.5
92;2021-08-10;3835;5614;1067694;916767;66.2;56.8
92;2021-08-11;3239;4436;1070933;921203;66.4;57.1
92;2021-08-12;3395;5602;1074328;926805;66.6;57.4
92;2021-08-13;2995;5148;1077323;931953;66.8;57.8
92;2021-08-14;1886;3930;1079209;935883;66.9;58.0
92;2021-08-15;588;839;1079797;936722;66.9;58.0
92;2021-08-16;2403;5326;1082200;942048;67.1;58.4
92;2021-08-17;2634;6990;1084834;949038;67.2;58.8
92;2021-08-18;2427;5256;1087261;954294;67.4;59.1
92;2021-08-19;2524;5746;1089785;960040;67.5;59.5
92;2021-08-20;2278;5198;1092063;965238;67.7;59.8
92;2021-08-21;1391;4222;1093454;969460;67.8;60.1
92;2021-08-22;428;1599;1093882;971059;67.8;60.2
92;2021-08-23;2496;6600;1096378;977659;67.9;60.6
92;2021-08-24;3153;8349;1099531;986008;68.1;61.1
92;2021-08-25;2861;7583;1102392;993591;68.3;61.6
92;2021-08-26;3013;7577;1105405;1001168;68.5;62.0
92;2021-08-27;3093;7013;1108498;1008181;68.7;62.5
92;2021-08-28;1615;4517;1110113;1012698;68.8;62.8
92;2021-08-29;345;789;1110458;1013487;68.8;62.8
92;2021-08-30;2248;4900;1112706;1018387;69.0;63.1
92;2021-08-31;3091;7043;1115797;1025430;69.1;63.5
92;2021-09-01;3317;7607;1119114;1033037;69.3;64.0
92;2021-09-02;2650;6830;1121764;1039867;69.5;64.4
92;2021-09-03;2674;6598;1124438;1046465;69.7;64.8
92;2021-09-04;2216;5056;1126654;1051521;69.8;65.2
92;2021-09-05;445;1051;1127099;1052572;69.8;65.2
92;2021-09-06;1313;3705;1128412;1056277;69.9;65.5
92;2021-09-07;1699;4196;1130111;1060473;70.0;65.7
92;2021-09-08;2176;4318;1132287;1064791;70.2;66.0
92;2021-09-09;1227;3274;1133514;1068065;70.2;66.2
92;2021-09-10;1781;4250;1135295;1072315;70.4;66.4
92;2021-09-11;1556;2942;1136851;1075257;70.4;66.6
92;2021-09-12;209;466;1137060;1075723;70.5;66.7
92;2021-09-13;1100;3091;1138160;1078814;70.5;66.9
92;2021-09-14;1227;3593;1139387;1082407;70.6;67.1
92;2021-09-15;1580;3628;1140967;1086035;70.7;67.3
92;2021-09-16;1078;2157;1142045;1088192;70.8;67.4
92;2021-09-17;1430;3096;1143475;1091288;70.9;67.6
92;2021-09-18;930;2232;1144405;1093520;70.9;67.8
92;2021-09-19;128;291;1144533;1093811;70.9;67.8
92;2021-09-20;773;1831;1145306;1095642;71.0;67.9
92;2021-09-21;779;1867;1146085;1097509;71.0;68.0
92;2021-09-22;1075;3814;1147160;1101323;71.1;68.2
92;2021-09-23;734;1820;1147894;1103143;71.1;68.4
92;2021-09-24;1093;2848;1148987;1105991;71.2;68.5
92;2021-09-25;615;2206;1149602;1108197;71.2;68.7
92;2021-09-26;95;249;1149697;1108446;71.2;68.7
92;2021-09-27;768;1623;1150465;1110069;71.3;68.8
92;2021-09-28;781;1568;1151246;1111637;71.3;68.9
92;2021-09-29;1132;2834;1152378;1114471;71.4;69.1
92;2021-09-30;846;1323;1153224;1115794;71.5;69.1
92;2021-10-01;1121;2091;1154345;1117885;71.5;69.3
92;2021-10-02;792;1797;1155137;1119682;71.6;69.4
92;2021-10-03;87;203;1155224;1119885;71.6;69.4
93;2020-12-27;12;3;12;3;0.0;0.0
93;2020-12-28;6;0;18;3;0.0;0.0
93;2020-12-29;2;0;20;3;0.0;0.0
93;2020-12-30;44;1;64;4;0.0;0.0
93;2020-12-31;11;0;75;4;0.0;0.0
93;2021-01-01;5;0;80;4;0.0;0.0
93;2021-01-02;1;0;81;4;0.0;0.0
93;2021-01-03;4;0;85;4;0.0;0.0
93;2021-01-04;3;0;88;4;0.0;0.0
93;2021-01-05;66;1;154;5;0.0;0.0
93;2021-01-06;179;0;333;5;0.0;0.0
93;2021-01-07;381;1;714;6;0.0;0.0
93;2021-01-08;632;1;1346;7;0.1;0.0
93;2021-01-09;21;0;1367;7;0.1;0.0
93;2021-01-10;2;0;1369;7;0.1;0.0
93;2021-01-11;505;3;1874;10;0.1;0.0
93;2021-01-12;753;7;2627;17;0.2;0.0
93;2021-01-13;751;6;3378;23;0.2;0.0
93;2021-01-14;689;18;4067;41;0.2;0.0
93;2021-01-15;515;3;4582;44;0.3;0.0
93;2021-01-16;138;3;4720;47;0.3;0.0
93;2021-01-17;6;1;4726;48;0.3;0.0
93;2021-01-18;1198;11;5924;59;0.4;0.0
93;2021-01-19;1614;17;7538;76;0.5;0.0
93;2021-01-20;1557;18;9095;94;0.5;0.0
93;2021-01-21;1921;35;11016;129;0.7;0.0
93;2021-01-22;1391;14;12407;143;0.7;0.0
93;2021-01-23;713;4;13120;147;0.8;0.0
93;2021-01-24;0;0;13120;147;0.8;0.0
93;2021-01-25;1208;13;14328;160;0.9;0.0
93;2021-01-26;1295;28;15623;188;0.9;0.0
93;2021-01-27;2158;63;17781;251;1.1;0.0
93;2021-01-28;2267;172;20048;423;1.2;0.0
93;2021-01-29;1625;206;21673;629;1.3;0.0
93;2021-01-30;927;36;22600;665;1.4;0.0
93;2021-01-31;9;5;22609;670;1.4;0.0
93;2021-02-01;1186;146;23795;816;1.4;0.0
93;2021-02-02;1172;283;24967;1099;1.5;0.1
93;2021-02-03;1230;389;26197;1488;1.6;0.1
93;2021-02-04;926;538;27123;2026;1.6;0.1
93;2021-02-05;800;396;27923;2422;1.7;0.1
93;2021-02-06;694;65;28617;2487;1.7;0.1
93;2021-02-07;6;0;28623;2487;1.7;0.1
93;2021-02-08;913;546;29536;3033;1.8;0.2
93;2021-02-09;851;552;30387;3585;1.8;0.2
93;2021-02-10;882;616;31269;4201;1.9;0.3
93;2021-02-11;1244;719;32513;4920;1.9;0.3
93;2021-02-12;1041;565;33554;5485;2.0;0.3
93;2021-02-13;395;209;33949;5694;2.0;0.3
93;2021-02-14;13;58;33962;5752;2.0;0.3
93;2021-02-15;414;907;34376;6659;2.1;0.4
93;2021-02-16;552;989;34928;7648;2.1;0.5
93;2021-02-17;542;1326;35470;8974;2.1;0.5
93;2021-02-18;1135;1630;36605;10604;2.2;0.6
93;2021-02-19;993;1290;37598;11894;2.3;0.7
93;2021-02-20;304;529;37902;12423;2.3;0.7
93;2021-02-21;10;24;37912;12447;2.3;0.7
93;2021-02-22;602;985;38514;13432;2.3;0.8
93;2021-02-23;561;873;39075;14305;2.3;0.9
93;2021-02-24;643;959;39718;15264;2.4;0.9
93;2021-02-25;901;863;40619;16127;2.4;1.0
93;2021-02-26;1121;819;41740;16946;2.5;1.0
93;2021-02-27;543;515;42283;17461;2.5;1.0
93;2021-02-28;88;57;42371;17518;2.5;1.0
93;2021-03-01;1083;854;43454;18372;2.6;1.1
93;2021-03-02;1447;949;44901;19321;2.7;1.2
93;2021-03-03;1747;1017;46648;20338;2.8;1.2
93;2021-03-04;2717;1020;49365;21358;3.0;1.3
93;2021-03-05;3822;802;53187;22160;3.2;1.3
93;2021-03-06;5050;526;58237;22686;3.5;1.4
93;2021-03-07;4299;238;62536;22924;3.7;1.4
93;2021-03-08;2036;1118;64572;24042;3.9;1.4
93;2021-03-09;2915;885;67487;24927;4.0;1.5
93;2021-03-10;2860;1032;70347;25959;4.2;1.6
93;2021-03-11;3575;1185;73922;27144;4.4;1.6
93;2021-03-12;4124;1247;78046;28391;4.7;1.7
93;2021-03-13;4290;611;82336;29002;4.9;1.7
93;2021-03-14;884;70;83220;29072;5.0;1.7
93;2021-03-15;3556;659;86776;29731;5.2;1.8
93;2021-03-16;3159;606;89935;30337;5.4;1.8
93;2021-03-17;2656;597;92591;30934;5.5;1.9
93;2021-03-18;3316;716;95907;31650;5.7;1.9
93;2021-03-19;3767;633;99674;32283;6.0;1.9
93;2021-03-20;3459;299;103133;32582;6.2;2.0
93;2021-03-21;813;266;103946;32848;6.2;2.0
93;2021-03-22;3852;617;107798;33465;6.5;2.0
93;2021-03-23;4767;809;112565;34274;6.7;2.1
93;2021-03-24;4114;685;116679;34959;7.0;2.1
93;2021-03-25;5586;870;122265;35829;7.3;2.1
93;2021-03-26;5547;893;127812;36722;7.7;2.2
93;2021-03-27;4283;322;132095;37044;7.9;2.2
93;2021-03-28;613;42;132708;37086;7.9;2.2
93;2021-03-29;3851;964;136559;38050;8.2;2.3
93;2021-03-30;4726;1269;141285;39319;8.5;2.4
93;2021-03-31;3914;1249;145199;40568;8.7;2.4
93;2021-04-01;4055;3140;149254;43708;8.9;2.6
93;2021-04-02;3224;3552;152478;47260;9.1;2.8
93;2021-04-03;2518;2258;154996;49518;9.3;3.0
93;2021-04-04;764;161;155760;49679;9.3;3.0
93;2021-04-05;708;87;156468;49766;9.4;3.0
93;2021-04-06;4563;2353;161031;52119;9.6;3.1
93;2021-04-07;4903;2093;165934;54212;9.9;3.2
93;2021-04-08;5814;2684;171748;56896;10.3;3.4
93;2021-04-09;6096;3178;177844;60074;10.6;3.6
93;2021-04-10;4198;2484;182042;62558;10.9;3.7
93;2021-04-11;575;434;182617;62992;10.9;3.8
93;2021-04-12;4100;2914;186717;65906;11.2;3.9
93;2021-04-13;4606;3651;191323;69557;11.5;4.2
93;2021-04-14;4366;2477;195689;72034;11.7;4.3
93;2021-04-15;4559;3036;200248;75070;12.0;4.5
93;2021-04-16;4442;2991;204690;78061;12.3;4.7
93;2021-04-17;3517;2500;208207;80561;12.5;4.8
93;2021-04-18;289;433;208496;80994;12.5;4.8
93;2021-04-19;3776;2864;212272;83858;12.7;5.0
93;2021-04-20;4308;3262;216580;87120;13.0;5.2
93;2021-04-21;4145;2770;220725;89890;13.2;5.4
93;2021-04-22;4513;4022;225238;93912;13.5;5.6
93;2021-04-23;5627;3244;230865;97156;13.8;5.8
93;2021-04-24;5921;3328;236786;100484;14.2;6.0
93;2021-04-25;1733;598;238519;101082;14.3;6.1
93;2021-04-26;4864;3076;243383;104158;14.6;6.2
93;2021-04-27;6453;3623;249836;107781;15.0;6.5
93;2021-04-28;6071;3431;255907;111212;15.3;6.7
93;2021-04-29;7301;3243;263208;114455;15.8;6.9
93;2021-04-30;8267;3114;271475;117569;16.3;7.0
93;2021-05-01;4948;1191;276423;118760;16.6;7.1
93;2021-05-02;419;646;276842;119406;16.6;7.1
93;2021-05-03;8173;5116;285015;124522;17.1;7.5
93;2021-05-04;7822;5395;292837;129917;17.5;7.8
93;2021-05-05;7576;4803;300413;134720;18.0;8.1
93;2021-05-06;8250;4777;308663;139497;18.5;8.4
93;2021-05-07;7014;5427;315677;144924;18.9;8.7
93;2021-05-08;8363;2393;324040;147317;19.4;8.8
93;2021-05-09;6125;1368;330165;148685;19.8;8.9
93;2021-05-10;8256;4071;338421;152756;20.3;9.1
93;2021-05-11;9308;4799;347729;157555;20.8;9.4
93;2021-05-12;9194;3655;356923;161210;21.4;9.7
93;2021-05-13;8300;1651;365223;162861;21.9;9.8
93;2021-05-14;10420;3527;375643;166388;22.5;10.0
93;2021-05-15;11125;3008;386768;169396;23.2;10.1
93;2021-05-16;5558;727;392326;170123;23.5;10.2
93;2021-05-17;11904;2268;404230;172391;24.2;10.3
93;2021-05-18;14097;2387;418327;174778;25.0;10.5
93;2021-05-19;11431;2943;429758;177721;25.7;10.6
93;2021-05-20;12624;3486;442382;181207;26.5;10.8
93;2021-05-21;13015;2885;455397;184092;27.3;11.0
93;2021-05-22;12376;2199;467773;186291;28.0;11.2
93;2021-05-23;8478;1108;476251;187399;28.5;11.2
93;2021-05-24;11208;1943;487459;189342;29.2;11.3
93;2021-05-25;12291;4318;499750;193660;29.9;11.6
93;2021-05-26;11079;3758;510829;197418;30.6;11.8
93;2021-05-27;12708;3893;523537;201311;31.3;12.1
93;2021-05-28;12653;5256;536190;206567;32.1;12.4
93;2021-05-29;11395;4264;547585;210831;32.8;12.6
93;2021-05-30;8210;1380;555795;212211;33.3;12.7
93;2021-05-31;9180;5174;564975;217385;33.8;13.0
93;2021-06-01;11401;6277;576376;223662;34.5;13.4
93;2021-06-02;10719;5195;587095;228857;35.2;13.7
93;2021-06-03;10817;5517;597912;234374;35.8;14.0
93;2021-06-04;10591;7789;608503;242163;36.4;14.5
93;2021-06-05;9018;7358;617521;249521;37.0;14.9
93;2021-06-06;8403;1746;625924;251267;37.5;15.0
93;2021-06-07;10066;7511;635990;258778;38.1;15.5
93;2021-06-08;10366;7376;646356;266154;38.7;15.9
93;2021-06-09;10242;7292;656598;273446;39.3;16.4
93;2021-06-10;9010;8194;665608;281640;39.9;16.9
93;2021-06-11;8824;8813;674432;290453;40.4;17.4
93;2021-06-12;9862;6658;684294;297111;41.0;17.8
93;2021-06-13;7168;2130;691462;299241;41.4;17.9
93;2021-06-14;5400;9732;696862;308973;41.7;18.5
93;2021-06-15;6236;9661;703098;318634;42.1;19.1
93;2021-06-16;6645;9059;709743;327693;42.5;19.6
93;2021-06-17;5753;8464;715496;336157;42.8;20.1
93;2021-06-18;7226;11120;722722;347277;43.3;20.8
93;2021-06-19;7075;11100;729797;358377;43.7;21.5
93;2021-06-20;4945;6877;734742;365254;44.0;21.9
93;2021-06-21;4071;10728;738813;375982;44.2;22.5
93;2021-06-22;4696;11314;743509;387296;44.5;23.2
93;2021-06-23;4537;10594;748046;397890;44.8;23.8
93;2021-06-24;4200;10297;752246;408187;45.0;24.4
93;2021-06-25;5188;13053;757434;421240;45.4;25.2
93;2021-06-26;5301;13928;762735;435168;45.7;26.1
93;2021-06-27;3285;7104;766020;442272;45.9;26.5
93;2021-06-28;3699;12507;769719;454779;46.1;27.2
93;2021-06-29;4016;12353;773735;467132;46.3;28.0
93;2021-06-30;4144;11302;777879;478434;46.6;28.6
93;2021-07-01;6088;11163;783967;489597;46.9;29.3
93;2021-07-02;5802;12380;789769;501977;47.3;30.1
93;2021-07-03;5550;13464;795319;515441;47.6;30.9
93;2021-07-04;3081;7888;798400;523329;47.8;31.3
93;2021-07-05;4591;10848;802991;534177;48.1;32.0
93;2021-07-06;4850;11760;807841;545937;48.4;32.7
93;2021-07-07;5229;11415;813070;557352;48.7;33.4
93;2021-07-08;5062;10268;818132;567620;49.0;34.0
93;2021-07-09;5923;13034;824055;580654;49.3;34.8
93;2021-07-10;5920;14293;829975;594947;49.7;35.6
93;2021-07-11;3689;9093;833664;604040;49.9;36.2
93;2021-07-12;5606;12079;839270;616119;50.3;36.9
93;2021-07-13;11144;13310;850414;629429;50.9;37.7
93;2021-07-14;10671;6797;861085;636226;51.6;38.1
93;2021-07-15;12557;14138;873642;650364;52.3;38.9
93;2021-07-16;13241;13697;886883;664061;53.1;39.8
93;2021-07-17;11370;13918;898253;677979;53.8;40.6
93;2021-07-18;7395;8959;905648;686938;54.2;41.1
93;2021-07-19;9637;10929;915285;697867;54.8;41.8
93;2021-07-20;12663;10690;927948;708557;55.6;42.4
93;2021-07-21;14411;10955;942359;719512;56.4;43.1
93;2021-07-22;14179;9482;956538;728994;57.3;43.6
93;2021-07-23;14620;10662;971158;739656;58.1;44.3
93;2021-07-24;13923;10648;985081;750304;59.0;44.9
93;2021-07-25;9036;6363;994117;756667;59.5;45.3
93;2021-07-26;12795;7798;1006912;764465;60.3;45.8
93;2021-07-27;15186;7467;1022098;771932;61.2;46.2
93;2021-07-28;15025;8309;1037123;780241;62.1;46.7
93;2021-07-29;13605;7081;1050728;787322;62.9;47.1
93;2021-07-30;14176;7874;1064904;795196;63.8;47.6
93;2021-07-31;12253;7721;1077157;802917;64.5;48.1
93;2021-08-01;7512;4603;1084669;807520;64.9;48.4
93;2021-08-02;11932;5738;1096601;813258;65.7;48.7
93;2021-08-03;8409;6872;1105010;820130;66.2;49.1
93;2021-08-04;8163;8006;1113173;828136;66.7;49.6
93;2021-08-05;6282;6864;1119455;835000;67.0;50.0
93;2021-08-06;7364;8340;1126819;843340;67.5;50.5
93;2021-08-07;7477;9054;1134296;852394;67.9;51.0
93;2021-08-08;4546;5566;1138842;857960;68.2;51.4
93;2021-08-09;7617;8087;1146459;866047;68.6;51.9
93;2021-08-10;7469;8849;1153928;874896;69.1;52.4
93;2021-08-11;7656;9692;1161584;884588;69.5;53.0
93;2021-08-12;6625;9044;1168209;893632;69.9;53.5
93;2021-08-13;6835;9030;1175044;902662;70.4;54.0
93;2021-08-14;6954;10496;1181998;913158;70.8;54.7
93;2021-08-15;2954;3621;1184952;916779;70.9;54.9
93;2021-08-16;6518;11220;1191470;927999;71.3;55.6
93;2021-08-17;6284;10917;1197754;938916;71.7;56.2
93;2021-08-18;5713;11212;1203467;950128;72.1;56.9
93;2021-08-19;5021;9673;1208488;959801;72.4;57.5
93;2021-08-20;5245;11234;1213733;971035;72.7;58.1
93;2021-08-21;4548;11947;1218281;982982;72.9;58.9
93;2021-08-22;2263;7052;1220544;990034;73.1;59.3
93;2021-08-23;4506;9335;1225050;999369;73.3;59.8
93;2021-08-24;4451;8431;1229501;1007800;73.6;60.3
93;2021-08-25;4314;8608;1233815;1016408;73.9;60.9
93;2021-08-26;3775;7108;1237590;1023516;74.1;61.3
93;2021-08-27;4094;8545;1241684;1032061;74.3;61.8
93;2021-08-28;3925;9588;1245609;1041649;74.6;62.4
93;2021-08-29;1814;4803;1247423;1046452;74.7;62.7
93;2021-08-30;3043;7616;1250466;1054068;74.9;63.1
93;2021-08-31;3112;7809;1253578;1061877;75.1;63.6
93;2021-09-01;3869;7773;1257447;1069650;75.3;64.0
93;2021-09-02;3025;6022;1260472;1075672;75.5;64.4
93;2021-09-03;2932;7308;1263404;1082980;75.6;64.8
93;2021-09-04;3409;8962;1266813;1091942;75.9;65.4
93;2021-09-05;1302;3709;1268115;1095651;75.9;65.6
93;2021-09-06;1886;5325;1270001;1100976;76.0;65.9
93;2021-09-07;1850;4849;1271851;1105825;76.2;66.2
93;2021-09-08;2264;5640;1274115;1111465;76.3;66.5
93;2021-09-09;2020;4925;1276135;1116390;76.4;66.8
93;2021-09-10;2754;5769;1278889;1122159;76.6;67.2
93;2021-09-11;2386;7035;1281275;1129194;76.7;67.6
93;2021-09-12;870;2889;1282145;1132083;76.8;67.8
93;2021-09-13;1761;4963;1283906;1137046;76.9;68.1
93;2021-09-14;1910;4607;1285816;1141653;77.0;68.4
93;2021-09-15;1850;4247;1287666;1145900;77.1;68.6
93;2021-09-16;1559;3037;1289225;1148937;77.2;68.8
93;2021-09-17;1956;4553;1291181;1153490;77.3;69.1
93;2021-09-18;1651;5576;1292832;1159066;77.4;69.4
93;2021-09-19;531;2103;1293363;1161169;77.4;69.5
93;2021-09-20;1257;2909;1294620;1164078;77.5;69.7
93;2021-09-21;1012;2483;1295632;1166561;77.6;69.8
93;2021-09-22;1492;3930;1297124;1170491;77.7;70.1
93;2021-09-23;1035;2421;1298159;1172912;77.7;70.2
93;2021-09-24;1336;3421;1299495;1176333;77.8;70.4
93;2021-09-25;1099;4516;1300594;1180849;77.9;70.7
93;2021-09-26;424;1671;1301018;1182520;77.9;70.8
93;2021-09-27;876;2213;1301894;1184733;78.0;70.9
93;2021-09-28;849;2019;1302743;1186752;78.0;71.1
93;2021-09-29;1208;3233;1303951;1189985;78.1;71.3
93;2021-09-30;871;2332;1304822;1192317;78.1;71.4
93;2021-10-01;1040;2679;1305862;1194996;78.2;71.6
93;2021-10-02;1124;2769;1306986;1197765;78.3;71.7
93;2021-10-03;297;832;1307283;1198597;78.3;71.8
94;2020-12-27;7;0;7;0;0.0;0.0
94;2020-12-28;11;0;18;0;0.0;0.0
94;2020-12-29;0;0;18;0;0.0;0.0
94;2020-12-30;1;0;19;0;0.0;0.0
94;2020-12-31;7;0;26;0;0.0;0.0
94;2021-01-01;4;0;30;0;0.0;0.0
94;2021-01-02;0;0;30;0;0.0;0.0
94;2021-01-03;3;0;33;0;0.0;0.0
94;2021-01-04;39;2;72;2;0.0;0.0
94;2021-01-05;233;2;305;4;0.0;0.0
94;2021-01-06;332;4;637;8;0.0;0.0
94;2021-01-07;694;11;1331;19;0.1;0.0
94;2021-01-08;925;10;2256;29;0.2;0.0
94;2021-01-09;47;0;2303;29;0.2;0.0
94;2021-01-10;18;0;2321;29;0.2;0.0
94;2021-01-11;1015;10;3336;39;0.2;0.0
94;2021-01-12;1343;25;4679;64;0.3;0.0
94;2021-01-13;1408;26;6087;90;0.4;0.0
94;2021-01-14;1543;27;7630;117;0.5;0.0
94;2021-01-15;1222;23;8852;140;0.6;0.0
94;2021-01-16;197;1;9049;141;0.6;0.0
94;2021-01-17;99;0;9148;141;0.7;0.0
94;2021-01-18;1500;25;10648;166;0.8;0.0
94;2021-01-19;1952;27;12600;193;0.9;0.0
94;2021-01-20;2186;25;14786;218;1.1;0.0
94;2021-01-21;3032;17;17818;235;1.3;0.0
94;2021-01-22;2192;26;20010;261;1.4;0.0
94;2021-01-23;735;3;20745;264;1.5;0.0
94;2021-01-24;285;0;21030;264;1.5;0.0
94;2021-01-25;1474;21;22504;285;1.6;0.0
94;2021-01-26;1581;19;24085;304;1.7;0.0
94;2021-01-27;1846;31;25931;335;1.8;0.0
94;2021-01-28;1558;128;27489;463;2.0;0.0
94;2021-01-29;1381;137;28870;600;2.1;0.0
94;2021-01-30;580;4;29450;604;2.1;0.0
94;2021-01-31;123;8;29573;612;2.1;0.0
94;2021-02-01;932;140;30505;752;2.2;0.1
94;2021-02-02;854;225;31359;977;2.2;0.1
94;2021-02-03;763;342;32122;1319;2.3;0.1
94;2021-02-04;901;389;33023;1708;2.3;0.1
94;2021-02-05;875;521;33898;2229;2.4;0.2
94;2021-02-06;408;60;34306;2289;2.4;0.2
94;2021-02-07;123;0;34429;2289;2.4;0.2
94;2021-02-08;635;463;35064;2752;2.5;0.2
94;2021-02-09;1035;931;36099;3683;2.6;0.3
94;2021-02-10;1103;1259;37202;4942;2.6;0.4
94;2021-02-11;1430;1467;38632;6409;2.7;0.5
94;2021-02-12;1394;1540;40026;7949;2.8;0.6
94;2021-02-13;299;194;40325;8143;2.9;0.6
94;2021-02-14;30;70;40355;8213;2.9;0.6
94;2021-02-15;755;1476;41110;9689;2.9;0.7
94;2021-02-16;702;2317;41812;12006;3.0;0.9
94;2021-02-17;719;1265;42531;13271;3.0;0.9
94;2021-02-18;798;1408;43329;14679;3.1;1.0
94;2021-02-19;968;1178;44297;15857;3.2;1.1
94;2021-02-20;133;719;44430;16576;3.2;1.2
94;2021-02-21;21;144;44451;16720;3.2;1.2
94;2021-02-22;524;1024;44975;17744;3.2;1.3
94;2021-02-23;624;992;45599;18736;3.2;1.3
94;2021-02-24;693;664;46292;19400;3.3;1.4
94;2021-02-25;1072;1303;47364;20703;3.4;1.5
94;2021-02-26;1322;825;48686;21528;3.5;1.5
94;2021-02-27;518;431;49204;21959;3.5;1.6
94;2021-02-28;91;72;49295;22031;3.5;1.6
94;2021-03-01;886;767;50181;22798;3.6;1.6
94;2021-03-02;1568;798;51749;23596;3.7;1.7
94;2021-03-03;1952;866;53701;24462;3.8;1.7
94;2021-03-04;2857;1015;56558;25477;4.0;1.8
94;2021-03-05;3836;1230;60394;26707;4.3;1.9
94;2021-03-06;4821;526;65215;27233;4.6;1.9
94;2021-03-07;3689;534;68904;27767;4.9;2.0
94;2021-03-08;1919;682;70823;28449;5.0;2.0
94;2021-03-09;2558;801;73381;29250;5.2;2.1
94;2021-03-10;3201;947;76582;30197;5.4;2.1
94;2021-03-11;3840;897;80422;31094;5.7;2.2
94;2021-03-12;4584;769;85006;31863;6.0;2.3
94;2021-03-13;4132;390;89138;32253;6.3;2.3
94;2021-03-14;2115;154;91253;32407;6.5;2.3
94;2021-03-15;3172;757;94425;33164;6.7;2.4
94;2021-03-16;2776;435;97201;33599;6.9;2.4
94;2021-03-17;2861;459;100062;34058;7.1;2.4
94;2021-03-18;3266;441;103328;34499;7.3;2.5
94;2021-03-19;4273;704;107601;35203;7.7;2.5
94;2021-03-20;3692;299;111293;35502;7.9;2.5
94;2021-03-21;1465;383;112758;35885;8.0;2.6
94;2021-03-22;3220;658;115978;36543;8.2;2.6
94;2021-03-23;4516;731;120494;37274;8.6;2.7
94;2021-03-24;4626;625;125120;37899;8.9;2.7
94;2021-03-25;6321;691;131441;38590;9.3;2.7
94;2021-03-26;6091;812;137532;39402;9.8;2.8
94;2021-03-27;4471;281;142003;39683;10.1;2.8
94;2021-03-28;1892;114;143895;39797;10.2;2.8
94;2021-03-29;4130;1218;148025;41015;10.5;2.9
94;2021-03-30;5298;1353;153323;42368;10.9;3.0
94;2021-03-31;4913;1785;158236;44153;11.3;3.1
94;2021-04-01;5832;2311;164068;46464;11.7;3.3
94;2021-04-02;5246;2311;169314;48775;12.0;3.5
94;2021-04-03;3087;2497;172401;51272;12.3;3.6
94;2021-04-04;1051;764;173452;52036;12.3;3.7
94;2021-04-05;837;142;174289;52178;12.4;3.7
94;2021-04-06;3583;2529;177872;54707;12.7;3.9
94;2021-04-07;3864;2257;181736;56964;12.9;4.1
94;2021-04-08;4628;2063;186364;59027;13.3;4.2
94;2021-04-09;5364;2473;191728;61500;13.6;4.4
94;2021-04-10;2957;3004;194685;64504;13.8;4.6
94;2021-04-11;1268;1766;195953;66270;13.9;4.7
94;2021-04-12;3440;2275;199393;68545;14.2;4.9
94;2021-04-13;4312;3406;203705;71951;14.5;5.1
94;2021-04-14;3905;2699;207610;74650;14.8;5.3
94;2021-04-15;4453;2997;212063;77647;15.1;5.5
94;2021-04-16;4709;2849;216772;80496;15.4;5.7
94;2021-04-17;2461;2774;219233;83270;15.6;5.9
94;2021-04-18;919;1244;220152;84514;15.7;6.0
94;2021-04-19;2977;2446;223129;86960;15.9;6.2
94;2021-04-20;3275;2715;226404;89675;16.1;6.4
94;2021-04-21;3222;3166;229626;92841;16.3;6.6
94;2021-04-22;3911;3655;233537;96496;16.6;6.9
94;2021-04-23;4121;3997;237658;100493;16.9;7.1
94;2021-04-24;4265;3401;241923;103894;17.2;7.4
94;2021-04-25;2408;1512;244331;105406;17.4;7.5
94;2021-04-26;4011;3280;248342;108686;17.7;7.7
94;2021-04-27;5098;3369;253440;112055;18.0;8.0
94;2021-04-28;4832;3640;258272;115695;18.4;8.2
94;2021-04-29;6418;3808;264690;119503;18.8;8.5
94;2021-04-30;6487;3923;271177;123426;19.3;8.8
94;2021-05-01;4057;1066;275234;124492;19.6;8.9
94;2021-05-02;3049;1474;278283;125966;19.8;9.0
94;2021-05-03;5734;5327;284017;131293;20.2;9.3
94;2021-05-04;6096;3566;290113;134859;20.6;9.6
94;2021-05-05;6183;3427;296296;138286;21.1;9.8
94;2021-05-06;7163;3529;303459;141815;21.6;10.1
94;2021-05-07;6673;4119;310132;145934;22.1;10.4
94;2021-05-08;4907;2558;315039;148492;22.4;10.6
94;2021-05-09;4226;2252;319265;150744;22.7;10.7
94;2021-05-10;7713;3125;326978;153869;23.3;10.9
94;2021-05-11;8969;3934;335947;157803;23.9;11.2
94;2021-05-12;9575;3599;345522;161402;24.6;11.5
94;2021-05-13;8675;1367;354197;162769;25.2;11.6
94;2021-05-14;9867;3310;364064;166079;25.9;11.8
94;2021-05-15;8940;2163;373004;168242;26.5;12.0
94;2021-05-16;5067;911;378071;169153;26.9;12.0
94;2021-05-17;10836;2249;388907;171402;27.7;12.2
94;2021-05-18;11295;2449;400202;173851;28.5;12.4
94;2021-05-19;11675;3597;411877;177448;29.3;12.6
94;2021-05-20;12156;4360;424033;181808;30.2;12.9
94;2021-05-21;11873;3164;435906;184972;31.0;13.2
94;2021-05-22;10283;1972;446189;186944;31.7;13.3
94;2021-05-23;4998;711;451187;187655;32.1;13.3
94;2021-05-24;9669;1348;460856;189003;32.8;13.4
94;2021-05-25;9996;4268;470852;193271;33.5;13.7
94;2021-05-26;10293;3311;481145;196582;34.2;14.0
94;2021-05-27;10863;4589;492008;201171;35.0;14.3
94;2021-05-28;10443;4950;502451;206121;35.7;14.7
94;2021-05-29;9868;3456;512319;209577;36.4;14.9
94;2021-05-30;4785;931;517104;210508;36.8;15.0
94;2021-05-31;9987;4237;527091;214745;37.5;15.3
94;2021-06-01;10308;5091;537399;219836;38.2;15.6
94;2021-06-02;9354;4587;546753;224423;38.9;16.0
94;2021-06-03;9562;5604;556315;230027;39.6;16.4
94;2021-06-04;10403;6539;566718;236566;40.3;16.8
94;2021-06-05;9181;6250;575899;242816;41.0;17.3
94;2021-06-06;3984;1848;579883;244664;41.2;17.4
94;2021-06-07;8663;5971;588546;250635;41.9;17.8
94;2021-06-08;8996;7515;597542;258150;42.5;18.4
94;2021-06-09;8955;8166;606497;266316;43.1;18.9
94;2021-06-10;8800;10972;615297;277288;43.8;19.7
94;2021-06-11;7847;8394;623144;285682;44.3;20.3
94;2021-06-12;10259;6852;633403;292534;45.0;20.8
94;2021-06-13;3469;3263;636872;295797;45.3;21.0
94;2021-06-14;6958;8203;643830;304000;45.8;21.6
94;2021-06-15;7736;8820;651566;312820;46.3;22.2
94;2021-06-16;7244;8270;658810;321090;46.9;22.8
94;2021-06-17;6698;9060;665508;330150;47.3;23.5
94;2021-06-18;6573;11959;672081;342109;47.8;24.3
94;2021-06-19;6001;9585;678082;351694;48.2;25.0
94;2021-06-20;1888;4009;679970;355703;48.4;25.3
94;2021-06-21;4527;11185;684497;366888;48.7;26.1
94;2021-06-22;4843;10812;689340;377700;49.0;26.9
94;2021-06-23;4180;11150;693520;388850;49.3;27.7
94;2021-06-24;4970;10333;698490;399183;49.7;28.4
94;2021-06-25;4285;13732;702775;412915;50.0;29.4
94;2021-06-26;3138;12006;705913;424921;50.2;30.2
94;2021-06-27;1059;4998;706972;429919;50.3;30.6
94;2021-06-28;3494;12074;710466;441993;50.5;31.4
94;2021-06-29;4052;12175;714518;454168;50.8;32.3
94;2021-06-30;4364;11643;718882;465811;51.1;33.1
94;2021-07-01;5672;11115;724554;476926;51.5;33.9
94;2021-07-02;5327;12193;729881;489119;51.9;34.8
94;2021-07-03;3710;11799;733591;500918;52.2;35.6
94;2021-07-04;1517;5092;735108;506010;52.3;36.0
94;2021-07-05;4491;11426;739599;517436;52.6;36.8
94;2021-07-06;4618;10892;744217;528328;52.9;37.6
94;2021-07-07;5042;11083;749259;539411;53.3;38.4
94;2021-07-08;5102;10023;754361;549434;53.7;39.1
94;2021-07-09;6107;11877;760468;561311;54.1;39.9
94;2021-07-10;4122;11358;764590;572669;54.4;40.7
94;2021-07-11;1555;4719;766145;577388;54.5;41.1
94;2021-07-12;4336;11965;770481;589353;54.8;41.9
94;2021-07-13;6491;12045;776972;601398;55.3;42.8
94;2021-07-14;4294;5296;781266;606694;55.6;43.1
94;2021-07-15;7321;12367;788587;619061;56.1;44.0
94;2021-07-16;7847;11321;796434;630382;56.6;44.8
94;2021-07-17;6105;11326;802539;641708;57.1;45.6
94;2021-07-18;2629;4024;805168;645732;57.3;45.9
94;2021-07-19;6913;10448;812081;656180;57.8;46.7
94;2021-07-20;8566;10383;820647;666563;58.4;47.4
94;2021-07-21;8804;9586;829451;676149;59.0;48.1
94;2021-07-22;9791;9429;839242;685578;59.7;48.8
94;2021-07-23;9432;9411;848674;694989;60.4;49.4
94;2021-07-24;7214;8882;855888;703871;60.9;50.1
94;2021-07-25;2191;2742;858079;706613;61.0;50.3
94;2021-07-26;7970;8045;866049;714658;61.6;50.8
94;2021-07-27;8622;7005;874671;721663;62.2;51.3
94;2021-07-28;8812;6322;883483;727985;62.8;51.8
94;2021-07-29;9058;6376;892541;734361;63.5;52.2
94;2021-07-30;8208;6598;900749;740959;64.1;52.7
94;2021-07-31;7214;6310;907963;747269;64.6;53.1
94;2021-08-01;3203;1783;911166;749052;64.8;53.3
94;2021-08-02;6666;5471;917832;754523;65.3;53.7
94;2021-08-03;6371;5212;924203;759735;65.7;54.0
94;2021-08-04;6306;5131;930509;764866;66.2;54.4
94;2021-08-05;5849;5470;936358;770336;66.6;54.8
94;2021-08-06;5809;5845;942167;776181;67.0;55.2
94;2021-08-07;4250;4481;946417;780662;67.3;55.5
94;2021-08-08;1371;1717;947788;782379;67.4;55.6
94;2021-08-09;4897;6530;952685;788909;67.8;56.1
94;2021-08-10;5404;6311;958089;795220;68.1;56.6
94;2021-08-11;4296;5723;962385;800943;68.4;57.0
94;2021-08-12;4419;6504;966804;807447;68.8;57.4
94;2021-08-13;3786;5755;970590;813202;69.0;57.8
94;2021-08-14;2904;5738;973494;818940;69.2;58.2
94;2021-08-15;459;736;973953;819676;69.3;58.3
94;2021-08-16;3506;8282;977459;827958;69.5;58.9
94;2021-08-17;3376;8131;980835;836089;69.8;59.5
94;2021-08-18;3273;8611;984108;844700;70.0;60.1
94;2021-08-19;3334;6910;987442;851610;70.2;60.6
94;2021-08-20;3393;7754;990835;859364;70.5;61.1
94;2021-08-21;2565;7151;993400;866515;70.7;61.6
94;2021-08-22;896;2737;994296;869252;70.7;61.8
94;2021-08-23;2846;8450;997142;877702;70.9;62.4
94;2021-08-24;3145;7513;1000287;885215;71.1;63.0
94;2021-08-25;2745;6746;1003032;891961;71.3;63.4
94;2021-08-26;2594;6146;1005626;898107;71.5;63.9
94;2021-08-27;2648;6572;1008274;904679;71.7;64.3
94;2021-08-28;2573;6493;1010847;911172;71.9;64.8
94;2021-08-29;868;2347;1011715;913519;72.0;65.0
94;2021-08-30;2840;7887;1014555;921406;72.2;65.5
94;2021-08-31;2606;7448;1017161;928854;72.3;66.1
94;2021-09-01;2338;6203;1019499;935057;72.5;66.5
94;2021-09-02;1969;5215;1021468;940272;72.6;66.9
94;2021-09-03;2101;5813;1023569;946085;72.8;67.3
94;2021-09-04;2394;5415;1025963;951500;73.0;67.7
94;2021-09-05;705;1287;1026668;952787;73.0;67.8
94;2021-09-06;1563;4082;1028231;956869;73.1;68.1
94;2021-09-07;1459;3740;1029690;960609;73.2;68.3
94;2021-09-08;1472;3723;1031162;964332;73.3;68.6
94;2021-09-09;1260;3446;1032422;967778;73.4;68.8
94;2021-09-10;1561;4072;1033983;971850;73.5;69.1
94;2021-09-11;1692;4506;1035675;976356;73.7;69.4
94;2021-09-12;420;1186;1036095;977542;73.7;69.5
94;2021-09-13;1039;2817;1037134;980359;73.8;69.7
94;2021-09-14;1317;3358;1038451;983717;73.9;70.0
94;2021-09-15;1288;3113;1039739;986830;73.9;70.2
94;2021-09-16;1038;2185;1040777;989015;74.0;70.3
94;2021-09-17;1156;2687;1041933;991702;74.1;70.5
94;2021-09-18;1105;3687;1043038;995389;74.2;70.8
94;2021-09-19;295;1039;1043333;996428;74.2;70.9
94;2021-09-20;779;1964;1044112;998392;74.3;71.0
94;2021-09-21;997;1781;1045109;1000173;74.3;71.1
94;2021-09-22;952;2365;1046061;1002538;74.4;71.3
94;2021-09-23;770;1696;1046831;1004234;74.5;71.4
94;2021-09-24;990;1972;1047821;1006206;74.5;71.6
94;2021-09-25;956;3054;1048777;1009260;74.6;71.8
94;2021-09-26;270;699;1049047;1009959;74.6;71.8
94;2021-09-27;673;1465;1049720;1011424;74.7;71.9
94;2021-09-28;660;1423;1050380;1012847;74.7;72.0
94;2021-09-29;849;1588;1051229;1014435;74.8;72.1
94;2021-09-30;973;1248;1052202;1015683;74.8;72.2
94;2021-10-01;1055;1780;1053257;1017463;74.9;72.4
94;2021-10-02;970;2156;1054227;1019619;75.0;72.5
94;2021-10-03;250;608;1054477;1020227;75.0;72.6
95;2020-12-27;3;0;3;0;0.0;0.0
95;2020-12-28;6;0;9;0;0.0;0.0
95;2020-12-29;0;0;9;0;0.0;0.0
95;2020-12-30;0;0;9;0;0.0;0.0
95;2020-12-31;2;0;11;0;0.0;0.0
95;2021-01-01;0;0;11;0;0.0;0.0
95;2021-01-02;13;0;24;0;0.0;0.0
95;2021-01-03;1;0;25;0;0.0;0.0
95;2021-01-04;50;0;75;0;0.0;0.0
95;2021-01-05;319;0;394;0;0.0;0.0
95;2021-01-06;191;0;585;0;0.0;0.0
95;2021-01-07;130;1;715;1;0.1;0.0
95;2021-01-08;279;2;994;3;0.1;0.0
95;2021-01-09;251;0;1245;3;0.1;0.0
95;2021-01-10;384;1;1629;4;0.1;0.0
95;2021-01-11;491;1;2120;5;0.2;0.0
95;2021-01-12;864;1;2984;6;0.2;0.0
95;2021-01-13;782;11;3766;17;0.3;0.0
95;2021-01-14;886;12;4652;29;0.4;0.0
95;2021-01-15;758;5;5410;34;0.4;0.0
95;2021-01-16;298;2;5708;36;0.5;0.0
95;2021-01-17;225;0;5933;36;0.5;0.0
95;2021-01-18;1338;5;7271;41;0.6;0.0
95;2021-01-19;1577;5;8848;46;0.7;0.0
95;2021-01-20;2039;3;10887;49;0.9;0.0
95;2021-01-21;1855;5;12742;54;1.0;0.0
95;2021-01-22;1325;6;14067;60;1.1;0.0
95;2021-01-23;648;0;14715;60;1.2;0.0
95;2021-01-24;182;0;14897;60;1.2;0.0
95;2021-01-25;796;32;15693;92;1.3;0.0
95;2021-01-26;988;160;16681;252;1.3;0.0
95;2021-01-27;1251;154;17932;406;1.4;0.0
95;2021-01-28;1720;20;19652;426;1.6;0.0
95;2021-01-29;1251;177;20903;603;1.7;0.0
95;2021-01-30;478;4;21381;607;1.7;0.0
95;2021-01-31;212;1;21593;608;1.7;0.0
95;2021-02-01;566;245;22159;853;1.8;0.1
95;2021-02-02;528;262;22687;1115;1.8;0.1
95;2021-02-03;614;489;23301;1604;1.9;0.1
95;2021-02-04;1068;350;24369;1954;2.0;0.2
95;2021-02-05;733;276;25102;2230;2.0;0.2
95;2021-02-06;338;211;25440;2441;2.0;0.2
95;2021-02-07;142;346;25582;2787;2.0;0.2
95;2021-02-08;765;307;26347;3094;2.1;0.2
95;2021-02-09;1136;1000;27483;4094;2.2;0.3
95;2021-02-10;1262;1316;28745;5410;2.3;0.4
95;2021-02-11;1386;1079;30131;6489;2.4;0.5
95;2021-02-12;1031;903;31162;7392;2.5;0.6
95;2021-02-13;329;261;31491;7653;2.5;0.6
95;2021-02-14;43;148;31534;7801;2.5;0.6
95;2021-02-15;430;786;31964;8587;2.6;0.7
95;2021-02-16;493;626;32457;9213;2.6;0.7
95;2021-02-17;654;909;33111;10122;2.7;0.8
95;2021-02-18;724;1312;33835;11434;2.7;0.9
95;2021-02-19;783;1050;34618;12484;2.8;1.0
95;2021-02-20;306;374;34924;12858;2.8;1.0
95;2021-02-21;165;252;35089;13110;2.8;1.1
95;2021-02-22;327;780;35416;13890;2.8;1.1
95;2021-02-23;368;549;35784;14439;2.9;1.2
95;2021-02-24;310;696;36094;15135;2.9;1.2
95;2021-02-25;729;880;36823;16015;2.9;1.3
95;2021-02-26;991;683;37814;16698;3.0;1.3
95;2021-02-27;365;356;38179;17054;3.1;1.4
95;2021-02-28;61;192;38240;17246;3.1;1.4
95;2021-03-01;773;479;39013;17725;3.1;1.4
95;2021-03-02;1321;758;40334;18483;3.2;1.5
95;2021-03-03;1599;835;41933;19318;3.4;1.5
95;2021-03-04;3196;1053;45129;20371;3.6;1.6
95;2021-03-05;3647;1005;48776;21376;3.9;1.7
95;2021-03-06;4005;458;52781;21834;4.2;1.7
95;2021-03-07;4218;302;56999;22136;4.6;1.8
95;2021-03-08;1541;777;58540;22913;4.7;1.8
95;2021-03-09;2622;465;61162;23378;4.9;1.9
95;2021-03-10;2344;788;63506;24166;5.1;1.9
95;2021-03-11;3140;1091;66646;25257;5.3;2.0
95;2021-03-12;3519;774;70165;26031;5.6;2.1
95;2021-03-13;3515;412;73680;26443;5.9;2.1
95;2021-03-14;1981;293;75661;26736;6.1;2.1
95;2021-03-15;2371;304;78032;27040;6.3;2.2
95;2021-03-16;1575;407;79607;27447;6.4;2.2
95;2021-03-17;2103;410;81710;27857;6.5;2.2
95;2021-03-18;2799;370;84509;28227;6.8;2.3
95;2021-03-19;3475;362;87984;28589;7.0;2.3
95;2021-03-20;2592;204;90576;28793;7.3;2.3
95;2021-03-21;1205;246;91781;29039;7.4;2.3
95;2021-03-22;2936;365;94717;29404;7.6;2.4
95;2021-03-23;3439;459;98156;29863;7.9;2.4
95;2021-03-24;3946;520;102102;30383;8.2;2.4
95;2021-03-25;5859;654;107961;31037;8.6;2.5
95;2021-03-26;5429;688;113390;31725;9.1;2.5
95;2021-03-27;3748;227;117138;31952;9.4;2.6
95;2021-03-28;1535;122;118673;32074;9.5;2.6
95;2021-03-29;2894;573;121567;32647;9.7;2.6
95;2021-03-30;3886;1237;125453;33884;10.0;2.7
95;2021-03-31;3657;1675;129110;35559;10.3;2.8
95;2021-04-01;5484;2271;134594;37830;10.8;3.0
95;2021-04-02;3561;2750;138155;40580;11.1;3.3
95;2021-04-03;2095;2476;140250;43056;11.2;3.4
95;2021-04-04;1247;1198;141497;44254;11.3;3.5
95;2021-04-05;596;64;142093;44318;11.4;3.6
95;2021-04-06;1859;1538;143952;45856;11.5;3.7
95;2021-04-07;4953;2193;148905;48049;11.9;3.8
95;2021-04-08;4896;2468;153801;50517;12.3;4.0
95;2021-04-09;5434;2338;159235;52855;12.8;4.2
95;2021-04-10;3709;1435;162944;54290;13.1;4.3
95;2021-04-11;1567;1038;164511;55328;13.2;4.4
95;2021-04-12;3254;1610;167765;56938;13.4;4.6
95;2021-04-13;3141;1691;170906;58629;13.7;4.7
95;2021-04-14;2751;1989;173657;60618;13.9;4.9
95;2021-04-15;3902;3350;177559;63968;14.2;5.1
95;2021-04-16;4064;3036;181623;67004;14.5;5.4
95;2021-04-17;2375;1757;183998;68761;14.7;5.5
95;2021-04-18;1511;1022;185509;69783;14.9;5.6
95;2021-04-19;2570;2371;188079;72154;15.1;5.8
95;2021-04-20;2121;2456;190200;74610;15.2;6.0
95;2021-04-21;3931;2630;194131;77240;15.6;6.2
95;2021-04-22;3413;4632;197544;81872;15.8;6.6
95;2021-04-23;2765;3555;200309;85427;16.0;6.8
95;2021-04-24;3571;2587;203880;88014;16.3;7.1
95;2021-04-25;1959;1550;205839;89564;16.5;7.2
95;2021-04-26;2753;2701;208592;92265;16.7;7.4
95;2021-04-27;3852;2180;212444;94445;17.0;7.6
95;2021-04-28;3890;2661;216334;97106;17.3;7.8
95;2021-04-29;6142;4542;222476;101648;17.8;8.1
95;2021-04-30;6904;2934;229380;104582;18.4;8.4
95;2021-05-01;2370;918;231750;105500;18.6;8.5
95;2021-05-02;2448;1502;234198;107002;18.8;8.6
95;2021-05-03;5126;1927;239324;108929;19.2;8.7
95;2021-05-04;6352;2724;245676;111653;19.7;8.9
95;2021-05-05;5146;3801;250822;115454;20.1;9.2
95;2021-05-06;8206;4925;259028;120379;20.7;9.6
95;2021-05-07;5778;4748;264806;125127;21.2;10.0
95;2021-05-08;5742;1535;270548;126662;21.7;10.1
95;2021-05-09;2830;1592;273378;128254;21.9;10.3
95;2021-05-10;9970;3191;283348;131445;22.7;10.5
95;2021-05-11;8451;3455;291799;134900;23.4;10.8
95;2021-05-12;9465;3223;301264;138123;24.1;11.1
95;2021-05-13;7953;1202;309217;139325;24.8;11.2
95;2021-05-14;7014;1910;316231;141235;25.3;11.3
95;2021-05-15;4511;1063;320742;142298;25.7;11.4
95;2021-05-16;4824;847;325566;143145;26.1;11.5
95;2021-05-17;7738;1353;333304;144498;26.7;11.6
95;2021-05-18;9465;1857;342769;146355;27.5;11.7
95;2021-05-19;9244;2496;352013;148851;28.2;11.9
95;2021-05-20;12585;2446;364598;151297;29.2;12.1
95;2021-05-21;10172;2537;374770;153834;30.0;12.3
95;2021-05-22;9395;1571;384165;155405;30.8;12.4
95;2021-05-23;4144;960;388309;156365;31.1;12.5
95;2021-05-24;2396;535;390705;156900;31.3;12.6
95;2021-05-25;7212;2082;397917;158982;31.9;12.7
95;2021-05-26;8850;3119;406767;162101;32.6;13.0
95;2021-05-27;10360;4430;417127;166531;33.4;13.3
95;2021-05-28;7683;4413;424810;170944;34.0;13.7
95;2021-05-29;5264;2760;430074;173704;34.5;13.9
95;2021-05-30;3733;1711;433807;175415;34.8;14.1
95;2021-05-31;6424;3327;440231;178742;35.3;14.3
95;2021-06-01;8782;3810;449013;182552;36.0;14.6
95;2021-06-02;8730;4750;457743;187302;36.7;15.0
95;2021-06-03;8524;6562;466267;193864;37.4;15.5
95;2021-06-04;8882;4404;475149;198268;38.1;15.9
95;2021-06-05;8335;3747;483484;202015;38.7;16.2
95;2021-06-06;4834;1623;488318;203638;39.1;16.3
95;2021-06-07;6058;4544;494376;208182;39.6;16.7
95;2021-06-08;6550;5514;500926;213696;40.1;17.1
95;2021-06-09;6253;6477;507179;220173;40.6;17.6
95;2021-06-10;6428;6813;513607;226986;41.1;18.2
95;2021-06-11;7222;6442;520829;233428;41.7;18.7
95;2021-06-12;6002;4373;526831;237801;42.2;19.0
95;2021-06-13;2082;3289;528913;241090;42.4;19.3
95;2021-06-14;5371;5989;534284;247079;42.8;19.8
95;2021-06-15;5739;8070;540023;255149;43.3;20.4
95;2021-06-16;5491;7536;545514;262685;43.7;21.0
95;2021-06-17;6599;8162;552113;270847;44.2;21.7
95;2021-06-18;5822;7861;557935;278708;44.7;22.3
95;2021-06-19;4967;8927;562902;287635;45.1;23.0
95;2021-06-20;1425;3316;564327;290951;45.2;23.3
95;2021-06-21;3534;7712;567861;298663;45.5;23.9
95;2021-06-22;5067;9055;572928;307718;45.9;24.6
95;2021-06-23;4774;10875;577702;318593;46.3;25.5
95;2021-06-24;4941;10723;582643;329316;46.7;26.4
95;2021-06-25;4878;10357;587521;339673;47.1;27.2
95;2021-06-26;4320;8477;591841;348150;47.4;27.9
95;2021-06-27;1032;3994;592873;352144;47.5;28.2
95;2021-06-28;2740;9486;595613;361630;47.7;29.0
95;2021-06-29;2537;8786;598150;370416;47.9;29.7
95;2021-06-30;3952;9996;602102;380412;48.2;30.5
95;2021-07-01;4864;11166;606966;391578;48.6;31.4
95;2021-07-02;4260;10544;611226;402122;49.0;32.2
95;2021-07-03;3525;9155;614751;411277;49.2;32.9
95;2021-07-04;1279;3400;616030;414677;49.3;33.2
95;2021-07-05;2357;4374;618387;419051;49.5;33.6
95;2021-07-06;2773;7752;621160;426803;49.8;34.2
95;2021-07-07;3961;9620;625121;436423;50.1;35.0
95;2021-07-08;5311;9820;630432;446243;50.5;35.7
95;2021-07-09;4552;10076;634984;456319;50.9;36.6
95;2021-07-10;3400;7391;638384;463710;51.1;37.1
95;2021-07-11;1526;3603;639910;467313;51.3;37.4
95;2021-07-12;2991;9692;642901;477005;51.5;38.2
95;2021-07-13;5054;10070;647955;487075;51.9;39.0
95;2021-07-14;4427;5741;652382;492816;52.3;39.5
95;2021-07-15;7401;12365;659783;505181;52.9;40.5
95;2021-07-16;7985;12003;667768;517184;53.5;41.4
95;2021-07-17;5054;7823;672822;525007;53.9;42.1
95;2021-07-18;3481;2912;676303;527919;54.2;42.3
95;2021-07-19;4832;6866;681135;534785;54.6;42.8
95;2021-07-20;6958;8383;688093;543168;55.1;43.5
95;2021-07-21;9258;9452;697351;552620;55.9;44.3
95;2021-07-22;10147;9726;707498;562346;56.7;45.0
95;2021-07-23;10917;10204;718415;572550;57.5;45.9
95;2021-07-24;5259;6235;723674;578785;58.0;46.4
95;2021-07-25;2251;2284;725925;581069;58.2;46.5
95;2021-07-26;4522;4022;730447;585091;58.5;46.9
95;2021-07-27;8500;7044;738947;592135;59.2;47.4
95;2021-07-28;9718;7561;748665;599696;60.0;48.0
95;2021-07-29;8430;5470;757095;605166;60.6;48.5
95;2021-07-30;8517;7774;765612;612940;61.3;49.1
95;2021-07-31;4238;4102;769850;617042;61.7;49.4
95;2021-08-01;2336;1375;772186;618417;61.9;49.5
95;2021-08-02;4158;3917;776344;622334;62.2;49.9
95;2021-08-03;6154;5539;782498;627873;62.7;50.3
95;2021-08-04;6509;6088;789007;633961;63.2;50.8
95;2021-08-05;6868;5730;795875;639691;63.8;51.2
95;2021-08-06;6513;7065;802388;646756;64.3;51.8
95;2021-08-07;2842;3038;805230;649794;64.5;52.1
95;2021-08-08;1368;1888;806598;651682;64.6;52.2
95;2021-08-09;3926;5037;810524;656719;64.9;52.6
95;2021-08-10;5277;5843;815801;662562;65.4;53.1
95;2021-08-11;5367;6562;821168;669124;65.8;53.6
95;2021-08-12;5225;6364;826393;675488;66.2;54.1
95;2021-08-13;3908;5474;830301;680962;66.5;54.5
95;2021-08-14;3568;3323;833869;684285;66.8;54.8
95;2021-08-15;283;361;834152;684646;66.8;54.8
95;2021-08-16;2857;6054;837009;690700;67.0;55.3
95;2021-08-17;3622;7264;840631;697964;67.3;55.9
95;2021-08-18;4275;8074;844906;706038;67.7;56.6
95;2021-08-19;3794;6592;848700;712630;68.0;57.1
95;2021-08-20;3792;7929;852492;720559;68.3;57.7
95;2021-08-21;2716;4302;855208;724861;68.5;58.1
95;2021-08-22;857;2398;856065;727259;68.6;58.3
95;2021-08-23;2468;5651;858533;732910;68.8;58.7
95;2021-08-24;2960;6463;861493;739373;69.0;59.2
95;2021-08-25;3769;8294;865262;747667;69.3;59.9
95;2021-08-26;3163;7534;868425;755201;69.6;60.5
95;2021-08-27;3516;8722;871941;763923;69.8;61.2
95;2021-08-28;2800;5495;874741;769418;70.1;61.6
95;2021-08-29;638;1712;875379;771130;70.1;61.8
95;2021-08-30;2763;6189;878142;777319;70.3;62.3
95;2021-08-31;2815;6505;880957;783824;70.6;62.8
95;2021-09-01;2703;6486;883660;790310;70.8;63.3
95;2021-09-02;1683;4635;885343;794945;70.9;63.7
95;2021-09-03;2211;5836;887554;800781;71.1;64.1
95;2021-09-04;2524;5856;890078;806637;71.3;64.6
95;2021-09-05;413;640;890491;807277;71.3;64.7
95;2021-09-06;1229;3540;891720;810817;71.4;65.0
95;2021-09-07;1394;3460;893114;814277;71.5;65.2
95;2021-09-08;1653;4246;894767;818523;71.7;65.6
95;2021-09-09;1280;3695;896047;822218;71.8;65.9
95;2021-09-10;1562;4002;897609;826220;71.9;66.2
95;2021-09-11;1537;3826;899146;830046;72.0;66.5
95;2021-09-12;317;796;899463;830842;72.1;66.6
95;2021-09-13;871;2574;900334;833416;72.1;66.8
95;2021-09-14;1104;2754;901438;836170;72.2;67.0
95;2021-09-15;1277;3569;902715;839739;72.3;67.3
95;2021-09-16;890;1887;903605;841626;72.4;67.4
95;2021-09-17;1157;2877;904762;844503;72.5;67.6
95;2021-09-18;1265;4201;906027;848704;72.6;68.0
95;2021-09-19;232;583;906259;849287;72.6;68.0
95;2021-09-20;588;1413;906847;850700;72.6;68.1
95;2021-09-21;825;1804;907672;852504;72.7;68.3
95;2021-09-22;934;3079;908606;855583;72.8;68.5
95;2021-09-23;743;1191;909349;856774;72.8;68.6
95;2021-09-24;752;2044;910101;858818;72.9;68.8
95;2021-09-25;1013;3798;911114;862616;73.0;69.1
95;2021-09-26;134;410;911248;863026;73.0;69.1
95;2021-09-27;681;1189;911929;864215;73.1;69.2
95;2021-09-28;763;1403;912692;865618;73.1;69.3
95;2021-09-29;798;1899;913490;867517;73.2;69.5
95;2021-09-30;800;1130;914290;868647;73.2;69.6
95;2021-10-01;745;1392;915035;870039;73.3;69.7
95;2021-10-02;1214;2479;916249;872518;73.4;69.9
95;2021-10-03;124;255;916373;872773;73.4;69.9
971;2020-12-27;0;0;0;0;0.0;0.0
971;2020-12-28;0;0;0;0;0.0;0.0
971;2020-12-29;0;0;0;0;0.0;0.0
971;2020-12-30;0;0;0;0;0.0;0.0
971;2020-12-31;0;0;0;0;0.0;0.0
971;2021-01-01;1;0;1;0;0.0;0.0
971;2021-01-02;0;0;1;0;0.0;0.0
971;2021-01-03;0;0;1;0;0.0;0.0
971;2021-01-04;1;0;2;0;0.0;0.0
971;2021-01-05;0;0;2;0;0.0;0.0
971;2021-01-06;1;0;3;0;0.0;0.0
971;2021-01-07;0;0;3;0;0.0;0.0
971;2021-01-08;58;1;61;1;0.0;0.0
971;2021-01-09;20;0;81;1;0.0;0.0
971;2021-01-10;0;0;81;1;0.0;0.0
971;2021-01-11;60;0;141;1;0.0;0.0
971;2021-01-12;46;0;187;1;0.0;0.0
971;2021-01-13;47;1;234;2;0.1;0.0
971;2021-01-14;63;0;297;2;0.1;0.0
971;2021-01-15;77;0;374;2;0.1;0.0
971;2021-01-16;0;0;374;2;0.1;0.0
971;2021-01-17;0;0;374;2;0.1;0.0
971;2021-01-18;82;1;456;3;0.1;0.0
971;2021-01-19;147;0;603;3;0.2;0.0
971;2021-01-20;134;0;737;3;0.2;0.0
971;2021-01-21;155;1;892;4;0.2;0.0
971;2021-01-22;135;0;1027;4;0.3;0.0
971;2021-01-23;1;0;1028;4;0.3;0.0
971;2021-01-24;0;0;1028;4;0.3;0.0
971;2021-01-25;203;1;1231;5;0.3;0.0
971;2021-01-26;218;1;1449;6;0.4;0.0
971;2021-01-27;237;0;1686;6;0.4;0.0
971;2021-01-28;242;2;1928;8;0.5;0.0
971;2021-01-29;199;2;2127;10;0.6;0.0
971;2021-01-30;25;0;2152;10;0.6;0.0
971;2021-01-31;1;0;2153;10;0.6;0.0
971;2021-02-01;228;3;2381;13;0.6;0.0
971;2021-02-02;247;13;2628;26;0.7;0.0
971;2021-02-03;228;3;2856;29;0.8;0.0
971;2021-02-04;306;21;3162;50;0.8;0.0
971;2021-02-05;289;25;3451;75;0.9;0.0
971;2021-02-06;49;1;3500;76;0.9;0.0
971;2021-02-07;0;0;3500;76;0.9;0.0
971;2021-02-08;260;18;3760;94;1.0;0.0
971;2021-02-09;322;25;4082;119;1.1;0.0
971;2021-02-10;254;21;4336;140;1.2;0.0
971;2021-02-11;302;99;4638;239;1.2;0.1
971;2021-02-12;291;26;4929;265;1.3;0.1
971;2021-02-13;51;4;4980;269;1.3;0.1
971;2021-02-14;19;36;4999;305;1.3;0.1
971;2021-02-15;85;45;5084;350;1.3;0.1
971;2021-02-16;16;1;5100;351;1.4;0.1
971;2021-02-17;17;1;5117;352;1.4;0.1
971;2021-02-18;254;11;5371;363;1.4;0.1
971;2021-02-19;250;15;5621;378;1.5;0.1
971;2021-02-20;49;0;5670;378;1.5;0.1
971;2021-02-21;2;0;5672;378;1.5;0.1
971;2021-02-22;193;47;5865;425;1.6;0.1
971;2021-02-23;206;59;6071;484;1.6;0.1
971;2021-02-24;345;113;6416;597;1.7;0.2
971;2021-02-25;385;65;6801;662;1.8;0.2
971;2021-02-26;232;72;7033;734;1.9;0.2
971;2021-02-27;65;0;7098;734;1.9;0.2
971;2021-02-28;1;0;7099;734;1.9;0.2
971;2021-03-01;179;76;7278;810;1.9;0.2
971;2021-03-02;278;115;7556;925;2.0;0.2
971;2021-03-03;245;99;7801;1024;2.1;0.3
971;2021-03-04;336;74;8137;1098;2.2;0.3
971;2021-03-05;376;133;8513;1231;2.3;0.3
971;2021-03-06;598;9;9111;1240;2.4;0.3
971;2021-03-07;1;0;9112;1240;2.4;0.3
971;2021-03-08;330;132;9442;1372;2.5;0.4
971;2021-03-09;391;135;9833;1507;2.6;0.4
971;2021-03-10;436;155;10269;1662;2.7;0.4
971;2021-03-11;122;43;10391;1705;2.8;0.5
971;2021-03-12;502;218;10893;1923;2.9;0.5
971;2021-03-13;138;4;11031;1927;2.9;0.5
971;2021-03-14;14;21;11045;1948;2.9;0.5
971;2021-03-15;425;45;11470;1993;3.0;0.5
971;2021-03-16;490;81;11960;2074;3.2;0.6
971;2021-03-17;471;70;12431;2144;3.3;0.6
971;2021-03-18;589;82;13020;2226;3.5;0.6
971;2021-03-19;584;91;13604;2317;3.6;0.6
971;2021-03-20;177;15;13781;2332;3.7;0.6
971;2021-03-21;8;0;13789;2332;3.7;0.6
971;2021-03-22;361;87;14150;2419;3.8;0.6
971;2021-03-23;539;155;14689;2574;3.9;0.7
971;2021-03-24;474;97;15163;2671;4.0;0.7
971;2021-03-25;758;180;15921;2851;4.2;0.8
971;2021-03-26;644;120;16565;2971;4.4;0.8
971;2021-03-27;296;33;16861;3004;4.5;0.8
971;2021-03-28;24;2;16885;3006;4.5;0.8
971;2021-03-29;383;85;17268;3091;4.6;0.8
971;2021-03-30;626;164;17894;3255;4.7;0.9
971;2021-03-31;545;132;18439;3387;4.9;0.9
971;2021-04-01;663;197;19102;3584;5.1;1.0
971;2021-04-02;41;35;19143;3619;5.1;1.0
971;2021-04-03;62;2;19205;3621;5.1;1.0
971;2021-04-04;4;17;19209;3638;5.1;1.0
971;2021-04-05;13;0;19222;3638;5.1;1.0
971;2021-04-06;488;195;19710;3833;5.2;1.0
971;2021-04-07;581;118;20291;3951;5.4;1.0
971;2021-04-08;525;156;20816;4107;5.5;1.1
971;2021-04-09;486;210;21302;4317;5.7;1.1
971;2021-04-10;101;5;21403;4322;5.7;1.1
971;2021-04-11;8;9;21411;4331;5.7;1.1
971;2021-04-12;305;260;21716;4591;5.8;1.2
971;2021-04-13;556;325;22272;4916;5.9;1.3
971;2021-04-14;448;228;22720;5144;6.0;1.4
971;2021-04-15;553;311;23273;5455;6.2;1.4
971;2021-04-16;563;274;23836;5729;6.3;1.5
971;2021-04-17;216;4;24052;5733;6.4;1.5
971;2021-04-18;6;13;24058;5746;6.4;1.5
971;2021-04-19;405;243;24463;5989;6.5;1.6
971;2021-04-20;727;344;25190;6333;6.7;1.7
971;2021-04-21;627;319;25817;6652;6.9;1.8
971;2021-04-22;819;322;26636;6974;7.1;1.9
971;2021-04-23;845;249;27481;7223;7.3;1.9
971;2021-04-24;391;68;27872;7291;7.4;1.9
971;2021-04-25;601;63;28473;7354;7.6;2.0
971;2021-04-26;981;220;29454;7574;7.8;2.0
971;2021-04-27;717;235;30171;7809;8.0;2.1
971;2021-04-28;864;269;31035;8078;8.2;2.1
971;2021-04-29;1201;204;32236;8282;8.6;2.2
971;2021-04-30;1269;188;33505;8470;8.9;2.2
971;2021-05-01;607;39;34112;8509;9.1;2.3
971;2021-05-02;357;19;34469;8528;9.1;2.3
971;2021-05-03;926;191;35395;8719;9.4;2.3
971;2021-05-04;960;209;36355;8928;9.6;2.4
971;2021-05-05;1022;251;37377;9179;9.9;2.4
971;2021-05-06;1146;174;38523;9353;10.2;2.5
971;2021-05-07;1266;271;39789;9624;10.6;2.6
971;2021-05-08;324;38;40113;9662;10.6;2.6
971;2021-05-09;183;11;40296;9673;10.7;2.6
971;2021-05-10;848;218;41144;9891;10.9;2.6
971;2021-05-11;964;314;42108;10205;11.2;2.7
971;2021-05-12;907;325;43015;10530;11.4;2.8
971;2021-05-13;212;78;43227;10608;11.5;2.8
971;2021-05-14;861;271;44088;10879;11.7;2.9
971;2021-05-15;486;15;44574;10894;11.8;2.9
971;2021-05-16;182;35;44756;10929;11.9;2.9
971;2021-05-17;721;276;45477;11205;12.1;3.0
971;2021-05-18;743;389;46220;11594;12.3;3.1
971;2021-05-19;705;529;46925;12123;12.5;3.2
971;2021-05-20;811;376;47736;12499;12.7;3.3
971;2021-05-21;827;405;48563;12904;12.9;3.4
971;2021-05-22;508;214;49071;13118;13.0;3.5
971;2021-05-23;200;114;49271;13232;13.1;3.5
971;2021-05-24;201;173;49472;13405;13.1;3.6
971;2021-05-25;552;661;50024;14066;13.3;3.7
971;2021-05-26;595;491;50619;14557;13.4;3.9
971;2021-05-27;133;179;50752;14736;13.5;3.9
971;2021-05-28;520;525;51272;15261;13.6;4.0
971;2021-05-29;238;140;51510;15401;13.7;4.1
971;2021-05-30;75;112;51585;15513;13.7;4.1
971;2021-05-31;453;535;52038;16048;13.8;4.3
971;2021-06-01;591;706;52629;16754;14.0;4.4
971;2021-06-02;576;705;53205;17459;14.1;4.6
971;2021-06-03;509;558;53714;18017;14.3;4.8
971;2021-06-04;834;799;54548;18816;14.5;5.0
971;2021-06-05;317;644;54865;19460;14.6;5.2
971;2021-06-06;139;528;55004;19988;14.6;5.3
971;2021-06-07;421;781;55425;20769;14.7;5.5
971;2021-06-08;489;885;55914;21654;14.8;5.7
971;2021-06-09;503;857;56417;22511;15.0;6.0
971;2021-06-10;537;848;56954;23359;15.1;6.2
971;2021-06-11;470;1233;57424;24592;15.2;6.5
971;2021-06-12;303;659;57727;25251;15.3;6.7
971;2021-06-13;126;312;57853;25563;15.4;6.8
971;2021-06-14;371;3678;58224;29241;15.4;7.8
971;2021-06-15;483;1981;58707;31222;15.6;8.3
971;2021-06-16;478;1432;59185;32654;15.7;8.7
971;2021-06-17;432;1008;59617;33662;15.8;8.9
971;2021-06-18;483;1020;60100;34682;15.9;9.2
971;2021-06-19;313;509;60413;35191;16.0;9.3
971;2021-06-20;111;231;60524;35422;16.1;9.4
971;2021-06-21;348;674;60872;36096;16.2;9.6
971;2021-06-22;333;870;61205;36966;16.2;9.8
971;2021-06-23;371;892;61576;37858;16.3;10.0
971;2021-06-24;417;731;61993;38589;16.4;10.2
971;2021-06-25;456;758;62449;39347;16.6;10.4
971;2021-06-26;301;512;62750;39859;16.6;10.6
971;2021-06-27;116;148;62866;40007;16.7;10.6
971;2021-06-28;304;682;63170;40689;16.8;10.8
971;2021-06-29;388;780;63558;41469;16.9;11.0
971;2021-06-30;441;924;63999;42393;17.0;11.2
971;2021-07-01;364;649;64363;43042;17.1;11.4
971;2021-07-02;433;693;64796;43735;17.2;11.6
971;2021-07-03;274;464;65070;44199;17.3;11.7
971;2021-07-04;112;238;65182;44437;17.3;11.8
971;2021-07-05;331;505;65513;44942;17.4;11.9
971;2021-07-06;388;769;65901;45711;17.5;12.1
971;2021-07-07;378;843;66279;46554;17.6;12.4
971;2021-07-08;416;791;66695;47345;17.7;12.6
971;2021-07-09;435;796;67130;48141;17.8;12.8
971;2021-07-10;245;295;67375;48436;17.9;12.9
971;2021-07-11;170;138;67545;48574;17.9;12.9
971;2021-07-12;477;603;68022;49177;18.0;13.0
971;2021-07-13;882;1001;68904;50178;18.3;13.3
971;2021-07-14;476;283;69380;50461;18.4;13.4
971;2021-07-15;884;841;70264;51302;18.6;13.6
971;2021-07-16;1095;1041;71359;52343;18.9;13.9
971;2021-07-17;647;445;72006;52788;19.1;14.0
971;2021-07-18;401;221;72407;53009;19.2;14.1
971;2021-07-19;579;579;72986;53588;19.4;14.2
971;2021-07-20;840;736;73826;54324;19.6;14.4
971;2021-07-21;767;501;74593;54825;19.8;14.5
971;2021-07-22;988;875;75581;55700;20.1;14.8
971;2021-07-23;1033;756;76614;56456;20.3;15.0
971;2021-07-24;426;387;77040;56843;20.4;15.1
971;2021-07-25;247;262;77287;57105;20.5;15.2
971;2021-07-26;636;565;77923;57670;20.7;15.3
971;2021-07-27;883;589;78806;58259;20.9;15.5
971;2021-07-28;795;655;79601;58914;21.1;15.6
971;2021-07-29;970;673;80571;59587;21.4;15.8
971;2021-07-30;1321;755;81892;60342;21.7;16.0
971;2021-07-31;557;412;82449;60754;21.9;16.1
971;2021-08-01;315;251;82764;61005;22.0;16.2
971;2021-08-02;764;420;83528;61425;22.2;16.3
971;2021-08-03;763;675;84291;62100;22.4;16.5
971;2021-08-04;690;674;84981;62774;22.5;16.7
971;2021-08-05;698;594;85679;63368;22.7;16.8
971;2021-08-06;933;643;86612;64011;23.0;17.0
971;2021-08-07;453;392;87065;64403;23.1;17.1
971;2021-08-08;279;313;87344;64716;23.2;17.2
971;2021-08-09;592;584;87936;65300;23.3;17.3
971;2021-08-10;760;796;88696;66096;23.5;17.5
971;2021-08-11;925;792;89621;66888;23.8;17.7
971;2021-08-12;1017;803;90638;67691;24.0;18.0
971;2021-08-13;976;443;91614;68134;24.3;18.1
971;2021-08-14;634;702;92248;68836;24.5;18.3
971;2021-08-15;436;413;92684;69249;24.6;18.4
971;2021-08-16;823;742;93507;69991;24.8;18.6
971;2021-08-17;906;871;94413;70862;25.1;18.8
971;2021-08-18;1275;976;95688;71838;25.4;19.1
971;2021-08-19;1341;928;97029;72766;25.7;19.3
971;2021-08-20;1532;1048;98561;73814;26.2;19.6
971;2021-08-21;731;518;99292;74332;26.3;19.7
971;2021-08-22;364;272;99656;74604;26.4;19.8
971;2021-08-23;875;630;100531;75234;26.7;20.0
971;2021-08-24;1292;794;101823;76028;27.0;20.2
971;2021-08-25;1391;801;103214;76829;27.4;20.4
971;2021-08-26;1406;775;104620;77604;27.8;20.6
971;2021-08-27;1492;1100;106112;78704;28.2;20.9
971;2021-08-28;936;579;107048;79283;28.4;21.0
971;2021-08-29;222;241;107270;79524;28.5;21.1
971;2021-08-30;932;749;108202;80273;28.7;21.3
971;2021-08-31;1254;900;109456;81173;29.0;21.5
971;2021-09-01;1126;914;110582;82087;29.3;21.8
971;2021-09-02;1069;886;111651;82973;29.6;22.0
971;2021-09-03;982;1136;112633;84109;29.9;22.3
971;2021-09-04;534;629;113167;84738;30.0;22.5
971;2021-09-05;128;240;113295;84978;30.1;22.5
971;2021-09-06;606;707;113901;85685;30.2;22.7
971;2021-09-07;621;744;114522;86429;30.4;22.9
971;2021-09-08;700;1055;115222;87484;30.6;23.2
971;2021-09-09;636;1136;115858;88620;30.7;23.5
971;2021-09-10;736;1342;116594;89962;30.9;23.9
971;2021-09-11;402;696;116996;90658;31.0;24.1
971;2021-09-12;84;360;117080;91018;31.1;24.2
971;2021-09-13;375;656;117455;91674;31.2;24.3
971;2021-09-14;542;1146;117997;92820;31.3;24.6
971;2021-09-15;549;1167;118546;93987;31.5;24.9
971;2021-09-16;439;1084;118985;95071;31.6;25.2
971;2021-09-17;544;1478;119529;96549;31.7;25.6
971;2021-09-18;279;1019;119808;97568;31.8;25.9
971;2021-09-19;92;336;119900;97904;31.8;26.0
971;2021-09-20;233;965;120133;98869;31.9;26.2
971;2021-09-21;274;1190;120407;100059;31.9;26.5
971;2021-09-22;380;1195;120787;101254;32.0;26.9
971;2021-09-23;368;1223;121155;102477;32.1;27.2
971;2021-09-24;449;1280;121604;103757;32.3;27.5
971;2021-09-25;232;778;121836;104535;32.3;27.7
971;2021-09-26;72;228;121908;104763;32.3;27.8
971;2021-09-27;248;664;122156;105427;32.4;28.0
971;2021-09-28;260;831;122416;106258;32.5;28.2
971;2021-09-29;306;888;122722;107146;32.6;28.4
971;2021-09-30;336;752;123058;107898;32.7;28.6
971;2021-10-01;381;863;123439;108761;32.8;28.9
971;2021-10-02;253;537;123692;109298;32.8;29.0
971;2021-10-03;69;167;123761;109465;32.8;29.0
972;2020-12-27;0;0;0;0;0.0;0.0
972;2020-12-28;0;0;0;0;0.0;0.0
972;2020-12-29;0;0;0;0;0.0;0.0
972;2020-12-30;0;0;0;0;0.0;0.0
972;2020-12-31;0;0;0;0;0.0;0.0
972;2021-01-01;0;0;0;0;0.0;0.0
972;2021-01-02;0;0;0;0;0.0;0.0
972;2021-01-03;0;0;0;0;0.0;0.0
972;2021-01-04;0;0;0;0;0.0;0.0
972;2021-01-05;0;0;0;0;0.0;0.0
972;2021-01-06;5;0;5;0;0.0;0.0
972;2021-01-07;31;0;36;0;0.0;0.0
972;2021-01-08;90;0;126;0;0.0;0.0
972;2021-01-09;20;0;146;0;0.0;0.0
972;2021-01-10;0;0;146;0;0.0;0.0
972;2021-01-11;122;0;268;0;0.1;0.0
972;2021-01-12;79;0;347;0;0.1;0.0
972;2021-01-13;65;0;412;0;0.1;0.0
972;2021-01-14;88;1;500;1;0.1;0.0
972;2021-01-15;171;0;671;1;0.2;0.0
972;2021-01-16;51;0;722;1;0.2;0.0
972;2021-01-17;0;0;722;1;0.2;0.0
972;2021-01-18;158;0;880;1;0.2;0.0
972;2021-01-19;168;1;1048;2;0.3;0.0
972;2021-01-20;170;0;1218;2;0.3;0.0
972;2021-01-21;181;2;1399;4;0.4;0.0
972;2021-01-22;173;0;1572;4;0.4;0.0
972;2021-01-23;58;0;1630;4;0.5;0.0
972;2021-01-24;0;0;1630;4;0.5;0.0
972;2021-01-25;161;1;1791;5;0.5;0.0
972;2021-01-26;138;1;1929;6;0.5;0.0
972;2021-01-27;163;4;2092;10;0.6;0.0
972;2021-01-28;152;10;2244;20;0.6;0.0
972;2021-01-29;143;39;2387;59;0.7;0.0
972;2021-01-30;96;16;2483;75;0.7;0.0
972;2021-01-31;0;0;2483;75;0.7;0.0
972;2021-02-01;119;56;2602;131;0.7;0.0
972;2021-02-02;184;74;2786;205;0.8;0.1
972;2021-02-03;132;63;2918;268;0.8;0.1
972;2021-02-04;160;58;3078;326;0.9;0.1
972;2021-02-05;123;74;3201;400;0.9;0.1
972;2021-02-06;63;18;3264;418;0.9;0.1
972;2021-02-07;1;0;3265;418;0.9;0.1
972;2021-02-08;137;54;3402;472;0.9;0.1
972;2021-02-09;177;58;3579;530;1.0;0.1
972;2021-02-10;153;66;3732;596;1.0;0.2
972;2021-02-11;149;74;3881;670;1.1;0.2
972;2021-02-12;152;99;4033;769;1.1;0.2
972;2021-02-13;47;26;4080;795;1.1;0.2
972;2021-02-14;0;0;4080;795;1.1;0.2
972;2021-02-15;51;63;4131;858;1.2;0.2
972;2021-02-16;0;0;4131;858;1.2;0.2
972;2021-02-17;1;3;4132;861;1.2;0.2
972;2021-02-18;69;101;4201;962;1.2;0.3
972;2021-02-19;69;106;4270;1068;1.2;0.3
972;2021-02-20;48;50;4318;1118;1.2;0.3
972;2021-02-21;0;0;4318;1118;1.2;0.3
972;2021-02-22;102;52;4420;1170;1.2;0.3
972;2021-02-23;113;203;4533;1373;1.3;0.4
972;2021-02-24;106;192;4639;1565;1.3;0.4
972;2021-02-25;93;123;4732;1688;1.3;0.5
972;2021-02-26;132;144;4864;1832;1.4;0.5
972;2021-02-27;69;46;4933;1878;1.4;0.5
972;2021-02-28;0;0;4933;1878;1.4;0.5
972;2021-03-01;138;124;5071;2002;1.4;0.6
972;2021-03-02;158;63;5229;2065;1.5;0.6
972;2021-03-03;179;129;5408;2194;1.5;0.6
972;2021-03-04;152;122;5560;2316;1.5;0.6
972;2021-03-05;236;105;5796;2421;1.6;0.7
972;2021-03-06;119;52;5915;2473;1.6;0.7
972;2021-03-07;100;3;6015;2476;1.7;0.7
972;2021-03-08;196;124;6211;2600;1.7;0.7
972;2021-03-09;283;94;6494;2694;1.8;0.8
972;2021-03-10;322;122;6816;2816;1.9;0.8
972;2021-03-11;336;70;7152;2886;2.0;0.8
972;2021-03-12;413;52;7565;2938;2.1;0.8
972;2021-03-13;155;16;7720;2954;2.2;0.8
972;2021-03-14;4;1;7724;2955;2.2;0.8
972;2021-03-15;277;88;8001;3043;2.2;0.8
972;2021-03-16;305;54;8306;3097;2.3;0.9
972;2021-03-17;388;44;8694;3141;2.4;0.9
972;2021-03-18;437;44;9131;3185;2.5;0.9
972;2021-03-19;401;58;9532;3243;2.7;0.9
972;2021-03-20;149;47;9681;3290;2.7;0.9
972;2021-03-21;25;1;9706;3291;2.7;0.9
972;2021-03-22;361;114;10067;3405;2.8;0.9
972;2021-03-23;404;121;10471;3526;2.9;1.0
972;2021-03-24;429;104;10900;3630;3.0;1.0
972;2021-03-25;491;97;11391;3727;3.2;1.0
972;2021-03-26;634;105;12025;3832;3.4;1.1
972;2021-03-27;154;69;12179;3901;3.4;1.1
972;2021-03-28;81;0;12260;3901;3.4;1.1
972;2021-03-29;423;164;12683;4065;3.5;1.1
972;2021-03-30;469;239;13152;4304;3.7;1.2
972;2021-03-31;1150;189;14302;4493;4.0;1.3
972;2021-04-01;955;169;15257;4662;4.3;1.3
972;2021-04-02;896;15;16153;4677;4.5;1.3
972;2021-04-03;789;57;16942;4734;4.7;1.3
972;2021-04-04;751;13;17693;4747;4.9;1.3
972;2021-04-05;828;44;18521;4791;5.2;1.3
972;2021-04-06;885;136;19406;4927;5.4;1.4
972;2021-04-07;1437;326;20843;5253;5.8;1.5
972;2021-04-08;1307;272;22150;5525;6.2;1.5
972;2021-04-09;1239;316;23389;5841;6.5;1.6
972;2021-04-10;838;164;24227;6005;6.8;1.7
972;2021-04-11;620;14;24847;6019;6.9;1.7
972;2021-04-12;868;317;25715;6336;7.2;1.8
972;2021-04-13;880;327;26595;6663;7.4;1.9
972;2021-04-14;959;321;27554;6984;7.7;1.9
972;2021-04-15;959;299;28513;7283;7.9;2.0
972;2021-04-16;997;296;29510;7579;8.2;2.1
972;2021-04-17;530;161;30040;7740;8.4;2.2
972;2021-04-18;339;56;30379;7796;8.5;2.2
972;2021-04-19;668;342;31047;8138;8.7;2.3
972;2021-04-20;865;307;31912;8445;8.9;2.4
972;2021-04-21;1002;353;32914;8798;9.2;2.5
972;2021-04-22;605;308;33519;9106;9.3;2.5
972;2021-04-23;614;463;34133;9569;9.5;2.7
972;2021-04-24;364;197;34497;9766;9.6;2.7
972;2021-04-25;168;199;34665;9965;9.7;2.8
972;2021-04-26;516;540;35181;10505;9.8;2.9
972;2021-04-27;568;606;35749;11111;10.0;3.1
972;2021-04-28;448;690;36197;11801;10.1;3.3
972;2021-04-29;654;640;36851;12441;10.3;3.5
972;2021-04-30;771;682;37622;13123;10.5;3.7
972;2021-05-01;244;246;37866;13369;10.6;3.7
972;2021-05-02;227;512;38093;13881;10.6;3.9
972;2021-05-03;569;769;38662;14650;10.8;4.1
972;2021-05-04;525;678;39187;15328;10.9;4.3
972;2021-05-05;548;896;39735;16224;11.1;4.5
972;2021-05-06;546;785;40281;17009;11.2;4.7
972;2021-05-07;629;1015;40910;18024;11.4;5.0
972;2021-05-08;225;525;41135;18549;11.5;5.2
972;2021-05-09;172;505;41307;19054;11.5;5.3
972;2021-05-10;519;855;41826;19909;11.7;5.5
972;2021-05-11;477;869;42303;20778;11.8;5.8
972;2021-05-12;560;910;42863;21688;11.9;6.0
972;2021-05-13;275;532;43138;22220;12.0;6.2
972;2021-05-14;388;746;43526;22966;12.1;6.4
972;2021-05-15;233;578;43759;23544;12.2;6.6
972;2021-05-16;155;442;43914;23986;12.2;6.7
972;2021-05-17;474;753;44388;24739;12.4;6.9
972;2021-05-18;445;678;44833;25417;12.5;7.1
972;2021-05-19;453;744;45286;26161;12.6;7.3
972;2021-05-20;594;498;45880;26659;12.8;7.4
972;2021-05-21;544;683;46424;27342;12.9;7.6
972;2021-05-22;186;359;46610;27701;13.0;7.7
972;2021-05-23;111;182;46721;27883;13.0;7.8
972;2021-05-24;135;241;46856;28124;13.1;7.8
972;2021-05-25;350;697;47206;28821;13.2;8.0
972;2021-05-26;382;712;47588;29533;13.3;8.2
972;2021-05-27;271;647;47859;30180;13.3;8.4
972;2021-05-28;280;815;48139;30995;13.4;8.6
972;2021-05-29;154;513;48293;31508;13.5;8.8
972;2021-05-30;17;33;48310;31541;13.5;8.8
972;2021-05-31;346;678;48656;32219;13.6;9.0
972;2021-06-01;299;543;48955;32762;13.6;9.1
972;2021-06-02;325;575;49280;33337;13.7;9.3
972;2021-06-03;247;424;49527;33761;13.8;9.4
972;2021-06-04;350;642;49877;34403;13.9;9.6
972;2021-06-05;260;371;50137;34774;14.0;9.7
972;2021-06-06;25;32;50162;34806;14.0;9.7
972;2021-06-07;260;735;50422;35541;14.1;9.9
972;2021-06-08;255;585;50677;36126;14.1;10.1
972;2021-06-09;303;697;50980;36823;14.2;10.3
972;2021-06-10;308;450;51288;37273;14.3;10.4
972;2021-06-11;358;533;51646;37806;14.4;10.5
972;2021-06-12;232;320;51878;38126;14.5;10.6
972;2021-06-13;32;29;51910;38155;14.5;10.6
972;2021-06-14;367;547;52277;38702;14.6;10.8
972;2021-06-15;410;487;52687;39189;14.7;10.9
972;2021-06-16;436;435;53123;39624;14.8;11.0
972;2021-06-17;354;573;53477;40197;14.9;11.2
972;2021-06-18;458;537;53935;40734;15.0;11.4
972;2021-06-19;225;196;54160;40930;15.1;11.4
972;2021-06-20;25;17;54185;40947;15.1;11.4
972;2021-06-21;332;579;54517;41526;15.2;11.6
972;2021-06-22;297;462;54814;41988;15.3;11.7
972;2021-06-23;421;562;55235;42550;15.4;11.9
972;2021-06-24;330;437;55565;42987;15.5;12.0
972;2021-06-25;313;387;55878;43374;15.6;12.1
972;2021-06-26;222;201;56100;43575;15.6;12.1
972;2021-06-27;16;23;56116;43598;15.6;12.2
972;2021-06-28;336;421;56452;44019;15.7;12.3
972;2021-06-29;329;430;56781;44449;15.8;12.4
972;2021-06-30;440;420;57221;44869;16.0;12.5
972;2021-07-01;351;394;57572;45263;16.0;12.6
972;2021-07-02;124;200;57696;45463;16.1;12.7
972;2021-07-03;100;118;57796;45581;16.1;12.7
972;2021-07-04;24;36;57820;45617;16.1;12.7
972;2021-07-05;494;580;58314;46197;16.3;12.9
972;2021-07-06;488;429;58802;46626;16.4;13.0
972;2021-07-07;612;493;59414;47119;16.6;13.1
972;2021-07-08;491;422;59905;47541;16.7;13.3
972;2021-07-09;629;582;60534;48123;16.9;13.4
972;2021-07-10;405;309;60939;48432;17.0;13.5
972;2021-07-11;52;38;60991;48470;17.0;13.5
972;2021-07-12;847;697;61838;49167;17.2;13.7
972;2021-07-13;1474;705;63312;49872;17.6;13.9
972;2021-07-14;133;65;63445;49937;17.7;13.9
972;2021-07-15;1603;680;65048;50617;18.1;14.1
972;2021-07-16;1632;661;66680;51278;18.6;14.3
972;2021-07-17;1094;367;67774;51645;18.9;14.4
972;2021-07-18;56;39;67830;51684;18.9;14.4
972;2021-07-19;1148;653;68978;52337;19.2;14.6
972;2021-07-20;1129;577;70107;52914;19.5;14.7
972;2021-07-21;1089;602;71196;53516;19.8;14.9
972;2021-07-22;906;519;72102;54035;20.1;15.1
972;2021-07-23;967;484;73069;54519;20.4;15.2
972;2021-07-24;505;223;73574;54742;20.5;15.3
972;2021-07-25;50;63;73624;54805;20.5;15.3
972;2021-07-26;685;524;74309;55329;20.7;15.4
972;2021-07-27;1029;515;75338;55844;21.0;15.6
972;2021-07-28;645;561;75983;56405;21.2;15.7
972;2021-07-29;842;548;76825;56953;21.4;15.9
972;2021-07-30;902;615;77727;57568;21.7;16.0
972;2021-07-31;560;275;78287;57843;21.8;16.1
972;2021-08-01;83;33;78370;57876;21.8;16.1
972;2021-08-02;812;815;79182;58691;22.1;16.4
972;2021-08-03;730;742;79912;59433;22.3;16.6
972;2021-08-04;786;570;80698;60003;22.5;16.7
972;2021-08-05;915;590;81613;60593;22.7;16.9
972;2021-08-06;1196;895;82809;61488;23.1;17.1
972;2021-08-07;667;570;83476;62058;23.3;17.3
972;2021-08-08;85;83;83561;62141;23.3;17.3
972;2021-08-09;1130;1064;84691;63205;23.6;17.6
972;2021-08-10;1199;1040;85890;64245;23.9;17.9
972;2021-08-11;1234;921;87124;65166;24.3;18.2
972;2021-08-12;1450;930;88574;66096;24.7;18.4
972;2021-08-13;1318;645;89892;66741;25.1;18.6
972;2021-08-14;849;322;90741;67063;25.3;18.7
972;2021-08-15;70;55;90811;67118;25.3;18.7
972;2021-08-16;1278;1046;92089;68164;25.7;19.0
972;2021-08-17;1177;1187;93266;69351;26.0;19.3
972;2021-08-18;1237;1173;94503;70524;26.3;19.7
972;2021-08-19;1286;892;95789;71416;26.7;19.9
972;2021-08-20;1329;893;97118;72309;27.1;20.2
972;2021-08-21;758;626;97876;72935;27.3;20.3
972;2021-08-22;47;82;97923;73017;27.3;20.4
972;2021-08-23;1181;859;99104;73876;27.6;20.6
972;2021-08-24;1374;880;100478;74756;28.0;20.8
972;2021-08-25;1077;768;101555;75524;28.3;21.1
972;2021-08-26;1279;801;102834;76325;28.7;21.3
972;2021-08-27;1285;1077;104119;77402;29.0;21.6
972;2021-08-28;779;756;104898;78158;29.2;21.8
972;2021-08-29;100;64;104998;78222;29.3;21.8
972;2021-08-30;1142;1126;106140;79348;29.6;22.1
972;2021-08-31;907;1106;107047;80454;29.8;22.4
972;2021-09-01;811;1134;107858;81588;30.1;22.7
972;2021-09-02;878;1214;108736;82802;30.3;23.1
972;2021-09-03;768;1315;109504;84117;30.5;23.4
972;2021-09-04;614;908;110118;85025;30.7;23.7
972;2021-09-05;144;136;110262;85161;30.7;23.7
972;2021-09-06;597;1064;110859;86225;30.9;24.0
972;2021-09-07;633;985;111492;87210;31.1;24.3
972;2021-09-08;590;1146;112082;88356;31.2;24.6
972;2021-09-09;518;1118;112600;89474;31.4;24.9
972;2021-09-10;587;1347;113187;90821;31.6;25.3
972;2021-09-11;489;921;113676;91742;31.7;25.6
972;2021-09-12;107;113;113783;91855;31.7;25.6
972;2021-09-13;460;1128;114243;92983;31.8;25.9
972;2021-09-14;477;1151;114720;94134;32.0;26.2
972;2021-09-15;386;1088;115106;95222;32.1;26.5
972;2021-09-16;382;1069;115488;96291;32.2;26.8
972;2021-09-17;588;1270;116076;97561;32.4;27.2
972;2021-09-18;422;929;116498;98490;32.5;27.5
972;2021-09-19;43;120;116541;98610;32.5;27.5
972;2021-09-20;357;920;116898;99530;32.6;27.7
972;2021-09-21;426;987;117324;100517;32.7;28.0
972;2021-09-22;362;854;117686;101371;32.8;28.3
972;2021-09-23;399;824;118085;102195;32.9;28.5
972;2021-09-24;451;975;118536;103170;33.0;28.8
972;2021-09-25;330;835;118866;104005;33.1;29.0
972;2021-09-26;30;184;118896;104189;33.1;29.0
972;2021-09-27;299;667;119195;104856;33.2;29.2
972;2021-09-28;407;669;119602;105525;33.3;29.4
972;2021-09-29;359;642;119961;106167;33.4;29.6
972;2021-09-30;431;637;120392;106804;33.6;29.8
972;2021-10-01;523;752;120915;107556;33.7;30.0
972;2021-10-02;358;605;121273;108161;33.8;30.1
972;2021-10-03;38;79;121311;108240;33.8;30.2
973;2020-12-27;0;0;0;0;0.0;0.0
973;2020-12-28;0;0;0;0;0.0;0.0
973;2020-12-29;0;0;0;0;0.0;0.0
973;2020-12-30;0;0;0;0;0.0;0.0
973;2020-12-31;0;0;0;0;0.0;0.0
973;2021-01-01;0;0;0;0;0.0;0.0
973;2021-01-02;1;1;1;1;0.0;0.0
973;2021-01-03;0;0;1;1;0.0;0.0
973;2021-01-04;0;0;1;1;0.0;0.0
973;2021-01-05;0;0;1;1;0.0;0.0
973;2021-01-06;0;0;1;1;0.0;0.0
973;2021-01-07;0;0;1;1;0.0;0.0
973;2021-01-08;0;0;1;1;0.0;0.0
973;2021-01-09;0;0;1;1;0.0;0.0
973;2021-01-10;0;0;1;1;0.0;0.0
973;2021-01-11;0;0;1;1;0.0;0.0
973;2021-01-12;0;0;1;1;0.0;0.0
973;2021-01-13;30;0;31;1;0.0;0.0
973;2021-01-14;46;0;77;1;0.0;0.0
973;2021-01-15;35;0;112;1;0.0;0.0
973;2021-01-16;18;1;130;2;0.0;0.0
973;2021-01-17;0;0;130;2;0.0;0.0
973;2021-01-18;63;0;193;2;0.1;0.0
973;2021-01-19;151;1;344;3;0.1;0.0
973;2021-01-20;134;0;478;3;0.2;0.0
973;2021-01-21;118;0;596;3;0.2;0.0
973;2021-01-22;76;0;672;3;0.2;0.0
973;2021-01-23;0;0;672;3;0.2;0.0
973;2021-01-24;0;0;672;3;0.2;0.0
973;2021-01-25;56;0;728;3;0.3;0.0
973;2021-01-26;100;2;828;5;0.3;0.0
973;2021-01-27;109;1;937;6;0.3;0.0
973;2021-01-28;96;3;1033;9;0.4;0.0
973;2021-01-29;104;3;1137;12;0.4;0.0
973;2021-01-30;0;0;1137;12;0.4;0.0
973;2021-01-31;0;0;1137;12;0.4;0.0
973;2021-02-01;54;0;1191;12;0.4;0.0
973;2021-02-02;122;5;1313;17;0.5;0.0
973;2021-02-03;119;6;1432;23;0.5;0.0
973;2021-02-04;79;25;1511;48;0.5;0.0
973;2021-02-05;65;8;1576;56;0.5;0.0
973;2021-02-06;0;0;1576;56;0.5;0.0
973;2021-02-07;0;0;1576;56;0.5;0.0
973;2021-02-08;52;12;1628;68;0.6;0.0
973;2021-02-09;92;38;1720;106;0.6;0.0
973;2021-02-10;101;37;1821;143;0.6;0.0
973;2021-02-11;105;90;1926;233;0.7;0.1
973;2021-02-12;89;59;2015;292;0.7;0.1
973;2021-02-13;0;0;2015;292;0.7;0.1
973;2021-02-14;0;0;2015;292;0.7;0.1
973;2021-02-15;27;57;2042;349;0.7;0.1
973;2021-02-16;123;45;2165;394;0.7;0.1
973;2021-02-17;145;111;2310;505;0.8;0.2
973;2021-02-18;103;125;2413;630;0.8;0.2
973;2021-02-19;122;70;2535;700;0.9;0.2
973;2021-02-20;0;0;2535;700;0.9;0.2
973;2021-02-21;0;0;2535;700;0.9;0.2
973;2021-02-22;78;46;2613;746;0.9;0.3
973;2021-02-23;158;99;2771;845;1.0;0.3
973;2021-02-24;189;118;2960;963;1.0;0.3
973;2021-02-25;259;86;3219;1049;1.1;0.4
973;2021-02-26;264;62;3483;1111;1.2;0.4
973;2021-02-27;121;1;3604;1112;1.2;0.4
973;2021-02-28;0;0;3604;1112;1.2;0.4
973;2021-03-01;182;83;3786;1195;1.3;0.4
973;2021-03-02;256;103;4042;1298;1.4;0.4
973;2021-03-03;255;122;4297;1420;1.5;0.5
973;2021-03-04;281;85;4578;1505;1.6;0.5
973;2021-03-05;274;46;4852;1551;1.7;0.5
973;2021-03-06;118;2;4970;1553;1.7;0.5
973;2021-03-07;0;0;4970;1553;1.7;0.5
973;2021-03-08;188;39;5158;1592;1.8;0.5
973;2021-03-09;353;87;5511;1679;1.9;0.6
973;2021-03-10;360;105;5871;1784;2.0;0.6
973;2021-03-11;271;110;6142;1894;2.1;0.7
973;2021-03-12;288;96;6430;1990;2.2;0.7
973;2021-03-13;112;4;6542;1994;2.3;0.7
973;2021-03-14;0;0;6542;1994;2.3;0.7
973;2021-03-15;181;27;6723;2021;2.3;0.7
973;2021-03-16;243;140;6966;2161;2.4;0.7
973;2021-03-17;274;127;7240;2288;2.5;0.8
973;2021-03-18;249;154;7489;2442;2.6;0.8
973;2021-03-19;283;128;7772;2570;2.7;0.9
973;2021-03-20;259;17;8031;2587;2.8;0.9
973;2021-03-21;119;2;8150;2589;2.8;0.9
973;2021-03-22;219;109;8369;2698;2.9;0.9
973;2021-03-23;275;193;8644;2891;3.0;1.0
973;2021-03-24;236;214;8880;3105;3.1;1.1
973;2021-03-25;167;179;9047;3284;3.1;1.1
973;2021-03-26;189;301;9236;3585;3.2;1.2
973;2021-03-27;58;93;9294;3678;3.2;1.3
973;2021-03-28;0;0;9294;3678;3.2;1.3
973;2021-03-29;175;246;9469;3924;3.3;1.3
973;2021-03-30;446;237;9915;4161;3.4;1.4
973;2021-03-31;318;291;10233;4452;3.5;1.5
973;2021-04-01;446;260;10679;4712;3.7;1.6
973;2021-04-02;309;277;10988;4989;3.8;1.7
973;2021-04-03;159;121;11147;5110;3.8;1.8
973;2021-04-04;0;0;11147;5110;3.8;1.8
973;2021-04-05;118;14;11265;5124;3.9;1.8
973;2021-04-06;441;334;11706;5458;4.0;1.9
973;2021-04-07;502;344;12208;5802;4.2;2.0
973;2021-04-08;513;269;12721;6071;4.4;2.1
973;2021-04-09;498;226;13219;6297;4.5;2.2
973;2021-04-10;147;90;13366;6387;4.6;2.2
973;2021-04-11;2;0;13368;6387;4.6;2.2
973;2021-04-12;551;267;13919;6654;4.8;2.3
973;2021-04-13;673;244;14592;6898;5.0;2.4
973;2021-04-14;721;313;15313;7211;5.3;2.5
973;2021-04-15;776;248;16089;7459;5.5;2.6
973;2021-04-16;761;304;16850;7763;5.8;2.7
973;2021-04-17;499;137;17349;7900;6.0;2.7
973;2021-04-18;499;46;17848;7946;6.1;2.7
973;2021-04-19;715;252;18563;8198;6.4;2.8
973;2021-04-20;607;280;19170;8478;6.6;2.9
973;2021-04-21;873;250;20043;8728;6.9;3.0
973;2021-04-22;727;231;20770;8959;7.1;3.1
973;2021-04-23;705;232;21475;9191;7.4;3.2
973;2021-04-24;524;97;21999;9288;7.6;3.2
973;2021-04-25;611;50;22610;9338;7.8;3.2
973;2021-04-26;779;233;23389;9571;8.0;3.3
973;2021-04-27;817;344;24206;9915;8.3;3.4
973;2021-04-28;746;331;24952;10246;8.6;3.5
973;2021-04-29;666;286;25618;10532;8.8;3.6
973;2021-04-30;711;260;26329;10792;9.1;3.7
973;2021-05-01;211;29;26540;10821;9.1;3.7
973;2021-05-02;602;85;27142;10906;9.3;3.8
973;2021-05-03;554;390;27696;11296;9.5;3.9
973;2021-05-04;664;327;28360;11623;9.8;4.0
973;2021-05-05;700;455;29060;12078;10.0;4.2
973;2021-05-06;694;477;29754;12555;10.2;4.3
973;2021-05-07;595;474;30349;13029;10.4;4.5
973;2021-05-08;343;59;30692;13088;10.6;4.5
973;2021-05-09;262;72;30954;13160;10.6;4.5
973;2021-05-10;440;611;31394;13771;10.8;4.7
973;2021-05-11;398;497;31792;14268;10.9;4.9
973;2021-05-12;515;647;32307;14915;11.1;5.1
973;2021-05-13;333;99;32640;15014;11.2;5.2
973;2021-05-14;485;555;33125;15569;11.4;5.4
973;2021-05-15;256;348;33381;15917;11.5;5.5
973;2021-05-16;207;210;33588;16127;11.6;5.5
973;2021-05-17;445;599;34033;16726;11.7;5.8
973;2021-05-18;564;568;34597;17294;11.9;5.9
973;2021-05-19;534;552;35131;17846;12.1;6.1
973;2021-05-20;643;451;35774;18297;12.3;6.3
973;2021-05-21;505;609;36279;18906;12.5;6.5
973;2021-05-22;167;500;36446;19406;12.5;6.7
973;2021-05-23;271;475;36717;19881;12.6;6.8
973;2021-05-24;562;249;37279;20130;12.8;6.9
973;2021-05-25;501;745;37780;20875;13.0;7.2
973;2021-05-26;453;684;38233;21559;13.2;7.4
973;2021-05-27;712;528;38945;22087;13.4;7.6
973;2021-05-28;579;554;39524;22641;13.6;7.8
973;2021-05-29;259;360;39783;23001;13.7;7.9
973;2021-05-30;151;399;39934;23400;13.7;8.0
973;2021-05-31;356;573;40290;23973;13.9;8.2
973;2021-06-01;421;467;40711;24440;14.0;8.4
973;2021-06-02;566;554;41277;24994;14.2;8.6
973;2021-06-03;525;470;41802;25464;14.4;8.8
973;2021-06-04;601;496;42403;25960;14.6;8.9
973;2021-06-05;273;292;42676;26252;14.7;9.0
973;2021-06-06;211;301;42887;26553;14.8;9.1
973;2021-06-07;488;452;43375;27005;14.9;9.3
973;2021-06-08;544;315;43919;27320;15.1;9.4
973;2021-06-09;530;390;44449;27710;15.3;9.5
973;2021-06-10;358;290;44807;28000;15.4;9.6
973;2021-06-11;436;466;45243;28466;15.6;9.8
973;2021-06-12;170;283;45413;28749;15.6;9.9
973;2021-06-13;214;269;45627;29018;15.7;10.0
973;2021-06-14;384;549;46011;29567;15.8;10.2
973;2021-06-15;378;445;46389;30012;16.0;10.3
973;2021-06-16;491;459;46880;30471;16.1;10.5
973;2021-06-17;442;578;47322;31049;16.3;10.7
973;2021-06-18;389;562;47711;31611;16.4;10.9
973;2021-06-19;235;260;47946;31871;16.5;11.0
973;2021-06-20;126;270;48072;32141;16.5;11.1
973;2021-06-21;335;601;48407;32742;16.7;11.3
973;2021-06-22;376;462;48783;33204;16.8;11.4
973;2021-06-23;343;539;49126;33743;16.9;11.6
973;2021-06-24;446;500;49572;34243;17.1;11.8
973;2021-06-25;445;559;50017;34802;17.2;12.0
973;2021-06-26;172;320;50189;35122;17.3;12.1
973;2021-06-27;121;170;50310;35292;17.3;12.1
973;2021-06-28;314;593;50624;35885;17.4;12.3
973;2021-06-29;376;506;51000;36391;17.5;12.5
973;2021-06-30;410;680;51410;37071;17.7;12.8
973;2021-07-01;431;399;51841;37470;17.8;12.9
973;2021-07-02;511;524;52352;37994;18.0;13.1
973;2021-07-03;210;275;52562;38269;18.1;13.2
973;2021-07-04;86;243;52648;38512;18.1;13.2
973;2021-07-05;361;546;53009;39058;18.2;13.4
973;2021-07-06;373;473;53382;39531;18.4;13.6
973;2021-07-07;375;415;53757;39946;18.5;13.7
973;2021-07-08;316;328;54073;40274;18.6;13.9
973;2021-07-09;392;434;54465;40708;18.7;14.0
973;2021-07-10;168;278;54633;40986;18.8;14.1
973;2021-07-11;102;163;54735;41149;18.8;14.2
973;2021-07-12;403;497;55138;41646;19.0;14.3
973;2021-07-13;682;560;55820;42206;19.2;14.5
973;2021-07-14;394;161;56214;42367;19.3;14.6
973;2021-07-15;658;527;56872;42894;19.6;14.8
973;2021-07-16;602;485;57474;43379;19.8;14.9
973;2021-07-17;345;285;57819;43664;19.9;15.0
973;2021-07-18;251;124;58070;43788;20.0;15.1
973;2021-07-19;524;459;58594;44247;20.2;15.2
973;2021-07-20;585;494;59179;44741;20.4;15.4
973;2021-07-21;725;397;59904;45138;20.6;15.5
973;2021-07-22;660;452;60564;45590;20.8;15.7
973;2021-07-23;608;370;61172;45960;21.0;15.8
973;2021-07-24;326;241;61498;46201;21.2;15.9
973;2021-07-25;166;111;61664;46312;21.2;15.9
973;2021-07-26;446;345;62110;46657;21.4;16.1
973;2021-07-27;551;358;62661;47015;21.6;16.2
973;2021-07-28;467;370;63128;47385;21.7;16.3
973;2021-07-29;536;431;63664;47816;21.9;16.4
973;2021-07-30;541;408;64205;48224;22.1;16.6
973;2021-07-31;203;163;64408;48387;22.2;16.6
973;2021-08-01;139;132;64547;48519;22.2;16.7
973;2021-08-02;398;432;64945;48951;22.3;16.8
973;2021-08-03;432;402;65377;49353;22.5;17.0
973;2021-08-04;308;373;65685;49726;22.6;17.1
973;2021-08-05;343;363;66028;50089;22.7;17.2
973;2021-08-06;365;524;66393;50613;22.8;17.4
973;2021-08-07;164;266;66557;50879;22.9;17.5
973;2021-08-08;123;177;66680;51056;22.9;17.6
973;2021-08-09;332;473;67012;51529;23.1;17.7
973;2021-08-10;362;516;67374;52045;23.2;17.9
973;2021-08-11;584;518;67958;52563;23.4;18.1
973;2021-08-12;550;584;68508;53147;23.6;18.3
973;2021-08-13;367;234;68875;53381;23.7;18.4
973;2021-08-14;253;401;69128;53782;23.8;18.5
973;2021-08-15;122;138;69250;53920;23.8;18.5
973;2021-08-16;307;472;69557;54392;23.9;18.7
973;2021-08-17;372;400;69929;54792;24.1;18.8
973;2021-08-18;369;446;70298;55238;24.2;19.0
973;2021-08-19;331;481;70629;55719;24.3;19.2
973;2021-08-20;313;400;70942;56119;24.4;19.3
973;2021-08-21;161;257;71103;56376;24.5;19.4
973;2021-08-22;115;183;71218;56559;24.5;19.5
973;2021-08-23;286;384;71504;56943;24.6;19.6
973;2021-08-24;311;465;71815;57408;24.7;19.7
973;2021-08-25;285;347;72100;57755;24.8;19.9
973;2021-08-26;314;404;72414;58159;24.9;20.0
973;2021-08-27;365;426;72779;58585;25.0;20.2
973;2021-08-28;143;266;72922;58851;25.1;20.2
973;2021-08-29;87;187;73009;59038;25.1;20.3
973;2021-08-30;219;349;73228;59387;25.2;20.4
973;2021-08-31;298;377;73526;59764;25.3;20.6
973;2021-09-01;255;400;73781;60164;25.4;20.7
973;2021-09-02;298;411;74079;60575;25.5;20.8
973;2021-09-03;277;353;74356;60928;25.6;21.0
973;2021-09-04;147;201;74503;61129;25.6;21.0
973;2021-09-05;72;93;74575;61222;25.7;21.1
973;2021-09-06;168;239;74743;61461;25.7;21.1
973;2021-09-07;202;264;74945;61725;25.8;21.2
973;2021-09-08;218;421;75163;62146;25.9;21.4
973;2021-09-09;216;313;75379;62459;25.9;21.5
973;2021-09-10;225;325;75604;62784;26.0;21.6
973;2021-09-11;124;295;75728;63079;26.1;21.7
973;2021-09-12;60;98;75788;63177;26.1;21.7
973;2021-09-13;218;234;76006;63411;26.1;21.8
973;2021-09-14;264;307;76270;63718;26.2;21.9
973;2021-09-15;345;330;76615;64048;26.4;22.0
973;2021-09-16;264;239;76879;64287;26.4;22.1
973;2021-09-17;215;242;77094;64529;26.5;22.2
973;2021-09-18;113;243;77207;64772;26.6;22.3
973;2021-09-19;55;150;77262;64922;26.6;22.3
973;2021-09-20;146;185;77408;65107;26.6;22.4
973;2021-09-21;194;201;77602;65308;26.7;22.5
973;2021-09-22;184;348;77786;65656;26.8;22.6
973;2021-09-23;246;238;78032;65894;26.8;22.7
973;2021-09-24;257;307;78289;66201;26.9;22.8
973;2021-09-25;113;257;78402;66458;27.0;22.9
973;2021-09-26;39;94;78441;66552;27.0;22.9
973;2021-09-27;159;166;78600;66718;27.0;23.0
973;2021-09-28;159;205;78759;66923;27.1;23.0
973;2021-09-29;204;237;78963;67160;27.2;23.1
973;2021-09-30;277;298;79240;67458;27.3;23.2
973;2021-10-01;188;215;79428;67673;27.3;23.3
973;2021-10-02;104;168;79532;67841;27.4;23.3
973;2021-10-03;60;91;79592;67932;27.4;23.4
974;2020-12-27;0;0;0;0;0.0;0.0
974;2020-12-28;0;0;0;0;0.0;0.0
974;2020-12-29;0;0;0;0;0.0;0.0
974;2020-12-30;0;0;0;0;0.0;0.0
974;2020-12-31;0;0;0;0;0.0;0.0
974;2021-01-01;1;0;1;0;0.0;0.0
974;2021-01-02;0;0;1;0;0.0;0.0
974;2021-01-03;0;0;1;0;0.0;0.0
974;2021-01-04;0;0;1;0;0.0;0.0
974;2021-01-05;2;0;3;0;0.0;0.0
974;2021-01-06;0;0;3;0;0.0;0.0
974;2021-01-07;0;0;3;0;0.0;0.0
974;2021-01-08;0;0;3;0;0.0;0.0
974;2021-01-09;1;0;4;0;0.0;0.0
974;2021-01-10;0;0;4;0;0.0;0.0
974;2021-01-11;0;0;4;0;0.0;0.0
974;2021-01-12;0;0;4;0;0.0;0.0
974;2021-01-13;0;0;4;0;0.0;0.0
974;2021-01-14;0;0;4;0;0.0;0.0
974;2021-01-15;335;0;339;0;0.0;0.0
974;2021-01-16;27;0;366;0;0.0;0.0
974;2021-01-17;0;0;366;0;0.0;0.0
974;2021-01-18;49;1;415;1;0.0;0.0
974;2021-01-19;395;0;810;1;0.1;0.0
974;2021-01-20;485;1;1295;2;0.2;0.0
974;2021-01-21;614;2;1909;4;0.2;0.0
974;2021-01-22;414;1;2323;5;0.3;0.0
974;2021-01-23;75;0;2398;5;0.3;0.0
974;2021-01-24;0;0;2398;5;0.3;0.0
974;2021-01-25;273;2;2671;7;0.3;0.0
974;2021-01-26;429;0;3100;7;0.4;0.0
974;2021-01-27;316;0;3416;7;0.4;0.0
974;2021-01-28;409;0;3825;7;0.4;0.0
974;2021-01-29;422;3;4247;10;0.5;0.0
974;2021-01-30;421;1;4668;11;0.5;0.0
974;2021-01-31;0;0;4668;11;0.5;0.0
974;2021-02-01;373;4;5041;15;0.6;0.0
974;2021-02-02;502;3;5543;18;0.6;0.0
974;2021-02-03;602;9;6145;27;0.7;0.0
974;2021-02-04;629;16;6774;43;0.8;0.0
974;2021-02-05;564;97;7338;140;0.9;0.0
974;2021-02-06;501;6;7839;146;0.9;0.0
974;2021-02-07;0;8;7839;154;0.9;0.0
974;2021-02-08;470;32;8309;186;1.0;0.0
974;2021-02-09;787;63;9096;249;1.1;0.0
974;2021-02-10;820;86;9916;335;1.2;0.0
974;2021-02-11;795;86;10711;421;1.2;0.0
974;2021-02-12;638;92;11349;513;1.3;0.1
974;2021-02-13;655;75;12004;588;1.4;0.1
974;2021-02-14;1;0;12005;588;1.4;0.1
974;2021-02-15;526;123;12531;711;1.5;0.1
974;2021-02-16;651;524;13182;1235;1.5;0.1
974;2021-02-17;593;311;13775;1546;1.6;0.2
974;2021-02-18;495;384;14270;1930;1.7;0.2
974;2021-02-19;497;305;14767;2235;1.7;0.3
974;2021-02-20;577;105;15344;2340;1.8;0.3
974;2021-02-21;0;0;15344;2340;1.8;0.3
974;2021-02-22;403;208;15747;2548;1.8;0.3
974;2021-02-23;607;201;16354;2749;1.9;0.3
974;2021-02-24;583;219;16937;2968;2.0;0.3
974;2021-02-25;649;247;17586;3215;2.0;0.4
974;2021-02-26;485;407;18071;3622;2.1;0.4
974;2021-02-27;384;396;18455;4018;2.1;0.5
974;2021-02-28;0;0;18455;4018;2.1;0.5
974;2021-03-01;293;327;18748;4345;2.2;0.5
974;2021-03-02;487;434;19235;4779;2.2;0.6
974;2021-03-03;757;487;19992;5266;2.3;0.6
974;2021-03-04;778;450;20770;5716;2.4;0.7
974;2021-03-05;729;470;21499;6186;2.5;0.7
974;2021-03-06;813;496;22312;6682;2.6;0.8
974;2021-03-07;0;0;22312;6682;2.6;0.8
974;2021-03-08;436;494;22748;7176;2.6;0.8
974;2021-03-09;671;743;23419;7919;2.7;0.9
974;2021-03-10;644;795;24063;8714;2.8;1.0
974;2021-03-11;700;603;24763;9317;2.9;1.1
974;2021-03-12;731;644;25494;9961;3.0;1.2
974;2021-03-13;669;577;26163;10538;3.0;1.2
974;2021-03-14;2;0;26165;10538;3.0;1.2
974;2021-03-15;508;485;26673;11023;3.1;1.3
974;2021-03-16;681;675;27354;11698;3.2;1.4
974;2021-03-17;847;517;28201;12215;3.3;1.4
974;2021-03-18;1022;491;29223;12706;3.4;1.5
974;2021-03-19;786;524;30009;13230;3.5;1.5
974;2021-03-20;578;585;30587;13815;3.6;1.6
974;2021-03-21;0;0;30587;13815;3.6;1.6
974;2021-03-22;566;459;31153;14274;3.6;1.7
974;2021-03-23;780;632;31933;14906;3.7;1.7
974;2021-03-24;791;640;32724;15546;3.8;1.8
974;2021-03-25;934;531;33658;16077;3.9;1.9
974;2021-03-26;923;447;34581;16524;4.0;1.9
974;2021-03-27;781;334;35362;16858;4.1;2.0
974;2021-03-28;1;0;35363;16858;4.1;2.0
974;2021-03-29;960;270;36323;17128;4.2;2.0
974;2021-03-30;883;493;37206;17621;4.3;2.0
974;2021-03-31;736;652;37942;18273;4.4;2.1
974;2021-04-01;718;705;38660;18978;4.5;2.2
974;2021-04-02;688;753;39348;19731;4.6;2.3
974;2021-04-03;699;697;40047;20428;4.7;2.4
974;2021-04-04;0;0;40047;20428;4.7;2.4
974;2021-04-05;0;0;40047;20428;4.7;2.4
974;2021-04-06;796;635;40843;21063;4.7;2.4
974;2021-04-07;1367;780;42210;21843;4.9;2.5
974;2021-04-08;1792;771;44002;22614;5.1;2.6
974;2021-04-09;1508;775;45510;23389;5.3;2.7
974;2021-04-10;1137;643;46647;24032;5.4;2.8
974;2021-04-11;2;0;46649;24032;5.4;2.8
974;2021-04-12;1238;547;47887;24579;5.6;2.9
974;2021-04-13;1439;750;49326;25329;5.7;2.9
974;2021-04-14;2068;769;51394;26098;6.0;3.0
974;2021-04-15;2506;954;53900;27052;6.3;3.1
974;2021-04-16;1936;783;55836;27835;6.5;3.2
974;2021-04-17;1290;603;57126;28438;6.6;3.3
974;2021-04-18;0;0;57126;28438;6.6;3.3
974;2021-04-19;1374;562;58500;29000;6.8;3.4
974;2021-04-20;1651;804;60151;29804;7.0;3.5
974;2021-04-21;2124;626;62275;30430;7.2;3.5
974;2021-04-22;2953;821;65228;31251;7.6;3.6
974;2021-04-23;2311;820;67539;32071;7.9;3.7
974;2021-04-24;1111;803;68650;32874;8.0;3.8
974;2021-04-25;3;0;68653;32874;8.0;3.8
974;2021-04-26;1172;912;69825;33786;8.1;3.9
974;2021-04-27;1687;1027;71512;34813;8.3;4.0
974;2021-04-28;2900;747;74412;35560;8.7;4.1
974;2021-04-29;3947;813;78359;36373;9.1;4.2
974;2021-04-30;3450;905;81809;37278;9.5;4.3
974;2021-05-01;2106;227;83915;37505;9.8;4.4
974;2021-05-02;1;0;83916;37505;9.8;4.4
974;2021-05-03;1865;575;85781;38080;10.0;4.4
974;2021-05-04;2127;1092;87908;39172;10.2;4.6
974;2021-05-05;3119;1643;91027;40815;10.6;4.7
974;2021-05-06;4001;1587;95028;42402;11.1;4.9
974;2021-05-07;3229;1524;98257;43926;11.4;5.1
974;2021-05-08;1578;504;99835;44430;11.6;5.2
974;2021-05-09;2;1;99837;44431;11.6;5.2
974;2021-05-10;2412;1001;102249;45432;11.9;5.3
974;2021-05-11;3650;1640;105899;47072;12.3;5.5
974;2021-05-12;4721;2403;110620;49475;12.9;5.8
974;2021-05-13;3553;597;114173;50072;13.3;5.8
974;2021-05-14;5276;2522;119449;52594;13.9;6.1
974;2021-05-15;3157;1536;122606;54130;14.3;6.3
974;2021-05-16;17;18;122623;54148;14.3;6.3
974;2021-05-17;2995;1497;125618;55645;14.6;6.5
974;2021-05-18;3764;1802;129382;57447;15.0;6.7
974;2021-05-19;4687;2433;134069;59880;15.6;7.0
974;2021-05-20;5139;2853;139208;62733;16.2;7.3
974;2021-05-21;4996;2628;144204;65361;16.8;7.6
974;2021-05-22;3371;1255;147575;66616;17.2;7.7
974;2021-05-23;6;3;147581;66619;17.2;7.7
974;2021-05-24;3644;1078;151225;67697;17.6;7.9
974;2021-05-25;4248;1921;155473;69618;18.1;8.1
974;2021-05-26;4986;2992;160459;72610;18.7;8.4
974;2021-05-27;4620;4101;165079;76711;19.2;8.9
974;2021-05-28;4385;3837;169464;80548;19.7;9.4
974;2021-05-29;2554;2456;172018;83004;20.0;9.7
974;2021-05-30;8;14;172026;83018;20.0;9.7
974;2021-05-31;2347;2247;174373;85265;20.3;9.9
974;2021-06-01;3302;2761;177675;88026;20.7;10.2
974;2021-06-02;3968;3363;181643;91389;21.1;10.6
974;2021-06-03;4041;3652;185684;95041;21.6;11.1
974;2021-06-04;3849;3759;189533;98800;22.0;11.5
974;2021-06-05;2213;1931;191746;100731;22.3;11.7
974;2021-06-06;1074;134;192820;100865;22.4;11.7
974;2021-06-07;2012;2526;194832;103391;22.7;12.0
974;2021-06-08;2558;3338;197390;106729;23.0;12.4
974;2021-06-09;2982;4836;200372;111565;23.3;13.0
974;2021-06-10;3411;4463;203783;116028;23.7;13.5
974;2021-06-11;2840;4622;206623;120650;24.0;14.0
974;2021-06-12;1726;3376;208349;124026;24.2;14.4
974;2021-06-13;1324;246;209673;124272;24.4;14.5
974;2021-06-14;1488;3182;211161;127454;24.6;14.8
974;2021-06-15;2060;3617;213221;131071;24.8;15.2
974;2021-06-16;2748;4663;215969;135734;25.1;15.8
974;2021-06-17;2521;4895;218490;140629;25.4;16.4
974;2021-06-18;2596;4889;221086;145518;25.7;16.9
974;2021-06-19;1300;3516;222386;149034;25.9;17.3
974;2021-06-20;633;289;223019;149323;25.9;17.4
974;2021-06-21;1265;3235;224284;152558;26.1;17.7
974;2021-06-22;1619;3759;225903;156317;26.3;18.2
974;2021-06-23;2257;4993;228160;161310;26.5;18.8
974;2021-06-24;2280;4069;230440;165379;26.8;19.2
974;2021-06-25;2188;4106;232628;169485;27.1;19.7
974;2021-06-26;1401;2712;234029;172197;27.2;20.0
974;2021-06-27;664;268;234693;172465;27.3;20.1
974;2021-06-28;1307;2480;236000;174945;27.4;20.3
974;2021-06-29;1755;2846;237755;177791;27.6;20.7
974;2021-06-30;2561;3843;240316;181634;27.9;21.1
974;2021-07-01;2699;3826;243015;185460;28.3;21.6
974;2021-07-02;2511;3708;245526;189168;28.6;22.0
974;2021-07-03;1613;2456;247139;191624;28.7;22.3
974;2021-07-04;881;1038;248020;192662;28.8;22.4
974;2021-07-05;1696;2221;249716;194883;29.0;22.7
974;2021-07-06;2569;2545;252285;197428;29.3;23.0
974;2021-07-07;2664;3134;254949;200562;29.6;23.3
974;2021-07-08;2417;3172;257366;203734;29.9;23.7
974;2021-07-09;2761;3427;260127;207161;30.2;24.1
974;2021-07-10;1618;2192;261745;209353;30.4;24.3
974;2021-07-11;729;1017;262474;210370;30.5;24.5
974;2021-07-12;1745;2604;264219;212974;30.7;24.8
974;2021-07-13;4432;3346;268651;216320;31.2;25.2
974;2021-07-14;3300;608;271951;216928;31.6;25.2
974;2021-07-15;5557;4023;277508;220951;32.3;25.7
974;2021-07-16;6240;3299;283748;224250;33.0;26.1
974;2021-07-17;4373;1912;288121;226162;33.5;26.3
974;2021-07-18;2673;765;290794;226927;33.8;26.4
974;2021-07-19;4650;2030;295444;228957;34.4;26.6
974;2021-07-20;6234;2428;301678;231385;35.1;26.9
974;2021-07-21;6746;2860;308424;234245;35.9;27.2
974;2021-07-22;7140;2826;315564;237071;36.7;27.6
974;2021-07-23;6643;2980;322207;240051;37.5;27.9
974;2021-07-24;3800;2066;326007;242117;37.9;28.2
974;2021-07-25;2522;754;328529;242871;38.2;28.2
974;2021-07-26;4371;2097;332900;244968;38.7;28.5
974;2021-07-27;5442;2561;338342;247529;39.3;28.8
974;2021-07-28;5396;2905;343738;250434;40.0;29.1
974;2021-07-29;5744;2809;349482;253243;40.6;29.4
974;2021-07-30;5875;2581;355357;255824;41.3;29.7
974;2021-07-31;3936;1648;359293;257472;41.8;29.9
974;2021-08-01;1907;715;361200;258187;42.0;30.0
974;2021-08-02;3434;1866;364634;260053;42.4;30.2
974;2021-08-03;4301;4074;368935;264127;42.9;30.7
974;2021-08-04;4878;4233;373813;268360;43.5;31.2
974;2021-08-05;4446;4667;378259;273027;44.0;31.7
974;2021-08-06;4082;5104;382341;278131;44.5;32.3
974;2021-08-07;2748;4042;385089;282173;44.8;32.8
974;2021-08-08;1481;2265;386570;284438;45.0;33.1
974;2021-08-09;2574;4525;389144;288963;45.3;33.6
974;2021-08-10;3790;4961;392934;293924;45.7;34.2
974;2021-08-11;4634;5448;397568;299372;46.2;34.8
974;2021-08-12;4714;5917;402282;305289;46.8;35.5
974;2021-08-13;4458;5828;406740;311117;47.3;36.2
974;2021-08-14;2607;4329;409347;315446;47.6;36.7
974;2021-08-15;1573;2175;410920;317621;47.8;36.9
974;2021-08-16;2345;4181;413265;321802;48.1;37.4
974;2021-08-17;3186;4525;416451;326327;48.4;37.9
974;2021-08-18;3348;5901;419799;332228;48.8;38.6
974;2021-08-19;3311;4908;423110;337136;49.2;39.2
974;2021-08-20;3440;5274;426550;342410;49.6;39.8
974;2021-08-21;1835;4615;428385;347025;49.8;40.4
974;2021-08-22;1019;1944;429404;348969;49.9;40.6
974;2021-08-23;1816;3326;431220;352295;50.1;41.0
974;2021-08-24;2461;3773;433681;356068;50.4;41.4
974;2021-08-25;2905;5216;436586;361284;50.8;42.0
974;2021-08-26;2667;3870;439253;365154;51.1;42.5
974;2021-08-27;2778;4010;442031;369164;51.4;42.9
974;2021-08-28;1863;3881;443894;373045;51.6;43.4
974;2021-08-29;760;1574;444654;374619;51.7;43.6
974;2021-08-30;1565;2533;446219;377152;51.9;43.9
974;2021-08-31;1865;3350;448084;380502;52.1;44.2
974;2021-09-01;2407;4908;450491;385410;52.4;44.8
974;2021-09-02;2254;4317;452745;389727;52.6;45.3
974;2021-09-03;2339;4540;455084;394267;52.9;45.8
974;2021-09-04;1584;3921;456668;398188;53.1;46.3
974;2021-09-05;607;1338;457275;399526;53.2;46.5
974;2021-09-06;1214;2552;458489;402078;53.3;46.8
974;2021-09-07;1366;3204;459855;405282;53.5;47.1
974;2021-09-08;2109;3965;461964;409247;53.7;47.6
974;2021-09-09;1794;3435;463758;412682;53.9;48.0
974;2021-09-10;1928;3819;465686;416501;54.2;48.4
974;2021-09-11;1531;2510;467217;419011;54.3;48.7
974;2021-09-12;391;971;467608;419982;54.4;48.8
974;2021-09-13;1073;1939;468681;421921;54.5;49.1
974;2021-09-14;1506;2458;470187;424379;54.7;49.3
974;2021-09-15;1816;3028;472003;427407;54.9;49.7
974;2021-09-16;1383;2782;473386;430189;55.0;50.0
974;2021-09-17;1482;3063;474868;433252;55.2;50.4
974;2021-09-18;1196;1957;476064;435209;55.4;50.6
974;2021-09-19;290;717;476354;435926;55.4;50.7
974;2021-09-20;716;1631;477070;437557;55.5;50.9
974;2021-09-21;837;1814;477907;439371;55.6;51.1
974;2021-09-22;1248;2516;479155;441887;55.7;51.4
974;2021-09-23;844;2119;479999;444006;55.8;51.6
974;2021-09-24;1098;2475;481097;446481;55.9;51.9
974;2021-09-25;768;1879;481865;448360;56.0;52.1
974;2021-09-26;160;518;482025;448878;56.1;52.2
974;2021-09-27;608;1071;482633;449949;56.1;52.3
974;2021-09-28;850;1533;483483;451482;56.2;52.5
974;2021-09-29;1195;2325;484678;453807;56.4;52.8
974;2021-09-30;992;1752;485670;455559;56.5;53.0
974;2021-10-01;1261;1987;486931;457546;56.6;53.2
974;2021-10-02;931;1465;487862;459011;56.7;53.4
974;2021-10-03;265;383;488127;459394;56.8;53.4
976;2020-12-27;0;0;0;0;0.0;0.0
976;2020-12-28;0;0;0;0;0.0;0.0
976;2020-12-29;0;0;0;0;0.0;0.0
976;2020-12-30;0;0;0;0;0.0;0.0
976;2020-12-31;0;0;0;0;0.0;0.0
976;2021-01-01;0;0;0;0;0.0;0.0
976;2021-01-02;0;0;0;0;0.0;0.0
976;2021-01-03;0;0;0;0;0.0;0.0
976;2021-01-04;0;0;0;0;0.0;0.0
976;2021-01-05;0;0;0;0;0.0;0.0
976;2021-01-06;0;0;0;0;0.0;0.0
976;2021-01-07;0;0;0;0;0.0;0.0
976;2021-01-08;0;0;0;0;0.0;0.0
976;2021-01-09;0;0;0;0;0.0;0.0
976;2021-01-10;0;0;0;0;0.0;0.0
976;2021-01-11;9;0;9;0;0.0;0.0
976;2021-01-12;0;0;9;0;0.0;0.0
976;2021-01-13;0;0;9;0;0.0;0.0
976;2021-01-14;0;0;9;0;0.0;0.0
976;2021-01-15;1;0;10;0;0.0;0.0
976;2021-01-16;1;0;11;0;0.0;0.0
976;2021-01-17;0;0;11;0;0.0;0.0
976;2021-01-18;1;0;12;0;0.0;0.0
976;2021-01-19;0;0;12;0;0.0;0.0
976;2021-01-20;0;0;12;0;0.0;0.0
976;2021-01-21;1;1;13;1;0.0;0.0
976;2021-01-22;0;0;13;1;0.0;0.0
976;2021-01-23;1;0;14;1;0.0;0.0
976;2021-01-24;0;0;14;1;0.0;0.0
976;2021-01-25;144;3;158;4;0.1;0.0
976;2021-01-26;167;2;325;6;0.1;0.0
976;2021-01-27;250;3;575;9;0.2;0.0
976;2021-01-28;104;8;679;17;0.2;0.0
976;2021-01-29;233;3;912;20;0.3;0.0
976;2021-01-30;286;11;1198;31;0.4;0.0
976;2021-01-31;1;0;1199;31;0.4;0.0
976;2021-02-01;161;2;1360;33;0.5;0.0
976;2021-02-02;328;11;1688;44;0.6;0.0
976;2021-02-03;227;4;1915;48;0.7;0.0
976;2021-02-04;215;9;2130;57;0.8;0.0
976;2021-02-05;213;1;2343;58;0.8;0.0
976;2021-02-06;83;10;2426;68;0.9;0.0
976;2021-02-07;0;0;2426;68;0.9;0.0
976;2021-02-08;82;3;2508;71;0.9;0.0
976;2021-02-09;194;2;2702;73;1.0;0.0
976;2021-02-10;187;5;2889;78;1.0;0.0
976;2021-02-11;236;4;3125;82;1.1;0.0
976;2021-02-12;288;4;3413;86;1.2;0.0
976;2021-02-13;56;0;3469;86;1.2;0.0
976;2021-02-14;1;0;3470;86;1.2;0.0
976;2021-02-15;358;9;3828;95;1.4;0.0
976;2021-02-16;266;10;4094;105;1.5;0.0
976;2021-02-17;167;9;4261;114;1.5;0.0
976;2021-02-18;217;15;4478;129;1.6;0.0
976;2021-02-19;237;24;4715;153;1.7;0.1
976;2021-02-20;138;9;4853;162;1.7;0.1
976;2021-02-21;0;0;4853;162;1.7;0.1
976;2021-02-22;130;117;4983;279;1.8;0.1
976;2021-02-23;185;152;5168;431;1.8;0.2
976;2021-02-24;176;146;5344;577;1.9;0.2
976;2021-02-25;227;273;5571;850;2.0;0.3
976;2021-02-26;242;245;5813;1095;2.1;0.4
976;2021-02-27;0;0;5813;1095;2.1;0.4
976;2021-02-28;0;0;5813;1095;2.1;0.4
976;2021-03-01;146;255;5959;1350;2.1;0.5
976;2021-03-02;228;257;6187;1607;2.2;0.6
976;2021-03-03;202;190;6389;1797;2.3;0.6
976;2021-03-04;205;143;6594;1940;2.4;0.7
976;2021-03-05;225;116;6819;2056;2.4;0.7
976;2021-03-06;1;0;6820;2056;2.4;0.7
976;2021-03-07;1;0;6821;2056;2.4;0.7
976;2021-03-08;189;112;7010;2168;2.5;0.8
976;2021-03-09;390;163;7400;2331;2.6;0.8
976;2021-03-10;179;178;7579;2509;2.7;0.9
976;2021-03-11;167;208;7746;2717;2.8;1.0
976;2021-03-12;237;293;7983;3010;2.9;1.1
976;2021-03-13;3;0;7986;3010;2.9;1.1
976;2021-03-14;0;0;7986;3010;2.9;1.1
976;2021-03-15;157;295;8143;3305;2.9;1.2
976;2021-03-16;238;226;8381;3531;3.0;1.3
976;2021-03-17;264;145;8645;3676;3.1;1.3
976;2021-03-18;174;235;8819;3911;3.2;1.4
976;2021-03-19;173;296;8992;4207;3.2;1.5
976;2021-03-20;0;0;8992;4207;3.2;1.5
976;2021-03-21;0;0;8992;4207;3.2;1.5
976;2021-03-22;97;136;9089;4343;3.3;1.6
976;2021-03-23;136;238;9225;4581;3.3;1.6
976;2021-03-24;160;146;9385;4727;3.4;1.7
976;2021-03-25;184;206;9569;4933;3.4;1.8
976;2021-03-26;160;212;9729;5145;3.5;1.8
976;2021-03-27;18;0;9747;5145;3.5;1.8
976;2021-03-28;1;0;9748;5145;3.5;1.8
976;2021-03-29;0;2;9748;5147;3.5;1.8
976;2021-03-30;272;337;10020;5484;3.6;2.0
976;2021-03-31;225;124;10245;5608;3.7;2.0
976;2021-04-01;246;104;10491;5712;3.8;2.0
976;2021-04-02;285;262;10776;5974;3.9;2.1
976;2021-04-03;905;310;11681;6284;4.2;2.2
976;2021-04-04;2;0;11683;6284;4.2;2.2
976;2021-04-05;1;0;11684;6284;4.2;2.2
976;2021-04-06;161;277;11845;6561;4.2;2.3
976;2021-04-07;237;266;12082;6827;4.3;2.4
976;2021-04-08;283;140;12365;6967;4.4;2.5
976;2021-04-09;248;172;12613;7139;4.5;2.6
976;2021-04-10;181;114;12794;7253;4.6;2.6
976;2021-04-11;7;0;12801;7253;4.6;2.6
976;2021-04-12;0;18;12801;7271;4.6;2.6
976;2021-04-13;394;345;13195;7616;4.7;2.7
976;2021-04-14;239;205;13434;7821;4.8;2.8
976;2021-04-15;209;117;13643;7938;4.9;2.8
976;2021-04-16;214;127;13857;8065;5.0;2.9
976;2021-04-17;225;130;14082;8195;5.0;2.9
976;2021-04-18;1;0;14083;8195;5.0;2.9
976;2021-04-19;7;1;14090;8196;5.0;2.9
976;2021-04-20;367;221;14457;8417;5.2;3.0
976;2021-04-21;411;150;14868;8567;5.3;3.1
976;2021-04-22;410;150;15278;8717;5.5;3.1
976;2021-04-23;366;166;15644;8883;5.6;3.2
976;2021-04-24;413;128;16057;9011;5.7;3.2
976;2021-04-25;3;0;16060;9011;5.7;3.2
976;2021-04-26;55;8;16115;9019;5.8;3.2
976;2021-04-27;351;292;16466;9311;5.9;3.3
976;2021-04-28;355;512;16821;9823;6.0;3.5
976;2021-04-29;559;343;17380;10166;6.2;3.6
976;2021-04-30;408;238;17788;10404;6.4;3.7
976;2021-05-01;671;286;18459;10690;6.6;3.8
976;2021-05-02;0;0;18459;10690;6.6;3.8
976;2021-05-03;140;6;18599;10696;6.7;3.8
976;2021-05-04;354;425;18953;11121;6.8;4.0
976;2021-05-05;447;318;19400;11439;6.9;4.1
976;2021-05-06;320;202;19720;11641;7.1;4.2
976;2021-05-07;341;133;20061;11774;7.2;4.2
976;2021-05-08;309;141;20370;11915;7.3;4.3
976;2021-05-09;0;0;20370;11915;7.3;4.3
976;2021-05-10;9;9;20379;11924;7.3;4.3
976;2021-05-11;363;492;20742;12416;7.4;4.4
976;2021-05-12;334;310;21076;12726;7.5;4.6
976;2021-05-13;126;96;21202;12822;7.6;4.6
976;2021-05-14;0;0;21202;12822;7.6;4.6
976;2021-05-15;485;282;21687;13104;7.8;4.7
976;2021-05-16;1;0;21688;13104;7.8;4.7
976;2021-05-17;124;51;21812;13155;7.8;4.7
976;2021-05-18;518;430;22330;13585;8.0;4.9
976;2021-05-19;651;663;22981;14248;8.2;5.1
976;2021-05-20;1057;499;24038;14747;8.6;5.3
976;2021-05-21;1046;313;25084;15060;9.0;5.4
976;2021-05-22;1240;298;26324;15358;9.4;5.5
976;2021-05-23;0;0;26324;15358;9.4;5.5
976;2021-05-24;1;0;26325;15358;9.4;5.5
976;2021-05-25;888;622;27213;15980;9.7;5.7
976;2021-05-26;1033;842;28246;16822;10.1;6.0
976;2021-05-27;1321;512;29567;17334;10.6;6.2
976;2021-05-28;956;375;30523;17709;10.9;6.3
976;2021-05-29;1130;392;31653;18101;11.3;6.5
976;2021-05-30;1;1;31654;18102;11.3;6.5
976;2021-05-31;107;6;31761;18108;11.4;6.5
976;2021-06-01;1149;651;32910;18759;11.8;6.7
976;2021-06-02;1243;531;34153;19290;12.2;6.9
976;2021-06-03;813;355;34966;19645;12.5;7.0
976;2021-06-04;1000;325;35966;19970;12.9;7.1
976;2021-06-05;680;299;36646;20269;13.1;7.3
976;2021-06-06;1;0;36647;20269;13.1;7.3
976;2021-06-07;91;12;36738;20281;13.1;7.3
976;2021-06-08;952;442;37690;20723;13.5;7.4
976;2021-06-09;969;550;38659;21273;13.8;7.6
976;2021-06-10;704;232;39363;21505;14.1;7.7
976;2021-06-11;850;365;40213;21870;14.4;7.8
976;2021-06-12;583;275;40796;22145;14.6;7.9
976;2021-06-13;2;0;40798;22145;14.6;7.9
976;2021-06-14;187;112;40985;22257;14.7;8.0
976;2021-06-15;412;838;41397;23095;14.8;8.3
976;2021-06-16;891;1441;42288;24536;15.1;8.8
976;2021-06-17;797;661;43085;25197;15.4;9.0
976;2021-06-18;705;620;43790;25817;15.7;9.2
976;2021-06-19;537;645;44327;26462;15.9;9.5
976;2021-06-20;1;0;44328;26462;15.9;9.5
976;2021-06-21;127;132;44455;26594;15.9;9.5
976;2021-06-22;429;1150;44884;27744;16.1;9.9
976;2021-06-23;691;1186;45575;28930;16.3;10.4
976;2021-06-24;480;544;46055;29474;16.5;10.5
976;2021-06-25;542;479;46597;29953;16.7;10.7
976;2021-06-26;386;692;46983;30645;16.8;11.0
976;2021-06-27;1;0;46984;30645;16.8;11.0
976;2021-06-28;108;191;47092;30836;16.9;11.0
976;2021-06-29;742;973;47834;31809;17.1;11.4
976;2021-06-30;707;948;48541;32757;17.4;11.7
976;2021-07-01;583;547;49124;33304;17.6;11.9
976;2021-07-02;451;432;49575;33736;17.7;12.1
976;2021-07-03;443;422;50018;34158;17.9;12.2
976;2021-07-04;2;0;50020;34158;17.9;12.2
976;2021-07-05;121;223;50141;34381;17.9;12.3
976;2021-07-06;498;865;50639;35246;18.1;12.6
976;2021-07-07;770;1014;51409;36260;18.4;13.0
976;2021-07-08;830;636;52239;36896;18.7;13.2
976;2021-07-09;786;519;53025;37415;19.0;13.4
976;2021-07-10;441;319;53466;37734;19.1;13.5
976;2021-07-11;0;0;53466;37734;19.1;13.5
976;2021-07-12;164;170;53630;37904;19.2;13.6
976;2021-07-13;847;1000;54477;38904;19.5;13.9
976;2021-07-14;0;5;54477;38909;19.5;13.9
976;2021-07-15;1220;812;55697;39721;19.9;14.2
976;2021-07-16;1292;657;56989;40378;20.4;14.4
976;2021-07-17;1033;377;58022;40755;20.8;14.6
976;2021-07-18;0;0;58022;40755;20.8;14.6
976;2021-07-19;206;134;58228;40889;20.8;14.6
976;2021-07-20;1155;877;59383;41766;21.2;14.9
976;2021-07-21;34;29;59417;41795;21.3;15.0
976;2021-07-22;1123;666;60540;42461;21.7;15.2
976;2021-07-23;1206;545;61746;43006;22.1;15.4
976;2021-07-24;855;440;62601;43446;22.4;15.5
976;2021-07-25;2;0;62603;43446;22.4;15.5
976;2021-07-26;180;37;62783;43483;22.5;15.6
976;2021-07-27;1138;826;63921;44309;22.9;15.9
976;2021-07-28;1041;634;64962;44943;23.2;16.1
976;2021-07-29;1233;566;66195;45509;23.7;16.3
976;2021-07-30;1212;412;67407;45921;24.1;16.4
976;2021-07-31;760;277;68167;46198;24.4;16.5
976;2021-08-01;5;3;68172;46201;24.4;16.5
976;2021-08-02;343;174;68515;46375;24.5;16.6
976;2021-08-03;1504;935;70019;47310;25.1;16.9
976;2021-08-04;1827;808;71846;48118;25.7;17.2
976;2021-08-05;1462;504;73308;48622;26.2;17.4
976;2021-08-06;1691;509;74999;49131;26.8;17.6
976;2021-08-07;912;357;75911;49488;27.2;17.7
976;2021-08-08;7;1;75918;49489;27.2;17.7
976;2021-08-09;529;236;76447;49725;27.4;17.8
976;2021-08-10;1641;1380;78088;51105;27.9;18.3
976;2021-08-11;2043;1239;80131;52344;28.7;18.7
976;2021-08-12;1709;620;81840;52964;29.3;19.0
976;2021-08-13;1574;534;83414;53498;29.8;19.1
976;2021-08-14;833;456;84247;53954;30.1;19.3
976;2021-08-15;0;0;84247;53954;30.1;19.3
976;2021-08-16;568;291;84815;54245;30.3;19.4
976;2021-08-17;1828;1300;86643;55545;31.0;19.9
976;2021-08-18;2230;1226;88873;56771;31.8;20.3
976;2021-08-19;1981;555;90854;57326;32.5;20.5
976;2021-08-20;1801;548;92655;57874;33.2;20.7
976;2021-08-21;1057;521;93712;58395;33.5;20.9
976;2021-08-22;12;0;93724;58395;33.5;20.9
976;2021-08-23;574;271;94298;58666;33.7;21.0
976;2021-08-24;1063;1008;95361;59674;34.1;21.4
976;2021-08-25;1080;1293;96441;60967;34.5;21.8
976;2021-08-26;909;574;97350;61541;34.8;22.0
976;2021-08-27;739;565;98089;62106;35.1;22.2
976;2021-08-28;471;858;98560;62964;35.3;22.5
976;2021-08-29;0;12;98560;62976;35.3;22.5
976;2021-08-30;149;256;98709;63232;35.3;22.6
976;2021-08-31;655;1162;99364;64394;35.6;23.0
976;2021-09-01;815;1396;100179;65790;35.8;23.5
976;2021-09-02;845;903;101024;66693;36.1;23.9
976;2021-09-03;910;1296;101934;67989;36.5;24.3
976;2021-09-04;432;1000;102366;68989;36.6;24.7
976;2021-09-05;0;1;102366;68990;36.6;24.7
976;2021-09-06;445;402;102811;69392;36.8;24.8
976;2021-09-07;738;703;103549;70095;37.1;25.1
976;2021-09-08;1090;1265;104639;71360;37.4;25.5
976;2021-09-09;875;1016;105514;72376;37.8;25.9
976;2021-09-10;1197;1084;106711;73460;38.2;26.3
976;2021-09-11;530;1036;107241;74496;38.4;26.7
976;2021-09-12;0;32;107241;74528;38.4;26.7
976;2021-09-13;701;618;107942;75146;38.6;26.9
976;2021-09-14;1046;722;108988;75868;39.0;27.1
976;2021-09-15;1683;1181;110671;77049;39.6;27.6
976;2021-09-16;1731;893;112402;77942;40.2;27.9
976;2021-09-17;1842;1061;114244;79003;40.9;28.3
976;2021-09-18;952;783;115196;79786;41.2;28.5
976;2021-09-19;1;52;115197;79838;41.2;28.6
976;2021-09-20;1004;543;116201;80381;41.6;28.8
976;2021-09-21;1650;769;117851;81150;42.2;29.0
976;2021-09-22;1438;964;119289;82114;42.7;29.4
976;2021-09-23;1021;879;120310;82993;43.0;29.7
976;2021-09-24;1085;1011;121395;84004;43.4;30.1
976;2021-09-25;489;478;121884;84482;43.6;30.2
976;2021-09-26;0;21;121884;84503;43.6;30.2
976;2021-09-27;691;423;122575;84926;43.9;30.4
976;2021-09-28;1167;924;123742;85850;44.3;30.7
976;2021-09-29;1319;1057;125061;86907;44.7;31.1
976;2021-09-30;993;684;126054;87591;45.1;31.3
976;2021-10-01;1209;1362;127263;88953;45.5;31.8
976;2021-10-02;452;648;127715;89601;45.7;32.1
976;2021-10-03;0;0;127715;89601;45.7;32.1
977;2020-12-27;0;0;0;0;0.0;0.0
977;2020-12-28;0;0;0;0;0.0;0.0
977;2020-12-29;0;0;0;0;0.0;0.0
977;2020-12-30;0;0;0;0;0.0;0.0
977;2020-12-31;0;0;0;0;0.0;0.0
977;2021-01-01;0;0;0;0;0.0;0.0
977;2021-01-02;0;0;0;0;0.0;0.0
977;2021-01-03;0;0;0;0;0.0;0.0
977;2021-01-04;0;0;0;0;0.0;0.0
977;2021-01-05;0;0;0;0;0.0;0.0
977;2021-01-06;0;0;0;0;0.0;0.0
977;2021-01-07;0;0;0;0;0.0;0.0
977;2021-01-08;0;0;0;0;0.0;0.0
977;2021-01-09;0;0;0;0;0.0;0.0
977;2021-01-10;0;0;0;0;0.0;0.0
977;2021-01-11;0;0;0;0;0.0;0.0
977;2021-01-12;0;0;0;0;0.0;0.0
977;2021-01-13;0;0;0;0;0.0;0.0
977;2021-01-14;0;0;0;0;0.0;0.0
977;2021-01-15;0;0;0;0;0.0;0.0
977;2021-01-16;0;0;0;0;0.0;0.0
977;2021-01-17;0;0;0;0;0.0;0.0
977;2021-01-18;1;0;1;0;0.0;0.0
977;2021-01-19;0;0;1;0;0.0;0.0
977;2021-01-20;0;0;1;0;0.0;0.0
977;2021-01-21;12;0;13;0;0.1;0.0
977;2021-01-22;12;0;25;0;0.3;0.0
977;2021-01-23;0;0;25;0;0.3;0.0
977;2021-01-24;0;0;25;0;0.3;0.0
977;2021-01-25;0;0;25;0;0.3;0.0
977;2021-01-26;0;0;25;0;0.3;0.0
977;2021-01-27;12;0;37;0;0.4;0.0
977;2021-01-28;1;0;38;0;0.4;0.0
977;2021-01-29;6;0;44;0;0.4;0.0
977;2021-01-30;0;0;44;0;0.4;0.0
977;2021-01-31;0;0;44;0;0.4;0.0
977;2021-02-01;0;0;44;0;0.4;0.0
977;2021-02-02;0;0;44;0;0.4;0.0
977;2021-02-03;11;0;55;0;0.6;0.0
977;2021-02-04;12;0;67;0;0.7;0.0
977;2021-02-05;11;0;78;0;0.8;0.0
977;2021-02-06;0;0;78;0;0.8;0.0
977;2021-02-07;0;0;78;0;0.8;0.0
977;2021-02-08;0;0;78;0;0.8;0.0
977;2021-02-09;14;0;92;0;0.9;0.0
977;2021-02-10;0;0;92;0;0.9;0.0
977;2021-02-11;18;0;110;0;1.1;0.0
977;2021-02-12;46;0;156;0;1.6;0.0
977;2021-02-13;0;0;156;0;1.6;0.0
977;2021-02-14;0;0;156;0;1.6;0.0
977;2021-02-15;0;0;156;0;1.6;0.0
977;2021-02-16;0;0;156;0;1.6;0.0
977;2021-02-17;0;0;156;0;1.6;0.0
977;2021-02-18;19;0;175;0;1.8;0.0
977;2021-02-19;35;0;210;0;2.1;0.0
977;2021-02-20;0;0;210;0;2.1;0.0
977;2021-02-21;0;0;210;0;2.1;0.0
977;2021-02-22;0;0;210;0;2.1;0.0
977;2021-02-23;0;18;210;18;2.1;0.2
977;2021-02-24;0;0;210;18;2.1;0.2
977;2021-02-25;15;3;225;21;2.3;0.2
977;2021-02-26;33;17;258;38;2.6;0.4
977;2021-02-27;0;0;258;38;2.6;0.4
977;2021-02-28;0;0;258;38;2.6;0.4
977;2021-03-01;0;0;258;38;2.6;0.4
977;2021-03-02;19;11;277;49;2.8;0.5
977;2021-03-03;0;0;277;49;2.8;0.5
977;2021-03-04;16;9;293;58;2.9;0.6
977;2021-03-05;35;16;328;74;3.3;0.7
977;2021-03-06;0;0;328;74;3.3;0.7
977;2021-03-07;0;0;328;74;3.3;0.7
977;2021-03-08;0;0;328;74;3.3;0.7
977;2021-03-09;1;0;329;74;3.3;0.7
977;2021-03-10;0;0;329;74;3.3;0.7
977;2021-03-11;20;26;349;100;3.5;1.0
977;2021-03-12;62;42;411;142;4.1;1.4
977;2021-03-13;0;0;411;142;4.1;1.4
977;2021-03-14;0;0;411;142;4.1;1.4
977;2021-03-15;0;0;411;142;4.1;1.4
977;2021-03-16;30;10;441;152;4.4;1.5
977;2021-03-17;0;0;441;152;4.4;1.5
977;2021-03-18;30;16;471;168;4.7;1.7
977;2021-03-19;58;27;529;195;5.3;2.0
977;2021-03-20;0;0;529;195;5.3;2.0
977;2021-03-21;0;0;529;195;5.3;2.0
977;2021-03-22;0;0;529;195;5.3;2.0
977;2021-03-23;0;0;529;195;5.3;2.0
977;2021-03-24;0;0;529;195;5.3;2.0
977;2021-03-25;65;17;594;212;6.0;2.1
977;2021-03-26;73;25;667;237;6.7;2.4
977;2021-03-27;0;0;667;237;6.7;2.4
977;2021-03-28;0;0;667;237;6.7;2.4
977;2021-03-29;0;0;667;237;6.7;2.4
977;2021-03-30;39;16;706;253;7.1;2.5
977;2021-03-31;26;14;732;267;7.3;2.7
977;2021-04-01;25;32;757;299;7.6;3.0
977;2021-04-02;0;0;757;299;7.6;3.0
977;2021-04-03;0;0;757;299;7.6;3.0
977;2021-04-04;0;0;757;299;7.6;3.0
977;2021-04-05;9;0;766;299;7.7;3.0
977;2021-04-06;0;0;766;299;7.7;3.0
977;2021-04-07;0;0;766;299;7.7;3.0
977;2021-04-08;57;46;823;345;8.3;3.5
977;2021-04-09;58;31;881;376;8.8;3.8
977;2021-04-10;0;0;881;376;8.8;3.8
977;2021-04-11;0;0;881;376;8.8;3.8
977;2021-04-12;0;0;881;376;8.8;3.8
977;2021-04-13;0;0;881;376;8.8;3.8
977;2021-04-14;5;5;886;381;8.9;3.8
977;2021-04-15;57;70;943;451;9.5;4.5
977;2021-04-16;89;35;1032;486;10.4;4.9
977;2021-04-17;0;1;1032;487;10.4;4.9
977;2021-04-18;0;0;1032;487;10.4;4.9
977;2021-04-19;1;0;1033;487;10.4;4.9
977;2021-04-20;335;62;1368;549;13.7;5.5
977;2021-04-21;337;30;1705;579;17.1;5.8
977;2021-04-22;284;47;1989;626;20.0;6.3
977;2021-04-23;260;42;2249;668;22.6;6.7
977;2021-04-24;231;1;2480;669;24.9;6.7
977;2021-04-25;0;0;2480;669;24.9;6.7
977;2021-04-26;283;19;2763;688;27.7;6.9
977;2021-04-27;224;67;2987;755;30.0;7.6
977;2021-04-28;192;26;3179;781;31.9;7.8
977;2021-04-29;170;23;3349;804;33.6;8.1
977;2021-04-30;171;16;3520;820;35.3;8.2
977;2021-05-01;202;11;3722;831;37.4;8.3
977;2021-05-02;0;0;3722;831;37.4;8.3
977;2021-05-03;135;9;3857;840;38.7;8.4
977;2021-05-04;161;54;4018;894;40.3;9.0
977;2021-05-05;221;28;4239;922;42.6;9.3
977;2021-05-06;175;33;4414;955;44.3;9.6
977;2021-05-07;149;32;4563;987;45.8;9.9
977;2021-05-08;1;0;4564;987;45.8;9.9
977;2021-05-09;0;0;4564;987;45.8;9.9
977;2021-05-10;0;0;4564;987;45.8;9.9
977;2021-05-11;3;41;4567;1028;45.8;10.3
977;2021-05-12;6;36;4573;1064;45.9;10.7
977;2021-05-13;0;0;4573;1064;45.9;10.7
977;2021-05-14;28;98;4601;1162;46.2;11.7
977;2021-05-15;0;0;4601;1162;46.2;11.7
977;2021-05-16;1;0;4602;1162;46.2;11.7
977;2021-05-17;1;14;4603;1176;46.2;11.8
977;2021-05-18;17;32;4620;1208;46.4;12.1
977;2021-05-19;1;2;4621;1210;46.4;12.1
977;2021-05-20;0;8;4621;1218;46.4;12.2
977;2021-05-21;12;31;4633;1249;46.5;12.5
977;2021-05-22;0;0;4633;1249;46.5;12.5
977;2021-05-23;0;0;4633;1249;46.5;12.5
977;2021-05-24;0;0;4633;1249;46.5;12.5
977;2021-05-25;50;331;4683;1580;47.0;15.9
977;2021-05-26;54;360;4737;1940;47.6;19.5
977;2021-05-27;34;317;4771;2257;47.9;22.7
977;2021-05-28;27;256;4798;2513;48.2;25.2
977;2021-05-29;35;375;4833;2888;48.5;29.0
977;2021-05-30;1;0;4834;2888;48.5;29.0
977;2021-05-31;45;216;4879;3104;49.0;31.2
977;2021-06-01;48;227;4927;3331;49.5;33.4
977;2021-06-02;69;273;4996;3604;50.2;36.2
977;2021-06-03;43;252;5039;3856;50.6;38.7
977;2021-06-04;82;270;5121;4126;51.4;41.4
977;2021-06-05;1;0;5122;4126;51.4;41.4
977;2021-06-06;0;0;5122;4126;51.4;41.4
977;2021-06-07;1;1;5123;4127;51.4;41.4
977;2021-06-08;8;2;5131;4129;51.5;41.5
977;2021-06-09;0;3;5131;4132;51.5;41.5
977;2021-06-10;8;4;5139;4136;51.6;41.5
977;2021-06-11;4;8;5143;4144;51.6;41.6
977;2021-06-12;15;59;5158;4203;51.8;42.2
977;2021-06-13;0;0;5158;4203;51.8;42.2
977;2021-06-14;0;0;5158;4203;51.8;42.2
977;2021-06-15;0;1;5158;4204;51.8;42.2
977;2021-06-16;0;0;5158;4204;51.8;42.2
977;2021-06-17;2;6;5160;4210;51.8;42.3
977;2021-06-18;0;2;5160;4212;51.8;42.3
977;2021-06-19;25;49;5185;4261;52.1;42.8
977;2021-06-20;0;0;5185;4261;52.1;42.8
977;2021-06-21;1;2;5186;4263;52.1;42.8
977;2021-06-22;9;0;5195;4263;52.2;42.8
977;2021-06-23;15;9;5210;4272;52.3;42.9
977;2021-06-24;10;5;5220;4277;52.4;42.9
977;2021-06-25;0;0;5220;4277;52.4;42.9
977;2021-06-26;25;45;5245;4322;52.7;43.4
977;2021-06-27;0;0;5245;4322;52.7;43.4
977;2021-06-28;0;0;5245;4322;52.7;43.4
977;2021-06-29;0;0;5245;4322;52.7;43.4
977;2021-06-30;0;0;5245;4322;52.7;43.4
977;2021-07-01;28;36;5273;4358;52.9;43.8
977;2021-07-02;26;31;5299;4389;53.2;44.1
977;2021-07-03;30;215;5329;4604;53.5;46.2
977;2021-07-04;0;0;5329;4604;53.5;46.2
977;2021-07-05;4;8;5333;4612;53.5;46.3
977;2021-07-06;0;0;5333;4612;53.5;46.3
977;2021-07-07;8;0;5341;4612;53.6;46.3
977;2021-07-08;33;23;5374;4635;54.0;46.5
977;2021-07-09;23;31;5397;4666;54.2;46.8
977;2021-07-10;33;45;5430;4711;54.5;47.3
977;2021-07-11;0;0;5430;4711;54.5;47.3
977;2021-07-12;0;1;5430;4712;54.5;47.3
977;2021-07-13;10;10;5440;4722;54.6;47.4
977;2021-07-14;0;0;5440;4722;54.6;47.4
977;2021-07-15;1;11;5441;4733;54.6;47.5
977;2021-07-16;44;51;5485;4784;55.1;48.0
977;2021-07-17;34;39;5519;4823;55.4;48.4
977;2021-07-18;1;0;5520;4823;55.4;48.4
977;2021-07-19;3;2;5523;4825;55.4;48.4
977;2021-07-20;3;1;5526;4826;55.5;48.4
977;2021-07-21;33;16;5559;4842;55.8;48.6
977;2021-07-22;36;33;5595;4875;56.2;48.9
977;2021-07-23;32;31;5627;4906;56.5;49.3
977;2021-07-24;42;25;5669;4931;56.9;49.5
977;2021-07-25;0;0;5669;4931;56.9;49.5
977;2021-07-26;13;10;5682;4941;57.0;49.6
977;2021-07-27;0;10;5682;4951;57.0;49.7
977;2021-07-28;31;14;5713;4965;57.4;49.8
977;2021-07-29;33;32;5746;4997;57.7;50.2
977;2021-07-30;31;28;5777;5025;58.0;50.4
977;2021-07-31;53;24;5830;5049;58.5;50.7
977;2021-08-01;0;0;5830;5049;58.5;50.7
977;2021-08-02;11;1;5841;5050;58.6;50.7
977;2021-08-03;0;0;5841;5050;58.6;50.7
977;2021-08-04;40;14;5881;5064;59.0;50.8
977;2021-08-05;28;30;5909;5094;59.3;51.1
977;2021-08-06;35;35;5944;5129;59.7;51.5
977;2021-08-07;56;25;6000;5154;60.2;51.7
977;2021-08-08;0;0;6000;5154;60.2;51.7
977;2021-08-09;7;5;6007;5159;60.3;51.8
977;2021-08-10;15;9;6022;5168;60.5;51.9
977;2021-08-11;36;18;6058;5186;60.8;52.1
977;2021-08-12;24;30;6082;5216;61.1;52.4
977;2021-08-13;32;14;6114;5230;61.4;52.5
977;2021-08-14;20;26;6134;5256;61.6;52.8
977;2021-08-15;0;0;6134;5256;61.6;52.8
977;2021-08-16;14;29;6148;5285;61.7;53.1
977;2021-08-17;15;8;6163;5293;61.9;53.1
977;2021-08-18;25;28;6188;5321;62.1;53.4
977;2021-08-19;31;36;6219;5357;62.4;53.8
977;2021-08-20;27;41;6246;5398;62.7;54.2
977;2021-08-21;34;41;6280;5439;63.0;54.6
977;2021-08-22;6;0;6286;5439;63.1;54.6
977;2021-08-23;3;11;6289;5450;63.1;54.7
977;2021-08-24;8;3;6297;5453;63.2;54.7
977;2021-08-25;20;37;6317;5490;63.4;55.1
977;2021-08-26;27;41;6344;5531;63.7;55.5
977;2021-08-27;27;35;6371;5566;64.0;55.9
977;2021-08-28;27;56;6398;5622;64.2;56.4
977;2021-08-29;0;0;6398;5622;64.2;56.4
977;2021-08-30;1;4;6399;5626;64.2;56.5
977;2021-08-31;1;2;6400;5628;64.3;56.5
977;2021-09-01;10;28;6410;5656;64.4;56.8
977;2021-09-02;22;35;6432;5691;64.6;57.1
977;2021-09-03;26;25;6458;5716;64.8;57.4
977;2021-09-04;37;49;6495;5765;65.2;57.9
977;2021-09-05;0;0;6495;5765;65.2;57.9
977;2021-09-06;4;16;6499;5781;65.2;58.0
977;2021-09-07;1;4;6500;5785;65.3;58.1
977;2021-09-08;12;13;6512;5798;65.4;58.2
977;2021-09-09;20;36;6532;5834;65.6;58.6
977;2021-09-10;7;31;6539;5865;65.6;58.9
977;2021-09-11;36;31;6575;5896;66.0;59.2
977;2021-09-12;0;6;6575;5902;66.0;59.3
977;2021-09-13;4;4;6579;5906;66.0;59.3
977;2021-09-14;1;0;6580;5906;66.1;59.3
977;2021-09-15;11;26;6591;5932;66.2;59.6
977;2021-09-16;15;31;6606;5963;66.3;59.9
977;2021-09-17;10;32;6616;5995;66.4;60.2
977;2021-09-18;21;39;6637;6034;66.6;60.6
977;2021-09-19;0;0;6637;6034;66.6;60.6
977;2021-09-20;0;2;6637;6036;66.6;60.6
977;2021-09-21;0;1;6637;6037;66.6;60.6
977;2021-09-22;10;11;6647;6048;66.7;60.7
977;2021-09-23;7;30;6654;6078;66.8;61.0
977;2021-09-24;0;0;6654;6078;66.8;61.0
977;2021-09-25;11;49;6665;6127;66.9;61.5
977;2021-09-26;0;0;6665;6127;66.9;61.5
977;2021-09-27;0;0;6665;6127;66.9;61.5
977;2021-09-28;0;1;6665;6128;66.9;61.5
977;2021-09-29;5;15;6670;6143;67.0;61.7
977;2021-09-30;18;19;6688;6162;67.1;61.9
977;2021-10-01;0;3;6688;6165;67.1;61.9
977;2021-10-02;10;39;6698;6204;67.2;62.3
977;2021-10-03;0;0;6698;6204;67.2;62.3
978;2020-12-27;0;0;0;0;0.0;0.0
978;2020-12-28;0;0;0;0;0.0;0.0
978;2020-12-29;0;0;0;0;0.0;0.0
978;2020-12-30;0;0;0;0;0.0;0.0
978;2020-12-31;0;0;0;0;0.0;0.0
978;2021-01-01;0;0;0;0;0.0;0.0
978;2021-01-02;0;0;0;0;0.0;0.0
978;2021-01-03;0;0;0;0;0.0;0.0
978;2021-01-04;0;0;0;0;0.0;0.0
978;2021-01-05;0;0;0;0;0.0;0.0
978;2021-01-06;0;0;0;0;0.0;0.0
978;2021-01-07;0;0;0;0;0.0;0.0
978;2021-01-08;0;0;0;0;0.0;0.0
978;2021-01-09;0;0;0;0;0.0;0.0
978;2021-01-10;0;0;0;0;0.0;0.0
978;2021-01-11;0;0;0;0;0.0;0.0
978;2021-01-12;0;0;0;0;0.0;0.0
978;2021-01-13;10;0;10;0;0.0;0.0
978;2021-01-14;12;0;22;0;0.1;0.0
978;2021-01-15;9;0;31;0;0.1;0.0
978;2021-01-16;0;0;31;0;0.1;0.0
978;2021-01-17;0;0;31;0;0.1;0.0
978;2021-01-18;0;0;31;0;0.1;0.0
978;2021-01-19;12;0;43;0;0.1;0.0
978;2021-01-20;13;0;56;0;0.2;0.0
978;2021-01-21;6;0;62;0;0.2;0.0
978;2021-01-22;0;0;62;0;0.2;0.0
978;2021-01-23;0;0;62;0;0.2;0.0
978;2021-01-24;0;0;62;0;0.2;0.0
978;2021-01-25;0;0;62;0;0.2;0.0
978;2021-01-26;9;0;71;0;0.2;0.0
978;2021-01-27;10;0;81;0;0.2;0.0
978;2021-01-28;6;1;87;1;0.2;0.0
978;2021-01-29;0;0;87;1;0.2;0.0
978;2021-01-30;0;0;87;1;0.2;0.0
978;2021-01-31;0;0;87;1;0.2;0.0
978;2021-02-01;1;0;88;1;0.2;0.0
978;2021-02-02;39;0;127;1;0.4;0.0
978;2021-02-03;11;0;138;1;0.4;0.0
978;2021-02-04;32;0;170;1;0.5;0.0
978;2021-02-05;6;0;176;1;0.5;0.0
978;2021-02-06;0;0;176;1;0.5;0.0
978;2021-02-07;0;0;176;1;0.5;0.0
978;2021-02-08;0;0;176;1;0.5;0.0
978;2021-02-09;38;0;214;1;0.6;0.0
978;2021-02-10;27;1;241;2;0.7;0.0
978;2021-02-11;0;0;241;2;0.7;0.0
978;2021-02-12;36;0;277;2;0.8;0.0
978;2021-02-13;0;0;277;2;0.8;0.0
978;2021-02-14;0;0;277;2;0.8;0.0
978;2021-02-15;50;1;327;3;0.9;0.0
978;2021-02-16;0;0;327;3;0.9;0.0
978;2021-02-17;0;0;327;3;0.9;0.0
978;2021-02-18;28;0;355;3;1.0;0.0
978;2021-02-19;44;0;399;3;1.1;0.0
978;2021-02-20;0;0;399;3;1.1;0.0
978;2021-02-21;0;0;399;3;1.1;0.0
978;2021-02-22;45;4;444;7;1.3;0.0
978;2021-02-23;41;25;485;32;1.4;0.1
978;2021-02-24;36;1;521;33;1.5;0.1
978;2021-02-25;55;34;576;67;1.6;0.2
978;2021-02-26;39;5;615;72;1.7;0.2
978;2021-02-27;0;0;615;72;1.7;0.2
978;2021-02-28;0;0;615;72;1.7;0.2
978;2021-03-01;50;4;665;76;1.9;0.2
978;2021-03-02;7;19;672;95;1.9;0.3
978;2021-03-03;53;23;725;118;2.1;0.3
978;2021-03-04;31;18;756;136;2.1;0.4
978;2021-03-05;46;10;802;146;2.3;0.4
978;2021-03-06;0;0;802;146;2.3;0.4
978;2021-03-07;0;0;802;146;2.3;0.4
978;2021-03-08;32;5;834;151;2.4;0.4
978;2021-03-09;21;23;855;174;2.4;0.5
978;2021-03-10;35;25;890;199;2.5;0.6
978;2021-03-11;2;0;892;199;2.5;0.6
978;2021-03-12;53;20;945;219;2.7;0.6
978;2021-03-13;13;0;958;219;2.7;0.6
978;2021-03-14;0;0;958;219;2.7;0.6
978;2021-03-15;31;41;989;260;2.8;0.7
978;2021-03-16;73;5;1062;265;3.0;0.7
978;2021-03-17;67;13;1129;278;3.2;0.8
978;2021-03-18;82;38;1211;316;3.4;0.9
978;2021-03-19;32;50;1243;366;3.5;1.0
978;2021-03-20;0;0;1243;366;3.5;1.0
978;2021-03-21;0;0;1243;366;3.5;1.0
978;2021-03-22;35;45;1278;411;3.6;1.2
978;2021-03-23;30;43;1308;454;3.7;1.3
978;2021-03-24;38;42;1346;496;3.8;1.4
978;2021-03-25;97;34;1443;530;4.1;1.5
978;2021-03-26;45;33;1488;563;4.2;1.6
978;2021-03-27;94;3;1582;566;4.5;1.6
978;2021-03-28;0;0;1582;566;4.5;1.6
978;2021-03-29;69;46;1651;612;4.7;1.7
978;2021-03-30;99;24;1750;636;5.0;1.8
978;2021-03-31;91;49;1841;685;5.2;1.9
978;2021-04-01;57;48;1898;733;5.4;2.1
978;2021-04-02;0;0;1898;733;5.4;2.1
978;2021-04-03;1;0;1899;733;5.4;2.1
978;2021-04-04;0;0;1899;733;5.4;2.1
978;2021-04-05;2;0;1901;733;5.4;2.1
978;2021-04-06;49;63;1950;796;5.5;2.3
978;2021-04-07;93;33;2043;829;5.8;2.3
978;2021-04-08;122;7;2165;836;6.1;2.4
978;2021-04-09;91;39;2256;875;6.4;2.5
978;2021-04-10;170;13;2426;888;6.9;2.5
978;2021-04-11;0;0;2426;888;6.9;2.5
978;2021-04-12;42;74;2468;962;7.0;2.7
978;2021-04-13;49;71;2517;1033;7.1;2.9
978;2021-04-14;82;45;2599;1078;7.4;3.1
978;2021-04-15;92;22;2691;1100;7.6;3.1
978;2021-04-16;77;42;2768;1142;7.8;3.2
978;2021-04-17;165;5;2933;1147;8.3;3.2
978;2021-04-18;0;0;2933;1147;8.3;3.2
978;2021-04-19;52;67;2985;1214;8.4;3.4
978;2021-04-20;83;27;3068;1241;8.7;3.5
978;2021-04-21;91;29;3159;1270;8.9;3.6
978;2021-04-22;101;20;3260;1290;9.2;3.7
978;2021-04-23;45;65;3305;1355;9.4;3.8
978;2021-04-24;99;78;3404;1433;9.6;4.1
978;2021-04-25;0;0;3404;1433;9.6;4.1
978;2021-04-26;29;91;3433;1524;9.7;4.3
978;2021-04-27;59;63;3492;1587;9.9;4.5
978;2021-04-28;93;40;3585;1627;10.1;4.6
978;2021-04-29;89;31;3674;1658;10.4;4.7
978;2021-04-30;103;14;3777;1672;10.7;4.7
978;2021-05-01;0;8;3777;1680;10.7;4.8
978;2021-05-02;0;0;3777;1680;10.7;4.8
978;2021-05-03;25;99;3802;1779;10.8;5.0
978;2021-05-04;159;101;3961;1880;11.2;5.3
978;2021-05-05;142;59;4103;1939;11.6;5.5
978;2021-05-06;199;49;4302;1988;12.2;5.6
978;2021-05-07;127;71;4429;2059;12.5;5.8
978;2021-05-08;69;122;4498;2181;12.7;6.2
978;2021-05-09;0;0;4498;2181;12.7;6.2
978;2021-05-10;124;100;4622;2281;13.1;6.5
978;2021-05-11;132;72;4754;2353;13.5;6.7
978;2021-05-12;155;78;4909;2431;13.9;6.9
978;2021-05-13;83;6;4992;2437;14.1;6.9
978;2021-05-14;130;62;5122;2499;14.5;7.1
978;2021-05-15;86;4;5208;2503;14.7;7.1
978;2021-05-16;0;0;5208;2503;14.7;7.1
978;2021-05-17;146;115;5354;2618;15.2;7.4
978;2021-05-18;151;94;5505;2712;15.6;7.7
978;2021-05-19;84;69;5589;2781;15.8;7.9
978;2021-05-20;104;26;5693;2807;16.1;7.9
978;2021-05-21;98;52;5791;2859;16.4;8.1
978;2021-05-22;99;11;5890;2870;16.7;8.1
978;2021-05-23;0;0;5890;2870;16.7;8.1
978;2021-05-24;33;7;5923;2877;16.8;8.1
978;2021-05-25;119;78;6042;2955;17.1;8.4
978;2021-05-26;108;49;6150;3004;17.4;8.5
978;2021-05-27;112;42;6262;3046;17.7;8.6
978;2021-05-28;33;1;6295;3047;17.8;8.6
978;2021-05-29;60;213;6355;3260;18.0;9.2
978;2021-05-30;0;0;6355;3260;18.0;9.2
978;2021-05-31;111;63;6466;3323;18.3;9.4
978;2021-06-01;116;62;6582;3385;18.6;9.6
978;2021-06-02;131;33;6713;3418;19.0;9.7
978;2021-06-03;101;38;6814;3456;19.3;9.8
978;2021-06-04;128;70;6942;3526;19.6;10.0
978;2021-06-05;83;21;7025;3547;19.9;10.0
978;2021-06-06;0;0;7025;3547;19.9;10.0
978;2021-06-07;96;96;7121;3643;20.2;10.3
978;2021-06-08;82;89;7203;3732;20.4;10.6
978;2021-06-09;99;73;7302;3805;20.7;10.8
978;2021-06-10;112;63;7414;3868;21.0;10.9
978;2021-06-11;116;106;7530;3974;21.3;11.2
978;2021-06-12;57;30;7587;4004;21.5;11.3
978;2021-06-13;0;0;7587;4004;21.5;11.3
978;2021-06-14;105;127;7692;4131;21.8;11.7
978;2021-06-15;88;120;7780;4251;22.0;12.0
978;2021-06-16;105;148;7885;4399;22.3;12.4
978;2021-06-17;85;72;7970;4471;22.6;12.7
978;2021-06-18;67;98;8037;4569;22.7;12.9
978;2021-06-19;65;79;8102;4648;22.9;13.2
978;2021-06-20;0;0;8102;4648;22.9;13.2
978;2021-06-21;78;150;8180;4798;23.2;13.6
978;2021-06-22;71;103;8251;4901;23.4;13.9
978;2021-06-23;68;115;8319;5016;23.5;14.2
978;2021-06-24;43;75;8362;5091;23.7;14.4
978;2021-06-25;64;100;8426;5191;23.8;14.7
978;2021-06-26;35;61;8461;5252;23.9;14.9
978;2021-06-27;0;0;8461;5252;23.9;14.9
978;2021-06-28;73;131;8534;5383;24.2;15.2
978;2021-06-29;62;104;8596;5487;24.3;15.5
978;2021-06-30;56;110;8652;5597;24.5;15.8
978;2021-07-01;42;87;8694;5684;24.6;16.1
978;2021-07-02;52;90;8746;5774;24.8;16.3
978;2021-07-03;40;90;8786;5864;24.9;16.6
978;2021-07-04;0;1;8786;5865;24.9;16.6
978;2021-07-05;67;93;8853;5958;25.1;16.9
978;2021-07-06;55;74;8908;6032;25.2;17.1
978;2021-07-07;55;123;8963;6155;25.4;17.4
978;2021-07-08;54;107;9017;6262;25.5;17.7
978;2021-07-09;45;92;9062;6354;25.6;18.0
978;2021-07-10;38;85;9100;6439;25.8;18.2
978;2021-07-11;0;4;9100;6443;25.8;18.2
978;2021-07-12;71;130;9171;6573;26.0;18.6
978;2021-07-13;146;162;9317;6735;26.4;19.1
978;2021-07-14;3;0;9320;6735;26.4;19.1
978;2021-07-15;161;195;9481;6930;26.8;19.6
978;2021-07-16;113;113;9594;7043;27.2;19.9
978;2021-07-17;52;100;9646;7143;27.3;20.2
978;2021-07-18;0;0;9646;7143;27.3;20.2
978;2021-07-19;99;133;9745;7276;27.6;20.6
978;2021-07-20;80;74;9825;7350;27.8;20.8
978;2021-07-21;63;50;9888;7400;28.0;20.9
978;2021-07-22;97;114;9985;7514;28.3;21.3
978;2021-07-23;67;98;10052;7612;28.4;21.5
978;2021-07-24;20;35;10072;7647;28.5;21.6
978;2021-07-25;0;0;10072;7647;28.5;21.6
978;2021-07-26;99;116;10171;7763;28.8;22.0
978;2021-07-27;72;144;10243;7907;29.0;22.4
978;2021-07-28;72;126;10315;8033;29.2;22.7
978;2021-07-29;80;98;10395;8131;29.4;23.0
978;2021-07-30;82;115;10477;8246;29.7;23.3
978;2021-07-31;49;68;10526;8314;29.8;23.5
978;2021-08-01;0;0;10526;8314;29.8;23.5
978;2021-08-02;65;95;10591;8409;30.0;23.8
978;2021-08-03;60;94;10651;8503;30.1;24.1
978;2021-08-04;64;55;10715;8558;30.3;24.2
978;2021-08-05;48;70;10763;8628;30.5;24.4
978;2021-08-06;73;127;10836;8755;30.7;24.8
978;2021-08-07;44;46;10880;8801;30.8;24.9
978;2021-08-08;0;0;10880;8801;30.8;24.9
978;2021-08-09;138;150;11018;8951;31.2;25.3
978;2021-08-10;81;93;11099;9044;31.4;25.6
978;2021-08-11;106;99;11205;9143;31.7;25.9
978;2021-08-12;99;99;11304;9242;32.0;26.2
978;2021-08-13;132;75;11436;9317;32.4;26.4
978;2021-08-14;74;100;11510;9417;32.6;26.7
978;2021-08-15;0;0;11510;9417;32.6;26.7
978;2021-08-16;45;71;11555;9488;32.7;26.9
978;2021-08-17;33;33;11588;9521;32.8;26.9
978;2021-08-18;35;55;11623;9576;32.9;27.1
978;2021-08-19;34;26;11657;9602;33.0;27.2
978;2021-08-20;46;61;11703;9663;33.1;27.3
978;2021-08-21;0;0;11703;9663;33.1;27.3
978;2021-08-22;0;0;11703;9663;33.1;27.3
978;2021-08-23;51;87;11754;9750;33.3;27.6
978;2021-08-24;31;52;11785;9802;33.4;27.7
978;2021-08-25;26;51;11811;9853;33.4;27.9
978;2021-08-26;31;26;11842;9879;33.5;28.0
978;2021-08-27;47;88;11889;9967;33.6;28.2
978;2021-08-28;3;0;11892;9967;33.7;28.2
978;2021-08-29;0;0;11892;9967;33.7;28.2
978;2021-08-30;39;113;11931;10080;33.8;28.5
978;2021-08-31;46;81;11977;10161;33.9;28.8
978;2021-09-01;31;85;12008;10246;34.0;29.0
978;2021-09-02;38;70;12046;10316;34.1;29.2
978;2021-09-03;16;96;12062;10412;34.1;29.5
978;2021-09-04;0;0;12062;10412;34.1;29.5
978;2021-09-05;0;0;12062;10412;34.1;29.5
978;2021-09-06;32;80;12094;10492;34.2;29.7
978;2021-09-07;37;51;12131;10543;34.3;29.8
978;2021-09-08;21;45;12152;10588;34.4;30.0
978;2021-09-09;21;58;12173;10646;34.5;30.1
978;2021-09-10;43;82;12216;10728;34.6;30.4
978;2021-09-11;1;0;12217;10728;34.6;30.4
978;2021-09-12;5;1;12222;10729;34.6;30.4
978;2021-09-13;32;56;12254;10785;34.7;30.5
978;2021-09-14;23;33;12277;10818;34.7;30.6
978;2021-09-15;24;43;12301;10861;34.8;30.7
978;2021-09-16;8;33;12309;10894;34.8;30.8
978;2021-09-17;13;45;12322;10939;34.9;31.0
978;2021-09-18;0;0;12322;10939;34.9;31.0
978;2021-09-19;0;0;12322;10939;34.9;31.0
978;2021-09-20;10;35;12332;10974;34.9;31.1
978;2021-09-21;15;37;12347;11011;34.9;31.2
978;2021-09-22;13;34;12360;11045;35.0;31.3
978;2021-09-23;26;41;12386;11086;35.1;31.4
978;2021-09-24;19;27;12405;11113;35.1;31.5
978;2021-09-25;0;1;12405;11114;35.1;31.5
978;2021-09-26;0;0;12405;11114;35.1;31.5
978;2021-09-27;11;31;12416;11145;35.1;31.5
978;2021-09-28;19;25;12435;11170;35.2;31.6
978;2021-09-29;20;25;12455;11195;35.2;31.7
978;2021-09-30;23;23;12478;11218;35.3;31.7
978;2021-10-01;25;36;12503;11254;35.4;31.9
978;2021-10-02;0;0;12503;11254;35.4;31.9
978;2021-10-03;0;0;12503;11254;35.4;31.9
