reg;jour;n_dose1;n_complet;n_cum_dose1;n_cum_complet;couv_dose1;couv_complet
01;2020-12-27;0;0;0;0;0.0;0.0
01;2020-12-28;0;0;0;0;0.0;0.0
01;2020-12-29;0;0;0;0;0.0;0.0
01;2020-12-30;0;0;0;0;0.0;0.0
01;2020-12-31;0;0;0;0;0.0;0.0
01;2021-01-01;1;0;1;0;0.0;0.0
01;2021-01-02;0;0;1;0;0.0;0.0
01;2021-01-03;0;0;1;0;0.0;0.0
01;2021-01-04;1;0;2;0;0.0;0.0
01;2021-01-05;0;0;2;0;0.0;0.0
01;2021-01-06;1;0;3;0;0.0;0.0
01;2021-01-07;0;0;3;0;0.0;0.0
01;2021-01-08;48;0;51;0;0.0;0.0
01;2021-01-09;18;0;69;0;0.0;0.0
01;2021-01-10;0;0;69;0;0.0;0.0
01;2021-01-11;55;0;124;0;0.0;0.0
01;2021-01-12;40;0;164;0;0.0;0.0
01;2021-01-13;45;0;209;0;0.1;0.0
01;2021-01-14;60;0;269;0;0.1;0.0
01;2021-01-15;76;0;345;0;0.1;0.0
01;2021-01-16;0;0;345;0;0.1;0.0
01;2021-01-17;0;0;345;0;0.1;0.0
01;2021-01-18;75;0;420;0;0.1;0.0
01;2021-01-19;137;0;557;0;0.1;0.0
01;2021-01-20;134;0;691;0;0.2;0.0
01;2021-01-21;146;1;837;1;0.2;0.0
01;2021-01-22;131;0;968;1;0.3;0.0
01;2021-01-23;1;0;969;1;0.3;0.0
01;2021-01-24;0;0;969;1;0.3;0.0
01;2021-01-25;203;0;1172;1;0.3;0.0
01;2021-01-26;210;1;1382;2;0.4;0.0
01;2021-01-27;233;0;1615;2;0.4;0.0
01;2021-01-28;229;3;1844;5;0.5;0.0
01;2021-01-29;197;1;2041;6;0.5;0.0
01;2021-01-30;17;0;2058;6;0.5;0.0
01;2021-01-31;1;0;2059;6;0.5;0.0
01;2021-02-01;220;4;2279;10;0.6;0.0
01;2021-02-02;241;26;2520;36;0.7;0.0
01;2021-02-03;210;2;2730;38;0.7;0.0
01;2021-02-04;299;20;3029;58;0.8;0.0
01;2021-02-05;247;32;3276;90;0.9;0.0
01;2021-02-06;47;1;3323;91;0.9;0.0
01;2021-02-07;0;0;3323;91;0.9;0.0
01;2021-02-08;217;23;3540;114;0.9;0.0
01;2021-02-09;286;29;3826;143;1.0;0.0
01;2021-02-10;220;29;4046;172;1.1;0.0
01;2021-02-11;291;109;4337;281;1.2;0.1
01;2021-02-12;285;25;4622;306;1.2;0.1
01;2021-02-13;49;7;4671;313;1.2;0.1
01;2021-02-14;19;36;4690;349;1.2;0.1
01;2021-02-15;69;46;4759;395;1.3;0.1
01;2021-02-16;16;1;4775;396;1.3;0.1
01;2021-02-17;17;1;4792;397;1.3;0.1
01;2021-02-18;215;18;5007;415;1.3;0.1
01;2021-02-19;226;20;5233;435;1.4;0.1
01;2021-02-20;47;0;5280;435;1.4;0.1
01;2021-02-21;1;0;5281;435;1.4;0.1
01;2021-02-22;150;63;5431;498;1.4;0.1
01;2021-02-23;188;73;5619;571;1.5;0.2
01;2021-02-24;305;126;5924;697;1.6;0.2
01;2021-02-25;366;79;6290;776;1.7;0.2
01;2021-02-26;184;84;6474;860;1.7;0.2
01;2021-02-27;63;0;6537;860;1.7;0.2
01;2021-02-28;1;0;6538;860;1.7;0.2
01;2021-03-01;132;81;6670;941;1.8;0.2
01;2021-03-02;235;131;6905;1072;1.8;0.3
01;2021-03-03;206;119;7111;1191;1.9;0.3
01;2021-03-04;297;84;7408;1275;2.0;0.3
01;2021-03-05;320;143;7728;1418;2.1;0.4
01;2021-03-06;583;3;8311;1421;2.2;0.4
01;2021-03-07;1;0;8312;1421;2.2;0.4
01;2021-03-08;276;138;8588;1559;2.3;0.4
01;2021-03-09;351;150;8939;1709;2.4;0.5
01;2021-03-10;359;163;9298;1872;2.5;0.5
01;2021-03-11;119;45;9417;1917;2.5;0.5
01;2021-03-12;373;212;9790;2129;2.6;0.6
01;2021-03-13;130;2;9920;2131;2.6;0.6
01;2021-03-14;13;24;9933;2155;2.6;0.6
01;2021-03-15;404;44;10337;2199;2.7;0.6
01;2021-03-16;447;78;10784;2277;2.9;0.6
01;2021-03-17;413;83;11197;2360;3.0;0.6
01;2021-03-18;537;111;11734;2471;3.1;0.7
01;2021-03-19;518;99;12252;2570;3.3;0.7
01;2021-03-20;173;44;12425;2614;3.3;0.7
01;2021-03-21;8;0;12433;2614;3.3;0.7
01;2021-03-22;332;87;12765;2701;3.4;0.7
01;2021-03-23;482;156;13247;2857;3.5;0.8
01;2021-03-24;453;108;13700;2965;3.6;0.8
01;2021-03-25;726;178;14426;3143;3.8;0.8
01;2021-03-26;633;120;15059;3263;4.0;0.9
01;2021-03-27;265;49;15324;3312;4.1;0.9
01;2021-03-28;7;0;15331;3312;4.1;0.9
01;2021-03-29;358;82;15689;3394;4.2;0.9
01;2021-03-30;595;162;16284;3556;4.3;0.9
01;2021-03-31;517;129;16801;3685;4.5;1.0
01;2021-04-01;620;199;17421;3884;4.6;1.0
01;2021-04-02;38;35;17459;3919;4.6;1.0
01;2021-04-03;42;2;17501;3921;4.6;1.0
01;2021-04-04;4;18;17505;3939;4.6;1.0
01;2021-04-05;11;0;17516;3939;4.6;1.0
01;2021-04-06;425;189;17941;4128;4.8;1.1
01;2021-04-07;566;115;18507;4243;4.9;1.1
01;2021-04-08;480;159;18987;4402;5.0;1.2
01;2021-04-09;466;209;19453;4611;5.2;1.2
01;2021-04-10;97;4;19550;4615;5.2;1.2
01;2021-04-11;2;25;19552;4640;5.2;1.2
01;2021-04-12;281;257;19833;4897;5.3;1.3
01;2021-04-13;544;318;20377;5215;5.4;1.4
01;2021-04-14;418;221;20795;5436;5.5;1.4
01;2021-04-15;544;316;21339;5752;5.7;1.5
01;2021-04-16;545;266;21884;6018;5.8;1.6
01;2021-04-17;186;3;22070;6021;5.9;1.6
01;2021-04-18;4;14;22074;6035;5.9;1.6
01;2021-04-19;385;239;22459;6274;6.0;1.7
01;2021-04-20;709;343;23168;6617;6.1;1.8
01;2021-04-21;610;312;23778;6929;6.3;1.8
01;2021-04-22;799;330;24577;7259;6.5;1.9
01;2021-04-23;836;248;25413;7507;6.7;2.0
01;2021-04-24;336;75;25749;7582;6.8;2.0
01;2021-04-25;594;64;26343;7646;7.0;2.0
01;2021-04-26;935;212;27278;7858;7.2;2.1
01;2021-04-27;628;227;27906;8085;7.4;2.1
01;2021-04-28;832;264;28738;8349;7.6;2.2
01;2021-04-29;1192;190;29930;8539;7.9;2.3
01;2021-04-30;1257;170;31187;8709;8.3;2.3
01;2021-05-01;593;38;31780;8747;8.4;2.3
01;2021-05-02;342;17;32122;8764;8.5;2.3
01;2021-05-03;917;171;33039;8935;8.8;2.4
01;2021-05-04;945;196;33984;9131;9.0;2.4
01;2021-05-05;966;242;34950;9373;9.3;2.5
01;2021-05-06;1111;166;36061;9539;9.6;2.5
01;2021-05-07;1215;257;37276;9796;9.9;2.6
01;2021-05-08;314;33;37590;9829;10.0;2.6
01;2021-05-09;178;9;37768;9838;10.0;2.6
01;2021-05-10;829;209;38597;10047;10.2;2.7
01;2021-05-11;930;309;39527;10356;10.5;2.7
01;2021-05-12;891;321;40418;10677;10.7;2.8
01;2021-05-13;210;80;40628;10757;10.8;2.9
01;2021-05-14;856;270;41484;11027;11.0;2.9
01;2021-05-15;468;14;41952;11041;11.1;2.9
01;2021-05-16;182;35;42134;11076;11.2;2.9
01;2021-05-17;702;269;42836;11345;11.4;3.0
01;2021-05-18;694;388;43530;11733;11.6;3.1
01;2021-05-19;681;520;44211;12253;11.7;3.3
01;2021-05-20;759;365;44970;12618;11.9;3.3
01;2021-05-21;791;400;45761;13018;12.1;3.5
01;2021-05-22;476;217;46237;13235;12.3;3.5
01;2021-05-23;199;115;46436;13350;12.3;3.5
01;2021-05-24;197;176;46633;13526;12.4;3.6
01;2021-05-25;518;664;47151;14190;12.5;3.8
01;2021-05-26;558;493;47709;14683;12.7;3.9
01;2021-05-27;127;186;47836;14869;12.7;3.9
01;2021-05-28;506;524;48342;15393;12.8;4.1
01;2021-05-29;219;138;48561;15531;12.9;4.1
01;2021-05-30;72;111;48633;15642;12.9;4.2
01;2021-05-31;412;536;49045;16178;13.0;4.3
01;2021-06-01;518;715;49563;16893;13.2;4.5
01;2021-06-02;529;709;50092;17602;13.3;4.7
01;2021-06-03;474;561;50566;18163;13.4;4.8
01;2021-06-04;665;799;51231;18962;13.6;5.0
01;2021-06-05;296;645;51527;19607;13.7;5.2
01;2021-06-06;122;530;51649;20137;13.7;5.3
01;2021-06-07;325;783;51974;20920;13.8;5.6
01;2021-06-08;441;888;52415;21808;13.9;5.8
01;2021-06-09;389;858;52804;22666;14.0;6.0
01;2021-06-10;464;850;53268;23516;14.1;6.2
01;2021-06-11;443;1230;53711;24746;14.3;6.6
01;2021-06-12;290;660;54001;25406;14.3;6.7
01;2021-06-13;129;314;54130;25720;14.4;6.8
01;2021-06-14;350;3809;54480;29529;14.5;7.8
01;2021-06-15;445;2011;54925;31540;14.6;8.4
01;2021-06-16;447;1490;55372;33030;14.7;8.8
01;2021-06-17;413;1012;55785;34042;14.8;9.0
01;2021-06-18;451;1016;56236;35058;14.9;9.3
01;2021-06-19;294;508;56530;35566;15.0;9.4
01;2021-06-20;108;232;56638;35798;15.0;9.5
01;2021-06-21;313;682;56951;36480;15.1;9.7
01;2021-06-22;313;867;57264;37347;15.2;9.9
01;2021-06-23;343;891;57607;38238;15.3;10.1
01;2021-06-24;378;731;57985;38969;15.4;10.3
01;2021-06-25;432;763;58417;39732;15.5;10.5
01;2021-06-26;291;513;58708;40245;15.6;10.7
01;2021-06-27;106;169;58814;40414;15.6;10.7
01;2021-06-28;283;689;59097;41103;15.7;10.9
02;2020-12-27;0;0;0;0;0.0;0.0
02;2020-12-28;0;0;0;0;0.0;0.0
02;2020-12-29;0;0;0;0;0.0;0.0
02;2020-12-30;0;0;0;0;0.0;0.0
02;2020-12-31;0;0;0;0;0.0;0.0
02;2021-01-01;0;0;0;0;0.0;0.0
02;2021-01-02;0;0;0;0;0.0;0.0
02;2021-01-03;0;0;0;0;0.0;0.0
02;2021-01-04;0;0;0;0;0.0;0.0
02;2021-01-05;0;0;0;0;0.0;0.0
02;2021-01-06;5;0;5;0;0.0;0.0
02;2021-01-07;31;0;36;0;0.0;0.0
02;2021-01-08;80;1;116;1;0.0;0.0
02;2021-01-09;20;0;136;1;0.0;0.0
02;2021-01-10;0;0;136;1;0.0;0.0
02;2021-01-11;122;0;258;1;0.1;0.0
02;2021-01-12;78;0;336;1;0.1;0.0
02;2021-01-13;64;0;400;1;0.1;0.0
02;2021-01-14;88;1;488;2;0.1;0.0
02;2021-01-15;136;0;624;2;0.2;0.0
02;2021-01-16;51;0;675;2;0.2;0.0
02;2021-01-17;0;0;675;2;0.2;0.0
02;2021-01-18;157;0;832;2;0.2;0.0
02;2021-01-19;168;1;1000;3;0.3;0.0
02;2021-01-20;163;0;1163;3;0.3;0.0
02;2021-01-21;181;1;1344;4;0.4;0.0
02;2021-01-22;156;0;1500;4;0.4;0.0
02;2021-01-23;58;0;1558;4;0.4;0.0
02;2021-01-24;0;0;1558;4;0.4;0.0
02;2021-01-25;160;0;1718;4;0.5;0.0
02;2021-01-26;137;0;1855;4;0.5;0.0
02;2021-01-27;161;5;2016;9;0.6;0.0
02;2021-01-28;143;12;2159;21;0.6;0.0
02;2021-01-29;142;41;2301;62;0.6;0.0
02;2021-01-30;96;16;2397;78;0.7;0.0
02;2021-01-31;0;0;2397;78;0.7;0.0
02;2021-02-01;119;74;2516;152;0.7;0.0
02;2021-02-02;184;96;2700;248;0.8;0.1
02;2021-02-03;130;80;2830;328;0.8;0.1
02;2021-02-04;158;73;2988;401;0.8;0.1
02;2021-02-05;120;97;3108;498;0.9;0.1
02;2021-02-06;62;26;3170;524;0.9;0.1
02;2021-02-07;1;0;3171;524;0.9;0.1
02;2021-02-08;137;80;3308;604;0.9;0.2
02;2021-02-09;175;78;3483;682;1.0;0.2
02;2021-02-10;138;90;3621;772;1.0;0.2
02;2021-02-11;150;103;3771;875;1.1;0.2
02;2021-02-12;124;130;3895;1005;1.1;0.3
02;2021-02-13;38;37;3933;1042;1.1;0.3
02;2021-02-14;0;0;3933;1042;1.1;0.3
02;2021-02-15;51;67;3984;1109;1.1;0.3
02;2021-02-16;0;1;3984;1110;1.1;0.3
02;2021-02-17;1;3;3985;1113;1.1;0.3
02;2021-02-18;68;128;4053;1241;1.1;0.3
02;2021-02-19;69;131;4122;1372;1.1;0.4
02;2021-02-20;48;69;4170;1441;1.2;0.4
02;2021-02-21;0;0;4170;1441;1.2;0.4
02;2021-02-22;102;60;4272;1501;1.2;0.4
02;2021-02-23;113;238;4385;1739;1.2;0.5
02;2021-02-24;106;223;4491;1962;1.3;0.5
02;2021-02-25;89;151;4580;2113;1.3;0.6
02;2021-02-26;126;169;4706;2282;1.3;0.6
02;2021-02-27;69;52;4775;2334;1.3;0.7
02;2021-02-28;0;0;4775;2334;1.3;0.7
02;2021-03-01;138;144;4913;2478;1.4;0.7
02;2021-03-02;158;78;5071;2556;1.4;0.7
02;2021-03-03;178;145;5249;2701;1.5;0.8
02;2021-03-04;145;135;5394;2836;1.5;0.8
02;2021-03-05;238;129;5632;2965;1.6;0.8
02;2021-03-06;119;59;5751;3024;1.6;0.8
02;2021-03-07;100;1;5851;3025;1.6;0.8
02;2021-03-08;196;133;6047;3158;1.7;0.9
02;2021-03-09;269;102;6316;3260;1.8;0.9
02;2021-03-10;324;134;6640;3394;1.9;0.9
02;2021-03-11;331;83;6971;3477;1.9;1.0
02;2021-03-12;398;53;7369;3530;2.1;1.0
02;2021-03-13;155;21;7524;3551;2.1;1.0
02;2021-03-14;4;1;7528;3552;2.1;1.0
02;2021-03-15;276;92;7804;3644;2.2;1.0
02;2021-03-16;305;55;8109;3699;2.3;1.0
02;2021-03-17;387;49;8496;3748;2.4;1.0
02;2021-03-18;435;44;8931;3792;2.5;1.1
02;2021-03-19;396;62;9327;3854;2.6;1.1
02;2021-03-20;149;48;9476;3902;2.6;1.1
02;2021-03-21;25;1;9501;3903;2.6;1.1
02;2021-03-22;362;117;9863;4020;2.7;1.1
02;2021-03-23;401;123;10264;4143;2.9;1.2
02;2021-03-24;427;104;10691;4247;3.0;1.2
02;2021-03-25;470;99;11161;4346;3.1;1.2
02;2021-03-26;632;100;11793;4446;3.3;1.2
02;2021-03-27;152;71;11945;4517;3.3;1.3
02;2021-03-28;81;2;12026;4519;3.4;1.3
02;2021-03-29;421;165;12447;4684;3.5;1.3
02;2021-03-30;468;244;12915;4928;3.6;1.4
02;2021-03-31;1143;187;14058;5115;3.9;1.4
02;2021-04-01;951;170;15009;5285;4.2;1.5
02;2021-04-02;895;8;15904;5293;4.4;1.5
02;2021-04-03;788;50;16692;5343;4.7;1.5
02;2021-04-04;750;10;17442;5353;4.9;1.5
02;2021-04-05;828;40;18270;5393;5.1;1.5
02;2021-04-06;883;133;19153;5526;5.3;1.5
02;2021-04-07;1431;326;20584;5852;5.7;1.6
02;2021-04-08;1303;268;21887;6120;6.1;1.7
02;2021-04-09;1239;317;23126;6437;6.4;1.8
02;2021-04-10;838;164;23964;6601;6.7;1.8
02;2021-04-11;621;12;24585;6613;6.9;1.8
02;2021-04-12;868;314;25453;6927;7.1;1.9
02;2021-04-13;867;326;26320;7253;7.3;2.0
02;2021-04-14;957;324;27277;7577;7.6;2.1
02;2021-04-15;958;294;28235;7871;7.9;2.2
02;2021-04-16;991;298;29226;8169;8.1;2.3
02;2021-04-17;528;161;29754;8330;8.3;2.3
02;2021-04-18;339;56;30093;8386;8.4;2.3
02;2021-04-19;668;347;30761;8733;8.6;2.4
02;2021-04-20;868;310;31629;9043;8.8;2.5
02;2021-04-21;999;358;32628;9401;9.1;2.6
02;2021-04-22;602;313;33230;9714;9.3;2.7
02;2021-04-23;605;466;33835;10180;9.4;2.8
02;2021-04-24;360;197;34195;10377;9.5;2.9
02;2021-04-25;168;200;34363;10577;9.6;2.9
02;2021-04-26;515;543;34878;11120;9.7;3.1
02;2021-04-27;559;609;35437;11729;9.9;3.3
02;2021-04-28;449;693;35886;12422;10.0;3.5
02;2021-04-29;651;643;36537;13065;10.2;3.6
02;2021-04-30;770;688;37307;13753;10.4;3.8
02;2021-05-01;243;246;37550;13999;10.5;3.9
02;2021-05-02;226;513;37776;14512;10.5;4.0
02;2021-05-03;569;772;38345;15284;10.7;4.3
02;2021-05-04;524;677;38869;15961;10.8;4.4
02;2021-05-05;541;898;39410;16859;11.0;4.7
02;2021-05-06;546;783;39956;17642;11.1;4.9
02;2021-05-07;629;1016;40585;18658;11.3;5.2
02;2021-05-08;224;526;40809;19184;11.4;5.3
02;2021-05-09;174;506;40983;19690;11.4;5.5
02;2021-05-10;520;861;41503;20551;11.6;5.7
02;2021-05-11;477;875;41980;21426;11.7;6.0
02;2021-05-12;556;914;42536;22340;11.9;6.2
02;2021-05-13;272;534;42808;22874;11.9;6.4
02;2021-05-14;388;753;43196;23627;12.0;6.6
02;2021-05-15;233;582;43429;24209;12.1;6.7
02;2021-05-16;155;442;43584;24651;12.1;6.9
02;2021-05-17;472;756;44056;25407;12.3;7.1
02;2021-05-18;443;678;44499;26085;12.4;7.3
02;2021-05-19;446;742;44945;26827;12.5;7.5
02;2021-05-20;589;501;45534;27328;12.7;7.6
02;2021-05-21;545;705;46079;28033;12.8;7.8
02;2021-05-22;184;365;46263;28398;12.9;7.9
02;2021-05-23;110;181;46373;28579;12.9;8.0
02;2021-05-24;134;242;46507;28821;13.0;8.0
02;2021-05-25;349;706;46856;29527;13.1;8.2
02;2021-05-26;377;713;47233;30240;13.2;8.4
02;2021-05-27;262;648;47495;30888;13.2;8.6
02;2021-05-28;272;820;47767;31708;13.3;8.8
02;2021-05-29;148;512;47915;32220;13.4;9.0
02;2021-05-30;16;33;47931;32253;13.4;9.0
02;2021-05-31;342;686;48273;32939;13.5;9.2
02;2021-06-01;289;548;48562;33487;13.5;9.3
02;2021-06-02;315;574;48877;34061;13.6;9.5
02;2021-06-03;246;431;49123;34492;13.7;9.6
02;2021-06-04;348;651;49471;35143;13.8;9.8
02;2021-06-05;235;362;49706;35505;13.9;9.9
02;2021-06-06;21;31;49727;35536;13.9;9.9
02;2021-06-07;257;741;49984;36277;13.9;10.1
02;2021-06-08;249;591;50233;36868;14.0;10.3
02;2021-06-09;293;704;50526;37572;14.1;10.5
02;2021-06-10;299;454;50825;38026;14.2;10.6
02;2021-06-11;334;544;51159;38570;14.3;10.8
02;2021-06-12;243;323;51402;38893;14.3;10.8
02;2021-06-13;32;29;51434;38922;14.3;10.8
02;2021-06-14;363;553;51797;39475;14.4;11.0
02;2021-06-15;407;494;52204;39969;14.6;11.1
02;2021-06-16;411;444;52615;40413;14.7;11.3
02;2021-06-17;346;578;52961;40991;14.8;11.4
02;2021-06-18;420;542;53381;41533;14.9;11.6
02;2021-06-19;225;196;53606;41729;14.9;11.6
02;2021-06-20;25;17;53631;41746;14.9;11.6
02;2021-06-21;317;578;53948;42324;15.0;11.8
02;2021-06-22;288;464;54236;42788;15.1;11.9
02;2021-06-23;406;562;54642;43350;15.2;12.1
02;2021-06-24;310;432;54952;43782;15.3;12.2
02;2021-06-25;304;388;55256;44170;15.4;12.3
02;2021-06-26;195;199;55451;44369;15.5;12.4
02;2021-06-27;15;23;55466;44392;15.5;12.4
02;2021-06-28;290;419;55756;44811;15.5;12.5
03;2020-12-27;0;0;0;0;0.0;0.0
03;2020-12-28;0;0;0;0;0.0;0.0
03;2020-12-29;0;0;0;0;0.0;0.0
03;2020-12-30;0;0;0;0;0.0;0.0
03;2020-12-31;0;0;0;0;0.0;0.0
03;2021-01-01;0;0;0;0;0.0;0.0
03;2021-01-02;2;2;2;2;0.0;0.0
03;2021-01-03;0;0;2;2;0.0;0.0
03;2021-01-04;0;0;2;2;0.0;0.0
03;2021-01-05;0;0;2;2;0.0;0.0
03;2021-01-06;0;0;2;2;0.0;0.0
03;2021-01-07;0;0;2;2;0.0;0.0
03;2021-01-08;0;0;2;2;0.0;0.0
03;2021-01-09;0;0;2;2;0.0;0.0
03;2021-01-10;0;0;2;2;0.0;0.0
03;2021-01-11;0;0;2;2;0.0;0.0
03;2021-01-12;0;0;2;2;0.0;0.0
03;2021-01-13;30;0;32;2;0.0;0.0
03;2021-01-14;46;0;78;2;0.0;0.0
03;2021-01-15;34;0;112;2;0.0;0.0
03;2021-01-16;18;0;130;2;0.0;0.0
03;2021-01-17;0;0;130;2;0.0;0.0
03;2021-01-18;63;0;193;2;0.1;0.0
03;2021-01-19;149;1;342;3;0.1;0.0
03;2021-01-20;132;0;474;3;0.2;0.0
03;2021-01-21;118;0;592;3;0.2;0.0
03;2021-01-22;76;0;668;3;0.2;0.0
03;2021-01-23;0;0;668;3;0.2;0.0
03;2021-01-24;0;0;668;3;0.2;0.0
03;2021-01-25;56;0;724;3;0.2;0.0
03;2021-01-26;100;0;824;3;0.3;0.0
03;2021-01-27;109;1;933;4;0.3;0.0
03;2021-01-28;96;2;1029;6;0.4;0.0
03;2021-01-29;104;3;1133;9;0.4;0.0
03;2021-01-30;0;0;1133;9;0.4;0.0
03;2021-01-31;0;0;1133;9;0.4;0.0
03;2021-02-01;54;0;1187;9;0.4;0.0
03;2021-02-02;122;4;1309;13;0.5;0.0
03;2021-02-03;116;7;1425;20;0.5;0.0
03;2021-02-04;79;26;1504;46;0.5;0.0
03;2021-02-05;65;8;1569;54;0.5;0.0
03;2021-02-06;0;0;1569;54;0.5;0.0
03;2021-02-07;0;0;1569;54;0.5;0.0
03;2021-02-08;51;13;1620;67;0.6;0.0
03;2021-02-09;92;39;1712;106;0.6;0.0
03;2021-02-10;101;42;1813;148;0.6;0.1
03;2021-02-11;104;93;1917;241;0.7;0.1
03;2021-02-12;87;65;2004;306;0.7;0.1
03;2021-02-13;0;0;2004;306;0.7;0.1
03;2021-02-14;0;0;2004;306;0.7;0.1
03;2021-02-15;27;65;2031;371;0.7;0.1
03;2021-02-16;123;54;2154;425;0.7;0.1
03;2021-02-17;145;120;2299;545;0.8;0.2
03;2021-02-18;102;143;2401;688;0.8;0.2
03;2021-02-19;121;72;2522;760;0.9;0.3
03;2021-02-20;0;0;2522;760;0.9;0.3
03;2021-02-21;0;0;2522;760;0.9;0.3
03;2021-02-22;78;49;2600;809;0.9;0.3
03;2021-02-23;158;100;2758;909;0.9;0.3
03;2021-02-24;190;120;2948;1029;1.0;0.4
03;2021-02-25;258;87;3206;1116;1.1;0.4
03;2021-02-26;264;69;3470;1185;1.2;0.4
03;2021-02-27;121;1;3591;1186;1.2;0.4
03;2021-02-28;0;0;3591;1186;1.2;0.4
03;2021-03-01;180;85;3771;1271;1.3;0.4
03;2021-03-02;255;108;4026;1379;1.4;0.5
03;2021-03-03;255;131;4281;1510;1.5;0.5
03;2021-03-04;281;81;4562;1591;1.6;0.5
03;2021-03-05;270;44;4832;1635;1.7;0.6
03;2021-03-06;116;1;4948;1636;1.7;0.6
03;2021-03-07;0;0;4948;1636;1.7;0.6
03;2021-03-08;187;41;5135;1677;1.8;0.6
03;2021-03-09;349;91;5484;1768;1.9;0.6
03;2021-03-10;357;100;5841;1868;2.0;0.6
03;2021-03-11;270;120;6111;1988;2.1;0.7
03;2021-03-12;286;92;6397;2080;2.2;0.7
03;2021-03-13;110;2;6507;2082;2.2;0.7
03;2021-03-14;0;0;6507;2082;2.2;0.7
03;2021-03-15;180;26;6687;2108;2.3;0.7
03;2021-03-16;241;139;6928;2247;2.4;0.8
03;2021-03-17;273;128;7201;2375;2.5;0.8
03;2021-03-18;250;153;7451;2528;2.6;0.9
03;2021-03-19;284;126;7735;2654;2.7;0.9
03;2021-03-20;255;14;7990;2668;2.7;0.9
03;2021-03-21;119;0;8109;2668;2.8;0.9
03;2021-03-22;219;112;8328;2780;2.9;1.0
03;2021-03-23;261;186;8589;2966;3.0;1.0
03;2021-03-24;225;209;8814;3175;3.0;1.1
03;2021-03-25;167;176;8981;3351;3.1;1.2
03;2021-03-26;189;307;9170;3658;3.2;1.3
03;2021-03-27;56;93;9226;3751;3.2;1.3
03;2021-03-28;0;0;9226;3751;3.2;1.3
03;2021-03-29;175;245;9401;3996;3.2;1.4
03;2021-03-30;446;235;9847;4231;3.4;1.5
03;2021-03-31;318;291;10165;4522;3.5;1.6
03;2021-04-01;445;261;10610;4783;3.6;1.6
03;2021-04-02;306;279;10916;5062;3.8;1.7
03;2021-04-03;151;122;11067;5184;3.8;1.8
03;2021-04-04;0;0;11067;5184;3.8;1.8
03;2021-04-05;118;14;11185;5198;3.8;1.8
03;2021-04-06;439;331;11624;5529;4.0;1.9
03;2021-04-07;501;341;12125;5870;4.2;2.0
03;2021-04-08;510;263;12635;6133;4.3;2.1
03;2021-04-09;493;225;13128;6358;4.5;2.2
03;2021-04-10;146;91;13274;6449;4.6;2.2
03;2021-04-11;2;0;13276;6449;4.6;2.2
03;2021-04-12;551;269;13827;6718;4.8;2.3
03;2021-04-13;671;241;14498;6959;5.0;2.4
03;2021-04-14;718;310;15216;7269;5.2;2.5
03;2021-04-15;770;242;15986;7511;5.5;2.6
03;2021-04-16;748;297;16734;7808;5.8;2.7
03;2021-04-17;495;128;17229;7936;5.9;2.7
03;2021-04-18;499;39;17728;7975;6.1;2.7
03;2021-04-19;712;249;18440;8224;6.3;2.8
03;2021-04-20;562;276;19002;8500;6.5;2.9
03;2021-04-21;801;237;19803;8737;6.8;3.0
03;2021-04-22;656;216;20459;8953;7.0;3.1
03;2021-04-23;663;220;21122;9173;7.3;3.2
03;2021-04-24;524;95;21646;9268;7.4;3.2
03;2021-04-25;602;42;22248;9310;7.7;3.2
03;2021-04-26;735;223;22983;9533;7.9;3.3
03;2021-04-27;766;338;23749;9871;8.2;3.4
03;2021-04-28;684;324;24433;10195;8.4;3.5
03;2021-04-29;620;277;25053;10472;8.6;3.6
03;2021-04-30;672;252;25725;10724;8.8;3.7
03;2021-05-01;209;26;25934;10750;8.9;3.7
03;2021-05-02;594;76;26528;10826;9.1;3.7
03;2021-05-03;554;390;27082;11216;9.3;3.9
03;2021-05-04;614;311;27696;11527;9.5;4.0
03;2021-05-05;647;445;28343;11972;9.8;4.1
03;2021-05-06;624;461;28967;12433;10.0;4.3
03;2021-05-07;539;462;29506;12895;10.2;4.4
03;2021-05-08;341;57;29847;12952;10.3;4.5
03;2021-05-09;262;73;30109;13025;10.4;4.5
03;2021-05-10;418;612;30527;13637;10.5;4.7
03;2021-05-11;376;491;30903;14128;10.6;4.9
03;2021-05-12;469;639;31372;14767;10.8;5.1
03;2021-05-13;332;98;31704;14865;10.9;5.1
03;2021-05-14;471;548;32175;15413;11.1;5.3
03;2021-05-15;253;345;32428;15758;11.2;5.4
03;2021-05-16;207;210;32635;15968;11.2;5.5
03;2021-05-17;443;600;33078;16568;11.4;5.7
03;2021-05-18;558;563;33636;17131;11.6;5.9
03;2021-05-19;511;548;34147;17679;11.7;6.1
03;2021-05-20;612;444;34759;18123;12.0;6.2
03;2021-05-21;483;601;35242;18724;12.1;6.4
03;2021-05-22;167;501;35409;19225;12.2;6.6
03;2021-05-23;267;473;35676;19698;12.3;6.8
03;2021-05-24;559;244;36235;19942;12.5;6.9
03;2021-05-25;495;740;36730;20682;12.6;7.1
03;2021-05-26;413;681;37143;21363;12.8;7.3
03;2021-05-27;662;515;37805;21878;13.0;7.5
03;2021-05-28;486;549;38291;22427;13.2;7.7
03;2021-05-29;238;361;38529;22788;13.3;7.8
03;2021-05-30;150;401;38679;23189;13.3;8.0
03;2021-05-31;337;573;39016;23762;13.4;8.2
03;2021-06-01;382;466;39398;24228;13.6;8.3
03;2021-06-02;502;549;39900;24777;13.7;8.5
03;2021-06-03;413;466;40313;25243;13.9;8.7
03;2021-06-04;522;489;40835;25732;14.0;8.9
03;2021-06-05;269;293;41104;26025;14.1;9.0
03;2021-06-06;208;299;41312;26324;14.2;9.1
03;2021-06-07;458;448;41770;26772;14.4;9.2
03;2021-06-08;508;312;42278;27084;14.5;9.3
03;2021-06-09;480;379;42758;27463;14.7;9.4
03;2021-06-10;345;290;43103;27753;14.8;9.5
03;2021-06-11;389;468;43492;28221;15.0;9.7
03;2021-06-12;162;285;43654;28506;15.0;9.8
03;2021-06-13;200;267;43854;28773;15.1;9.9
03;2021-06-14;350;547;44204;29320;15.2;10.1
03;2021-06-15;355;439;44559;29759;15.3;10.2
03;2021-06-16;389;450;44948;30209;15.5;10.4
03;2021-06-17;364;575;45312;30784;15.6;10.6
03;2021-06-18;335;561;45647;31345;15.7;10.8
03;2021-06-19;230;259;45877;31604;15.8;10.9
03;2021-06-20;123;272;46000;31876;15.8;11.0
03;2021-06-21;264;597;46264;32473;15.9;11.2
03;2021-06-22;307;456;46571;32929;16.0;11.3
03;2021-06-23;271;530;46842;33459;16.1;11.5
03;2021-06-24;343;494;47185;33953;16.2;11.7
03;2021-06-25;317;544;47502;34497;16.3;11.9
03;2021-06-26;164;321;47666;34818;16.4;12.0
03;2021-06-27;117;169;47783;34987;16.4;12.0
03;2021-06-28;278;587;48061;35574;16.5;12.2
04;2020-12-27;0;0;0;0;0.0;0.0
04;2020-12-28;0;0;0;0;0.0;0.0
04;2020-12-29;0;0;0;0;0.0;0.0
04;2020-12-30;0;0;0;0;0.0;0.0
04;2020-12-31;0;0;0;0;0.0;0.0
04;2021-01-01;1;0;1;0;0.0;0.0
04;2021-01-02;0;0;1;0;0.0;0.0
04;2021-01-03;0;0;1;0;0.0;0.0
04;2021-01-04;0;0;1;0;0.0;0.0
04;2021-01-05;2;0;3;0;0.0;0.0
04;2021-01-06;0;0;3;0;0.0;0.0
04;2021-01-07;0;0;3;0;0.0;0.0
04;2021-01-08;0;0;3;0;0.0;0.0
04;2021-01-09;1;0;4;0;0.0;0.0
04;2021-01-10;0;0;4;0;0.0;0.0
04;2021-01-11;0;0;4;0;0.0;0.0
04;2021-01-12;0;0;4;0;0.0;0.0
04;2021-01-13;0;0;4;0;0.0;0.0
04;2021-01-14;0;0;4;0;0.0;0.0
04;2021-01-15;332;0;336;0;0.0;0.0
04;2021-01-16;27;0;363;0;0.0;0.0
04;2021-01-17;0;0;363;0;0.0;0.0
04;2021-01-18;49;1;412;1;0.0;0.0
04;2021-01-19;393;0;805;1;0.1;0.0
04;2021-01-20;482;1;1287;2;0.1;0.0
04;2021-01-21;614;1;1901;3;0.2;0.0
04;2021-01-22;409;1;2310;4;0.3;0.0
04;2021-01-23;75;0;2385;4;0.3;0.0
04;2021-01-24;0;0;2385;4;0.3;0.0
04;2021-01-25;272;0;2657;4;0.3;0.0
04;2021-01-26;429;0;3086;4;0.4;0.0
04;2021-01-27;317;0;3403;4;0.4;0.0
04;2021-01-28;406;0;3809;4;0.4;0.0
04;2021-01-29;421;3;4230;7;0.5;0.0
04;2021-01-30;419;0;4649;7;0.5;0.0
04;2021-01-31;0;0;4649;7;0.5;0.0
04;2021-02-01;372;3;5021;10;0.6;0.0
04;2021-02-02;498;4;5519;14;0.6;0.0
04;2021-02-03;602;14;6121;28;0.7;0.0
04;2021-02-04;626;22;6747;50;0.8;0.0
04;2021-02-05;564;98;7311;148;0.9;0.0
04;2021-02-06;501;4;7812;152;0.9;0.0
04;2021-02-07;0;8;7812;160;0.9;0.0
04;2021-02-08;472;34;8284;194;1.0;0.0
04;2021-02-09;783;90;9067;284;1.1;0.0
04;2021-02-10;820;85;9887;369;1.1;0.0
04;2021-02-11;796;86;10683;455;1.2;0.1
04;2021-02-12;637;95;11320;550;1.3;0.1
04;2021-02-13;651;74;11971;624;1.4;0.1
04;2021-02-14;1;0;11972;624;1.4;0.1
04;2021-02-15;524;126;12496;750;1.5;0.1
04;2021-02-16;650;535;13146;1285;1.5;0.1
04;2021-02-17;592;329;13738;1614;1.6;0.2
04;2021-02-18;493;414;14231;2028;1.7;0.2
04;2021-02-19;496;321;14727;2349;1.7;0.3
04;2021-02-20;576;117;15303;2466;1.8;0.3
04;2021-02-21;0;0;15303;2466;1.8;0.3
04;2021-02-22;401;238;15704;2704;1.8;0.3
04;2021-02-23;607;238;16311;2942;1.9;0.3
04;2021-02-24;583;255;16894;3197;2.0;0.4
04;2021-02-25;645;298;17539;3495;2.0;0.4
04;2021-02-26;483;473;18022;3968;2.1;0.5
04;2021-02-27;386;472;18408;4440;2.1;0.5
04;2021-02-28;0;0;18408;4440;2.1;0.5
04;2021-03-01;289;392;18697;4832;2.2;0.6
04;2021-03-02;487;504;19184;5336;2.2;0.6
04;2021-03-03;755;559;19939;5895;2.3;0.7
04;2021-03-04;775;543;20714;6438;2.4;0.7
04;2021-03-05;727;542;21441;6980;2.5;0.8
04;2021-03-06;812;530;22253;7510;2.6;0.9
04;2021-03-07;0;0;22253;7510;2.6;0.9
04;2021-03-08;436;591;22689;8101;2.6;0.9
04;2021-03-09;670;777;23359;8878;2.7;1.0
04;2021-03-10;644;849;24003;9727;2.8;1.1
04;2021-03-11;699;649;24702;10376;2.9;1.2
04;2021-03-12;729;666;25431;11042;3.0;1.3
04;2021-03-13;668;611;26099;11653;3.0;1.4
04;2021-03-14;2;0;26101;11653;3.0;1.4
04;2021-03-15;504;507;26605;12160;3.1;1.4
04;2021-03-16;680;711;27285;12871;3.2;1.5
04;2021-03-17;847;538;28132;13409;3.3;1.6
04;2021-03-18;1021;556;29153;13965;3.4;1.6
04;2021-03-19;784;543;29937;14508;3.5;1.7
04;2021-03-20;576;600;30513;15108;3.5;1.8
04;2021-03-21;0;0;30513;15108;3.5;1.8
04;2021-03-22;565;482;31078;15590;3.6;1.8
04;2021-03-23;780;640;31858;16230;3.7;1.9
04;2021-03-24;792;671;32650;16901;3.8;2.0
04;2021-03-25;929;555;33579;17456;3.9;2.0
04;2021-03-26;921;450;34500;17906;4.0;2.1
04;2021-03-27;782;340;35282;18246;4.1;2.1
04;2021-03-28;1;0;35283;18246;4.1;2.1
04;2021-03-29;960;272;36243;18518;4.2;2.2
04;2021-03-30;883;503;37126;19021;4.3;2.2
04;2021-03-31;740;674;37866;19695;4.4;2.3
04;2021-04-01;716;709;38582;20404;4.5;2.4
04;2021-04-02;688;761;39270;21165;4.6;2.5
04;2021-04-03;699;707;39969;21872;4.6;2.5
04;2021-04-04;0;0;39969;21872;4.6;2.5
04;2021-04-05;0;2;39969;21874;4.6;2.5
04;2021-04-06;796;642;40765;22516;4.7;2.6
04;2021-04-07;1369;789;42134;23305;4.9;2.7
04;2021-04-08;1792;780;43926;24085;5.1;2.8
04;2021-04-09;1508;787;45434;24872;5.3;2.9
04;2021-04-10;1137;651;46571;25523;5.4;3.0
04;2021-04-11;2;0;46573;25523;5.4;3.0
04;2021-04-12;1239;553;47812;26076;5.6;3.0
04;2021-04-13;1438;754;49250;26830;5.7;3.1
04;2021-04-14;2069;778;51319;27608;6.0;3.2
04;2021-04-15;2502;956;53821;28564;6.3;3.3
04;2021-04-16;1932;786;55753;29350;6.5;3.4
04;2021-04-17;1289;604;57042;29954;6.6;3.5
04;2021-04-18;0;0;57042;29954;6.6;3.5
04;2021-04-19;1377;565;58419;30519;6.8;3.5
04;2021-04-20;1649;807;60068;31326;7.0;3.6
04;2021-04-21;2128;607;62196;31933;7.2;3.7
04;2021-04-22;2946;806;65142;32739;7.6;3.8
04;2021-04-23;2309;815;67451;33554;7.8;3.9
04;2021-04-24;1102;798;68553;34352;8.0;4.0
04;2021-04-25;2;0;68555;34352;8.0;4.0
04;2021-04-26;1165;922;69720;35274;8.1;4.1
04;2021-04-27;1679;1027;71399;36301;8.3;4.2
04;2021-04-28;2896;753;74295;37054;8.6;4.3
04;2021-04-29;3944;813;78239;37867;9.1;4.4
04;2021-04-30;3433;906;81672;38773;9.5;4.5
04;2021-05-01;2107;220;83779;38993;9.7;4.5
04;2021-05-02;2;0;83781;38993;9.7;4.5
04;2021-05-03;1865;572;85646;39565;10.0;4.6
04;2021-05-04;2127;1096;87773;40661;10.2;4.7
04;2021-05-05;3118;1641;90891;42302;10.6;4.9
04;2021-05-06;4005;1589;94896;43891;11.0;5.1
04;2021-05-07;3229;1527;98125;45418;11.4;5.3
04;2021-05-08;1566;503;99691;45921;11.6;5.3
04;2021-05-09;1;0;99692;45921;11.6;5.3
04;2021-05-10;2412;994;102104;46915;11.9;5.5
04;2021-05-11;3649;1642;105753;48557;12.3;5.6
04;2021-05-12;4719;2397;110472;50954;12.8;5.9
04;2021-05-13;3554;585;114026;51539;13.3;6.0
04;2021-05-14;5264;2515;119290;54054;13.9;6.3
04;2021-05-15;3160;1538;122450;55592;14.2;6.5
04;2021-05-16;15;18;122465;55610;14.2;6.5
04;2021-05-17;2997;1480;125462;57090;14.6;6.6
04;2021-05-18;3749;1781;129211;58871;15.0;6.8
04;2021-05-19;4678;2335;133889;61206;15.6;7.1
04;2021-05-20;5140;2808;139029;64014;16.2;7.4
04;2021-05-21;4988;2639;144017;66653;16.7;7.8
04;2021-05-22;3365;1253;147382;67906;17.1;7.9
04;2021-05-23;5;3;147387;67909;17.1;7.9
04;2021-05-24;3642;1081;151029;68990;17.6;8.0
04;2021-05-25;4246;1915;155275;70905;18.1;8.2
04;2021-05-26;4979;2966;160254;73871;18.6;8.6
04;2021-05-27;4602;4094;164856;77965;19.2;9.1
04;2021-05-28;4372;3827;169228;81792;19.7;9.5
04;2021-05-29;2550;2462;171778;84254;20.0;9.8
04;2021-05-30;7;14;171785;84268;20.0;9.8
04;2021-05-31;2348;2252;174133;86520;20.2;10.1
04;2021-06-01;3275;2722;177408;89242;20.6;10.4
04;2021-06-02;3916;3353;181324;92595;21.1;10.8
04;2021-06-03;4015;3664;185339;96259;21.6;11.2
04;2021-06-04;3820;3752;189159;100011;22.0;11.6
04;2021-06-05;2192;1923;191351;101934;22.3;11.9
04;2021-06-06;1060;128;192411;102062;22.4;11.9
04;2021-06-07;2000;2530;194411;104592;22.6;12.2
04;2021-06-08;2514;3321;196925;107913;22.9;12.5
04;2021-06-09;2942;4771;199867;112684;23.2;13.1
04;2021-06-10;3342;4446;203209;117130;23.6;13.6
04;2021-06-11;2828;4620;206037;121750;24.0;14.2
04;2021-06-12;1710;3378;207747;125128;24.2;14.6
04;2021-06-13;1312;243;209059;125371;24.3;14.6
04;2021-06-14;1479;3179;210538;128550;24.5;14.9
04;2021-06-15;2035;3616;212573;132166;24.7;15.4
04;2021-06-16;2713;4650;215286;136816;25.0;15.9
04;2021-06-17;2497;4900;217783;141716;25.3;16.5
04;2021-06-18;2559;4901;220342;146617;25.6;17.0
04;2021-06-19;1293;3515;221635;150132;25.8;17.5
04;2021-06-20;625;286;222260;150418;25.8;17.5
04;2021-06-21;1253;3233;223513;153651;26.0;17.9
04;2021-06-22;1599;3747;225112;157398;26.2;18.3
04;2021-06-23;2216;4961;227328;162359;26.4;18.9
04;2021-06-24;2261;4062;229589;166421;26.7;19.4
04;2021-06-25;2157;4097;231746;170518;26.9;19.8
04;2021-06-26;1386;2706;233132;173224;27.1;20.1
04;2021-06-27;650;258;233782;173482;27.2;20.2
04;2021-06-28;1294;2480;235076;175962;27.3;20.5
05;2020-12-27;0;0;0;0;0.0;0.0
05;2020-12-28;0;0;0;0;0.0;0.0
05;2020-12-29;0;0;0;0;0.0;0.0
05;2020-12-30;0;0;0;0;0.0;0.0
05;2020-12-31;0;0;0;0;0.0;0.0
05;2021-01-01;0;0;0;0;0.0;0.0
05;2021-01-02;0;0;0;0;0.0;0.0
05;2021-01-03;0;0;0;0;0.0;0.0
05;2021-01-04;0;0;0;0;0.0;0.0
05;2021-01-05;0;0;0;0;0.0;0.0
05;2021-01-06;0;0;0;0;0.0;0.0
05;2021-01-07;0;0;0;0;0.0;0.0
05;2021-01-08;0;0;0;0;0.0;0.0
05;2021-01-09;0;0;0;0;0.0;0.0
05;2021-01-10;0;0;0;0;0.0;0.0
05;2021-01-11;0;0;0;0;0.0;0.0
05;2021-01-12;0;0;0;0;0.0;0.0
05;2021-01-13;0;0;0;0;0.0;0.0
05;2021-01-14;0;0;0;0;0.0;0.0
05;2021-01-15;0;0;0;0;0.0;0.0
05;2021-01-16;0;0;0;0;0.0;0.0
05;2021-01-17;0;0;0;0;0.0;0.0
05;2021-01-18;0;0;0;0;0.0;0.0
05;2021-01-19;0;0;0;0;0.0;0.0
05;2021-01-20;0;0;0;0;0.0;0.0
05;2021-01-21;0;0;0;0;0.0;0.0
05;2021-01-22;0;0;0;0;0.0;0.0
05;2021-01-23;0;0;0;0;0.0;0.0
05;2021-01-24;0;0;0;0;0.0;0.0
05;2021-01-25;0;0;0;0;0.0;0.0
05;2021-01-26;0;0;0;0;0.0;0.0
05;2021-01-27;0;0;0;0;0.0;0.0
05;2021-01-28;0;0;0;0;0.0;0.0
05;2021-01-29;0;0;0;0;0.0;0.0
05;2021-01-30;0;0;0;0;0.0;0.0
05;2021-01-31;0;0;0;0;0.0;0.0
05;2021-02-01;0;0;0;0;0.0;0.0
05;2021-02-02;0;0;0;0;0.0;0.0
05;2021-02-03;0;0;0;0;0.0;0.0
05;2021-02-04;0;0;0;0;0.0;0.0
05;2021-02-05;0;0;0;0;0.0;0.0
05;2021-02-06;0;0;0;0;0.0;0.0
05;2021-02-07;0;0;0;0;0.0;0.0
05;2021-02-08;0;0;0;0;0.0;0.0
05;2021-02-09;0;0;0;0;0.0;0.0
05;2021-02-10;0;0;0;0;0.0;0.0
05;2021-02-11;0;0;0;0;0.0;0.0
05;2021-02-12;0;0;0;0;0.0;0.0
05;2021-02-13;0;0;0;0;0.0;0.0
05;2021-02-14;0;0;0;0;0.0;0.0
05;2021-02-15;0;0;0;0;0.0;0.0
05;2021-02-16;0;0;0;0;0.0;0.0
05;2021-02-17;0;0;0;0;0.0;0.0
05;2021-02-18;0;0;0;0;0.0;0.0
05;2021-02-19;0;0;0;0;0.0;0.0
05;2021-02-20;0;0;0;0;0.0;0.0
05;2021-02-21;0;0;0;0;0.0;0.0
05;2021-02-22;0;0;0;0;0.0;0.0
05;2021-02-23;0;0;0;0;0.0;0.0
05;2021-02-24;0;0;0;0;0.0;0.0
05;2021-02-25;0;0;0;0;0.0;0.0
05;2021-02-26;0;0;0;0;0.0;0.0
05;2021-02-27;0;0;0;0;0.0;0.0
05;2021-02-28;0;0;0;0;0.0;0.0
05;2021-03-01;0;0;0;0;0.0;0.0
05;2021-03-02;0;0;0;0;0.0;0.0
05;2021-03-03;0;0;0;0;0.0;0.0
05;2021-03-04;0;0;0;0;0.0;0.0
05;2021-03-05;0;0;0;0;0.0;0.0
05;2021-03-06;0;0;0;0;0.0;0.0
05;2021-03-07;0;0;0;0;0.0;0.0
05;2021-03-08;0;0;0;0;0.0;0.0
05;2021-03-09;0;0;0;0;0.0;0.0
05;2021-03-10;0;0;0;0;0.0;0.0
05;2021-03-11;0;0;0;0;0.0;0.0
05;2021-03-12;0;0;0;0;0.0;0.0
05;2021-03-13;0;0;0;0;0.0;0.0
05;2021-03-14;0;0;0;0;0.0;0.0
05;2021-03-15;0;0;0;0;0.0;0.0
05;2021-03-16;0;0;0;0;0.0;0.0
05;2021-03-17;0;0;0;0;0.0;0.0
05;2021-03-18;0;0;0;0;0.0;0.0
05;2021-03-19;0;0;0;0;0.0;0.0
05;2021-03-20;0;0;0;0;0.0;0.0
05;2021-03-21;0;0;0;0;0.0;0.0
05;2021-03-22;0;0;0;0;0.0;0.0
05;2021-03-23;0;0;0;0;0.0;0.0
05;2021-03-24;0;0;0;0;0.0;0.0
05;2021-03-25;0;0;0;0;0.0;0.0
05;2021-03-26;0;0;0;0;0.0;0.0
05;2021-03-27;0;0;0;0;0.0;0.0
05;2021-03-28;0;0;0;0;0.0;0.0
05;2021-03-29;2;0;2;0;0.0;0.0
05;2021-03-30;0;0;2;0;0.0;0.0
05;2021-03-31;0;0;2;0;0.0;0.0
05;2021-04-01;0;0;2;0;0.0;0.0
05;2021-04-02;0;0;2;0;0.0;0.0
05;2021-04-03;0;0;2;0;0.0;0.0
05;2021-04-04;0;0;2;0;0.0;0.0
05;2021-04-05;0;0;2;0;0.0;0.0
05;2021-04-06;0;0;2;0;0.0;0.0
05;2021-04-07;0;0;2;0;0.0;0.0
05;2021-04-08;1;0;3;0;0.1;0.0
05;2021-04-09;0;0;3;0;0.1;0.0
05;2021-04-10;0;0;3;0;0.1;0.0
05;2021-04-11;0;0;3;0;0.1;0.0
05;2021-04-12;0;0;3;0;0.1;0.0
05;2021-04-13;0;0;3;0;0.1;0.0
05;2021-04-14;0;0;3;0;0.1;0.0
05;2021-04-15;0;0;3;0;0.1;0.0
05;2021-04-16;0;0;3;0;0.1;0.0
05;2021-04-17;0;0;3;0;0.1;0.0
05;2021-04-18;0;0;3;0;0.1;0.0
05;2021-04-19;0;0;3;0;0.1;0.0
05;2021-04-20;0;0;3;0;0.1;0.0
05;2021-04-21;0;0;3;0;0.1;0.0
05;2021-04-22;0;0;3;0;0.1;0.0
05;2021-04-23;0;0;3;0;0.1;0.0
05;2021-04-24;0;0;3;0;0.1;0.0
05;2021-04-25;0;0;3;0;0.1;0.0
05;2021-04-26;0;0;3;0;0.1;0.0
05;2021-04-27;0;0;3;0;0.1;0.0
05;2021-04-28;0;0;3;0;0.1;0.0
05;2021-04-29;0;0;3;0;0.1;0.0
05;2021-04-30;0;0;3;0;0.1;0.0
05;2021-05-01;0;0;3;0;0.1;0.0
05;2021-05-02;0;0;3;0;0.1;0.0
05;2021-05-03;0;0;3;0;0.1;0.0
05;2021-05-04;0;0;3;0;0.1;0.0
05;2021-05-05;0;0;3;0;0.1;0.0
05;2021-05-06;0;0;3;0;0.1;0.0
05;2021-05-07;0;0;3;0;0.1;0.0
05;2021-05-08;0;0;3;0;0.1;0.0
05;2021-05-09;0;0;3;0;0.1;0.0
05;2021-05-10;0;0;3;0;0.1;0.0
05;2021-05-11;0;0;3;0;0.1;0.0
05;2021-05-12;0;0;3;0;0.1;0.0
05;2021-05-13;0;0;3;0;0.1;0.0
05;2021-05-14;0;0;3;0;0.1;0.0
05;2021-05-15;0;0;3;0;0.1;0.0
05;2021-05-16;0;0;3;0;0.1;0.0
05;2021-05-17;0;0;3;0;0.1;0.0
05;2021-05-18;0;0;3;0;0.1;0.0
05;2021-05-19;0;0;3;0;0.1;0.0
05;2021-05-20;0;0;3;0;0.1;0.0
05;2021-05-21;0;0;3;0;0.1;0.0
05;2021-05-22;0;0;3;0;0.1;0.0
05;2021-05-23;0;0;3;0;0.1;0.0
05;2021-05-24;0;0;3;0;0.1;0.0
05;2021-05-25;0;0;3;0;0.1;0.0
05;2021-05-26;0;0;3;0;0.1;0.0
05;2021-05-27;0;0;3;0;0.1;0.0
05;2021-05-28;0;0;3;0;0.1;0.0
05;2021-05-29;0;2;3;2;0.1;0.0
05;2021-05-30;0;0;3;2;0.1;0.0
05;2021-05-31;0;0;3;2;0.1;0.0
05;2021-06-01;0;0;3;2;0.1;0.0
05;2021-06-02;0;0;3;2;0.1;0.0
05;2021-06-03;0;0;3;2;0.1;0.0
05;2021-06-04;0;0;3;2;0.1;0.0
05;2021-06-05;0;0;3;2;0.1;0.0
05;2021-06-06;0;0;3;2;0.1;0.0
05;2021-06-07;0;0;3;2;0.1;0.0
05;2021-06-08;0;0;3;2;0.1;0.0
05;2021-06-09;0;0;3;2;0.1;0.0
05;2021-06-10;0;0;3;2;0.1;0.0
05;2021-06-11;0;0;3;2;0.1;0.0
05;2021-06-12;0;0;3;2;0.1;0.0
05;2021-06-13;0;0;3;2;0.1;0.0
05;2021-06-14;0;0;3;2;0.1;0.0
05;2021-06-15;0;0;3;2;0.1;0.0
05;2021-06-16;0;0;3;2;0.1;0.0
05;2021-06-17;0;0;3;2;0.1;0.0
05;2021-06-18;0;0;3;2;0.1;0.0
05;2021-06-19;0;0;3;2;0.1;0.0
05;2021-06-20;0;0;3;2;0.1;0.0
05;2021-06-21;0;0;3;2;0.1;0.0
05;2021-06-22;0;0;3;2;0.1;0.0
05;2021-06-23;0;0;3;2;0.1;0.0
05;2021-06-24;0;0;3;2;0.1;0.0
05;2021-06-25;0;0;3;2;0.1;0.0
05;2021-06-26;0;0;3;2;0.1;0.0
05;2021-06-27;0;0;3;2;0.1;0.0
05;2021-06-28;0;0;3;2;0.1;0.0
06;2020-12-27;0;0;0;0;0.0;0.0
06;2020-12-28;0;0;0;0;0.0;0.0
06;2020-12-29;0;0;0;0;0.0;0.0
06;2020-12-30;0;0;0;0;0.0;0.0
06;2020-12-31;0;0;0;0;0.0;0.0
06;2021-01-01;0;0;0;0;0.0;0.0
06;2021-01-02;0;0;0;0;0.0;0.0
06;2021-01-03;0;0;0;0;0.0;0.0
06;2021-01-04;0;0;0;0;0.0;0.0
06;2021-01-05;0;0;0;0;0.0;0.0
06;2021-01-06;0;0;0;0;0.0;0.0
06;2021-01-07;0;0;0;0;0.0;0.0
06;2021-01-08;0;0;0;0;0.0;0.0
06;2021-01-09;0;0;0;0;0.0;0.0
06;2021-01-10;0;0;0;0;0.0;0.0
06;2021-01-11;9;0;9;0;0.0;0.0
06;2021-01-12;0;0;9;0;0.0;0.0
06;2021-01-13;0;0;9;0;0.0;0.0
06;2021-01-14;0;0;9;0;0.0;0.0
06;2021-01-15;1;0;10;0;0.0;0.0
06;2021-01-16;1;0;11;0;0.0;0.0
06;2021-01-17;0;0;11;0;0.0;0.0
06;2021-01-18;1;0;12;0;0.0;0.0
06;2021-01-19;0;0;12;0;0.0;0.0
06;2021-01-20;0;0;12;0;0.0;0.0
06;2021-01-21;0;0;12;0;0.0;0.0
06;2021-01-22;0;0;12;0;0.0;0.0
06;2021-01-23;1;0;13;0;0.0;0.0
06;2021-01-24;0;0;13;0;0.0;0.0
06;2021-01-25;141;1;154;1;0.1;0.0
06;2021-01-26;166;4;320;5;0.1;0.0
06;2021-01-27;250;2;570;7;0.2;0.0
06;2021-01-28;101;5;671;12;0.2;0.0
06;2021-01-29;230;2;901;14;0.3;0.0
06;2021-01-30;286;9;1187;23;0.4;0.0
06;2021-01-31;1;0;1188;23;0.4;0.0
06;2021-02-01;160;0;1348;23;0.5;0.0
06;2021-02-02;329;7;1677;30;0.6;0.0
06;2021-02-03;228;2;1905;32;0.7;0.0
06;2021-02-04;215;7;2120;39;0.8;0.0
06;2021-02-05;214;1;2334;40;0.8;0.0
06;2021-02-06;83;10;2417;50;0.9;0.0
06;2021-02-07;0;0;2417;50;0.9;0.0
06;2021-02-08;82;3;2499;53;0.9;0.0
06;2021-02-09;193;0;2692;53;1.0;0.0
06;2021-02-10;187;2;2879;55;1.0;0.0
06;2021-02-11;235;2;3114;57;1.1;0.0
06;2021-02-12;287;4;3401;61;1.2;0.0
06;2021-02-13;56;0;3457;61;1.2;0.0
06;2021-02-14;1;0;3458;61;1.2;0.0
06;2021-02-15;359;5;3817;66;1.4;0.0
06;2021-02-16;266;6;4083;72;1.5;0.0
06;2021-02-17;167;5;4250;77;1.5;0.0
06;2021-02-18;217;12;4467;89;1.6;0.0
06;2021-02-19;235;22;4702;111;1.7;0.0
06;2021-02-20;138;7;4840;118;1.7;0.0
06;2021-02-21;0;0;4840;118;1.7;0.0
06;2021-02-22;130;122;4970;240;1.8;0.1
06;2021-02-23;186;151;5156;391;1.8;0.1
06;2021-02-24;176;145;5332;536;1.9;0.2
06;2021-02-25;227;285;5559;821;2.0;0.3
06;2021-02-26;242;259;5801;1080;2.1;0.4
06;2021-02-27;0;0;5801;1080;2.1;0.4
06;2021-02-28;0;0;5801;1080;2.1;0.4
06;2021-03-01;144;259;5945;1339;2.1;0.5
06;2021-03-02;228;257;6173;1596;2.2;0.6
06;2021-03-03;202;189;6375;1785;2.3;0.6
06;2021-03-04;205;140;6580;1925;2.4;0.7
06;2021-03-05;224;114;6804;2039;2.4;0.7
06;2021-03-06;1;0;6805;2039;2.4;0.7
06;2021-03-07;0;0;6805;2039;2.4;0.7
06;2021-03-08;189;125;6994;2164;2.5;0.8
06;2021-03-09;390;155;7384;2319;2.6;0.8
06;2021-03-10;180;178;7564;2497;2.7;0.9
06;2021-03-11;167;207;7731;2704;2.8;1.0
06;2021-03-12;238;288;7969;2992;2.9;1.1
06;2021-03-13;2;0;7971;2992;2.9;1.1
06;2021-03-14;0;0;7971;2992;2.9;1.1
06;2021-03-15;156;292;8127;3284;2.9;1.2
06;2021-03-16;236;223;8363;3507;3.0;1.3
06;2021-03-17;264;140;8627;3647;3.1;1.3
06;2021-03-18;172;232;8799;3879;3.1;1.4
06;2021-03-19;172;298;8971;4177;3.2;1.5
06;2021-03-20;0;0;8971;4177;3.2;1.5
06;2021-03-21;0;0;8971;4177;3.2;1.5
06;2021-03-22;97;136;9068;4313;3.2;1.5
06;2021-03-23;136;240;9204;4553;3.3;1.6
06;2021-03-24;160;146;9364;4699;3.4;1.7
06;2021-03-25;186;206;9550;4905;3.4;1.8
06;2021-03-26;160;212;9710;5117;3.5;1.8
06;2021-03-27;18;0;9728;5117;3.5;1.8
06;2021-03-28;0;0;9728;5117;3.5;1.8
06;2021-03-29;0;2;9728;5119;3.5;1.8
06;2021-03-30;272;334;10000;5453;3.6;2.0
06;2021-03-31;225;125;10225;5578;3.7;2.0
06;2021-04-01;243;104;10468;5682;3.7;2.0
06;2021-04-02;285;263;10753;5945;3.8;2.1
06;2021-04-03;906;307;11659;6252;4.2;2.2
06;2021-04-04;1;0;11660;6252;4.2;2.2
06;2021-04-05;1;0;11661;6252;4.2;2.2
06;2021-04-06;160;282;11821;6534;4.2;2.3
06;2021-04-07;237;265;12058;6799;4.3;2.4
06;2021-04-08;286;140;12344;6939;4.4;2.5
06;2021-04-09;248;171;12592;7110;4.5;2.5
06;2021-04-10;181;114;12773;7224;4.6;2.6
06;2021-04-11;7;0;12780;7224;4.6;2.6
06;2021-04-12;0;19;12780;7243;4.6;2.6
06;2021-04-13;393;343;13173;7586;4.7;2.7
06;2021-04-14;239;205;13412;7791;4.8;2.8
06;2021-04-15;207;117;13619;7908;4.9;2.8
06;2021-04-16;214;127;13833;8035;4.9;2.9
06;2021-04-17;226;132;14059;8167;5.0;2.9
06;2021-04-18;1;0;14060;8167;5.0;2.9
06;2021-04-19;7;1;14067;8168;5.0;2.9
06;2021-04-20;368;224;14435;8392;5.2;3.0
06;2021-04-21;412;150;14847;8542;5.3;3.1
06;2021-04-22;410;150;15257;8692;5.5;3.1
06;2021-04-23;367;166;15624;8858;5.6;3.2
06;2021-04-24;413;127;16037;8985;5.7;3.2
06;2021-04-25;2;0;16039;8985;5.7;3.2
06;2021-04-26;54;8;16093;8993;5.8;3.2
06;2021-04-27;351;293;16444;9286;5.9;3.3
06;2021-04-28;355;515;16799;9801;6.0;3.5
06;2021-04-29;558;345;17357;10146;6.2;3.6
06;2021-04-30;403;238;17760;10384;6.4;3.7
06;2021-05-01;670;285;18430;10669;6.6;3.8
06;2021-05-02;0;0;18430;10669;6.6;3.8
06;2021-05-03;136;6;18566;10675;6.6;3.8
06;2021-05-04;353;426;18919;11101;6.8;4.0
06;2021-05-05;444;317;19363;11418;6.9;4.1
06;2021-05-06;319;200;19682;11618;7.0;4.2
06;2021-05-07;341;134;20023;11752;7.2;4.2
06;2021-05-08;300;140;20323;11892;7.3;4.3
06;2021-05-09;0;0;20323;11892;7.3;4.3
06;2021-05-10;8;9;20331;11901;7.3;4.3
06;2021-05-11;359;489;20690;12390;7.4;4.4
06;2021-05-12;331;310;21021;12700;7.5;4.5
06;2021-05-13;127;97;21148;12797;7.6;4.6
06;2021-05-14;0;0;21148;12797;7.6;4.6
06;2021-05-15;484;283;21632;13080;7.7;4.7
06;2021-05-16;0;0;21632;13080;7.7;4.7
06;2021-05-17;122;51;21754;13131;7.8;4.7
06;2021-05-18;515;430;22269;13561;8.0;4.9
06;2021-05-19;649;663;22918;14224;8.2;5.1
06;2021-05-20;1055;496;23973;14720;8.6;5.3
06;2021-05-21;1046;315;25019;15035;9.0;5.4
06;2021-05-22;1241;300;26260;15335;9.4;5.5
06;2021-05-23;0;0;26260;15335;9.4;5.5
06;2021-05-24;1;0;26261;15335;9.4;5.5
06;2021-05-25;878;624;27139;15959;9.7;5.7
06;2021-05-26;1033;841;28172;16800;10.1;6.0
06;2021-05-27;1307;506;29479;17306;10.5;6.2
06;2021-05-28;952;372;30431;17678;10.9;6.3
06;2021-05-29;1130;390;31561;18068;11.3;6.5
06;2021-05-30;0;1;31561;18069;11.3;6.5
06;2021-05-31;103;6;31664;18075;11.3;6.5
06;2021-06-01;1140;650;32804;18725;11.7;6.7
06;2021-06-02;1153;496;33957;19221;12.2;6.9
06;2021-06-03;792;333;34749;19554;12.4;7.0
06;2021-06-04;977;320;35726;19874;12.8;7.1
06;2021-06-05;655;298;36381;20172;13.0;7.2
06;2021-06-06;0;0;36381;20172;13.0;7.2
06;2021-06-07;84;12;36465;20184;13.0;7.2
06;2021-06-08;917;442;37382;20626;13.4;7.4
06;2021-06-09;951;546;38333;21172;13.7;7.6
06;2021-06-10;650;224;38983;21396;13.9;7.7
06;2021-06-11;825;368;39808;21764;14.2;7.8
06;2021-06-12;563;273;40371;22037;14.4;7.9
06;2021-06-13;0;0;40371;22037;14.4;7.9
06;2021-06-14;178;112;40549;22149;14.5;7.9
06;2021-06-15;399;839;40948;22988;14.7;8.2
06;2021-06-16;880;1437;41828;24425;15.0;8.7
06;2021-06-17;757;650;42585;25075;15.2;9.0
06;2021-06-18;686;617;43271;25692;15.5;9.2
06;2021-06-19;527;639;43798;26331;15.7;9.4
06;2021-06-20;0;0;43798;26331;15.7;9.4
06;2021-06-21;122;128;43920;26459;15.7;9.5
06;2021-06-22;423;1143;44343;27602;15.9;9.9
06;2021-06-23;646;1179;44989;28781;16.1;10.3
06;2021-06-24;455;540;45444;29321;16.3;10.5
06;2021-06-25;522;469;45966;29790;16.4;10.7
06;2021-06-26;380;681;46346;30471;16.6;10.9
06;2021-06-27;0;0;46346;30471;16.6;10.9
06;2021-06-28;99;190;46445;30661;16.6;11.0
07;2020-12-27;0;0;0;0;0.0;0.0
07;2020-12-28;0;0;0;0;0.0;0.0
07;2020-12-29;0;0;0;0;0.0;0.0
07;2020-12-30;0;0;0;0;0.0;0.0
07;2020-12-31;0;0;0;0;0.0;0.0
07;2021-01-01;0;0;0;0;0.0;0.0
07;2021-01-02;0;0;0;0;0.0;0.0
07;2021-01-03;0;0;0;0;0.0;0.0
07;2021-01-04;0;0;0;0;0.0;0.0
07;2021-01-05;0;0;0;0;0.0;0.0
07;2021-01-06;0;0;0;0;0.0;0.0
07;2021-01-07;0;0;0;0;0.0;0.0
07;2021-01-08;0;0;0;0;0.0;0.0
07;2021-01-09;0;0;0;0;0.0;0.0
07;2021-01-10;0;0;0;0;0.0;0.0
07;2021-01-11;0;0;0;0;0.0;0.0
07;2021-01-12;0;0;0;0;0.0;0.0
07;2021-01-13;0;0;0;0;0.0;0.0
07;2021-01-14;0;0;0;0;0.0;0.0
07;2021-01-15;0;0;0;0;0.0;0.0
07;2021-01-16;0;0;0;0;0.0;0.0
07;2021-01-17;0;0;0;0;0.0;0.0
07;2021-01-18;1;0;1;0;0.0;0.0
07;2021-01-19;0;0;1;0;0.0;0.0
07;2021-01-20;0;0;1;0;0.0;0.0
07;2021-01-21;12;0;13;0;0.1;0.0
07;2021-01-22;12;0;25;0;0.3;0.0
07;2021-01-23;0;0;25;0;0.3;0.0
07;2021-01-24;0;0;25;0;0.3;0.0
07;2021-01-25;0;0;25;0;0.3;0.0
07;2021-01-26;0;0;25;0;0.3;0.0
07;2021-01-27;12;0;37;0;0.4;0.0
07;2021-01-28;1;0;38;0;0.4;0.0
07;2021-01-29;6;0;44;0;0.4;0.0
07;2021-01-30;0;0;44;0;0.4;0.0
07;2021-01-31;0;0;44;0;0.4;0.0
07;2021-02-01;0;0;44;0;0.4;0.0
07;2021-02-02;0;0;44;0;0.4;0.0
07;2021-02-03;11;0;55;0;0.6;0.0
07;2021-02-04;12;0;67;0;0.7;0.0
07;2021-02-05;11;0;78;0;0.8;0.0
07;2021-02-06;0;0;78;0;0.8;0.0
07;2021-02-07;0;0;78;0;0.8;0.0
07;2021-02-08;0;0;78;0;0.8;0.0
07;2021-02-09;13;0;91;0;0.9;0.0
07;2021-02-10;0;0;91;0;0.9;0.0
07;2021-02-11;16;0;107;0;1.1;0.0
07;2021-02-12;45;0;152;0;1.5;0.0
07;2021-02-13;0;0;152;0;1.5;0.0
07;2021-02-14;0;0;152;0;1.5;0.0
07;2021-02-15;0;0;152;0;1.5;0.0
07;2021-02-16;0;0;152;0;1.5;0.0
07;2021-02-17;0;0;152;0;1.5;0.0
07;2021-02-18;18;0;170;0;1.7;0.0
07;2021-02-19;34;0;204;0;2.0;0.0
07;2021-02-20;0;0;204;0;2.0;0.0
07;2021-02-21;0;0;204;0;2.0;0.0
07;2021-02-22;0;0;204;0;2.0;0.0
07;2021-02-23;0;22;204;22;2.0;0.2
07;2021-02-24;0;0;204;22;2.0;0.2
07;2021-02-25;15;10;219;32;2.2;0.3
07;2021-02-26;33;21;252;53;2.5;0.5
07;2021-02-27;0;0;252;53;2.5;0.5
07;2021-02-28;0;0;252;53;2.5;0.5
07;2021-03-01;0;0;252;53;2.5;0.5
07;2021-03-02;17;11;269;64;2.7;0.6
07;2021-03-03;0;0;269;64;2.7;0.6
07;2021-03-04;16;11;285;75;2.9;0.8
07;2021-03-05;33;19;318;94;3.2;0.9
07;2021-03-06;0;0;318;94;3.2;0.9
07;2021-03-07;0;0;318;94;3.2;0.9
07;2021-03-08;0;0;318;94;3.2;0.9
07;2021-03-09;1;0;319;94;3.2;0.9
07;2021-03-10;0;0;319;94;3.2;0.9
07;2021-03-11;20;30;339;124;3.4;1.2
07;2021-03-12;62;42;401;166;4.0;1.7
07;2021-03-13;0;0;401;166;4.0;1.7
07;2021-03-14;0;0;401;166;4.0;1.7
07;2021-03-15;0;0;401;166;4.0;1.7
07;2021-03-16;30;9;431;175;4.3;1.8
07;2021-03-17;0;0;431;175;4.3;1.8
07;2021-03-18;29;16;460;191;4.6;1.9
07;2021-03-19;56;31;516;222;5.2;2.2
07;2021-03-20;0;0;516;222;5.2;2.2
07;2021-03-21;0;0;516;222;5.2;2.2
07;2021-03-22;0;0;516;222;5.2;2.2
07;2021-03-23;0;0;516;222;5.2;2.2
07;2021-03-24;0;0;516;222;5.2;2.2
07;2021-03-25;65;17;581;239;5.8;2.4
07;2021-03-26;73;26;654;265;6.6;2.7
07;2021-03-27;0;0;654;265;6.6;2.7
07;2021-03-28;0;0;654;265;6.6;2.7
07;2021-03-29;0;0;654;265;6.6;2.7
07;2021-03-30;40;18;694;283;7.0;2.8
07;2021-03-31;26;15;720;298;7.2;3.0
07;2021-04-01;25;32;745;330;7.5;3.3
07;2021-04-02;0;0;745;330;7.5;3.3
07;2021-04-03;0;0;745;330;7.5;3.3
07;2021-04-04;0;0;745;330;7.5;3.3
07;2021-04-05;9;0;754;330;7.6;3.3
07;2021-04-06;0;0;754;330;7.6;3.3
07;2021-04-07;0;0;754;330;7.6;3.3
07;2021-04-08;57;46;811;376;8.1;3.8
07;2021-04-09;59;31;870;407;8.7;4.1
07;2021-04-10;0;0;870;407;8.7;4.1
07;2021-04-11;0;0;870;407;8.7;4.1
07;2021-04-12;0;0;870;407;8.7;4.1
07;2021-04-13;0;0;870;407;8.7;4.1
07;2021-04-14;5;6;875;413;8.8;4.1
07;2021-04-15;56;71;931;484;9.3;4.9
07;2021-04-16;90;35;1021;519;10.2;5.2
07;2021-04-17;0;1;1021;520;10.2;5.2
07;2021-04-18;0;0;1021;520;10.2;5.2
07;2021-04-19;1;0;1022;520;10.3;5.2
07;2021-04-20;335;66;1357;586;13.6;5.9
07;2021-04-21;337;29;1694;615;17.0;6.2
07;2021-04-22;284;50;1978;665;19.9;6.7
07;2021-04-23;258;41;2236;706;22.4;7.1
07;2021-04-24;231;1;2467;707;24.8;7.1
07;2021-04-25;0;0;2467;707;24.8;7.1
07;2021-04-26;283;20;2750;727;27.6;7.3
07;2021-04-27;224;69;2974;796;29.9;8.0
07;2021-04-28;192;26;3166;822;31.8;8.3
07;2021-04-29;170;22;3336;844;33.5;8.5
07;2021-04-30;172;15;3508;859;35.2;8.6
07;2021-05-01;200;12;3708;871;37.2;8.7
07;2021-05-02;0;0;3708;871;37.2;8.7
07;2021-05-03;134;10;3842;881;38.6;8.8
07;2021-05-04;161;54;4003;935;40.2;9.4
07;2021-05-05;221;30;4224;965;42.4;9.7
07;2021-05-06;175;31;4399;996;44.2;10.0
07;2021-05-07;149;31;4548;1027;45.7;10.3
07;2021-05-08;1;0;4549;1027;45.7;10.3
07;2021-05-09;0;2;4549;1029;45.7;10.3
07;2021-05-10;0;0;4549;1029;45.7;10.3
07;2021-05-11;2;41;4551;1070;45.7;10.7
07;2021-05-12;6;36;4557;1106;45.7;11.1
07;2021-05-13;0;0;4557;1106;45.7;11.1
07;2021-05-14;28;98;4585;1204;46.0;12.1
07;2021-05-15;0;0;4585;1204;46.0;12.1
07;2021-05-16;0;0;4585;1204;46.0;12.1
07;2021-05-17;1;14;4586;1218;46.0;12.2
07;2021-05-18;17;32;4603;1250;46.2;12.5
07;2021-05-19;0;1;4603;1251;46.2;12.6
07;2021-05-20;0;8;4603;1259;46.2;12.6
07;2021-05-21;12;32;4615;1291;46.3;13.0
07;2021-05-22;0;0;4615;1291;46.3;13.0
07;2021-05-23;0;0;4615;1291;46.3;13.0
07;2021-05-24;0;0;4615;1291;46.3;13.0
07;2021-05-25;50;334;4665;1625;46.8;16.3
07;2021-05-26;55;359;4720;1984;47.4;19.9
07;2021-05-27;34;317;4754;2301;47.7;23.1
07;2021-05-28;27;256;4781;2557;48.0;25.7
07;2021-05-29;35;376;4816;2933;48.3;29.4
07;2021-05-30;0;0;4816;2933;48.3;29.4
07;2021-05-31;45;218;4861;3151;48.8;31.6
07;2021-06-01;47;226;4908;3377;49.3;33.9
07;2021-06-02;69;273;4977;3650;50.0;36.6
07;2021-06-03;41;252;5018;3902;50.4;39.2
07;2021-06-04;73;272;5091;4174;51.1;41.9
07;2021-06-05;1;0;5092;4174;51.1;41.9
07;2021-06-06;0;0;5092;4174;51.1;41.9
07;2021-06-07;1;1;5093;4175;51.1;41.9
07;2021-06-08;3;2;5096;4177;51.2;41.9
07;2021-06-09;0;3;5096;4180;51.2;42.0
07;2021-06-10;8;4;5104;4184;51.2;42.0
07;2021-06-11;3;8;5107;4192;51.3;42.1
07;2021-06-12;15;59;5122;4251;51.4;42.7
07;2021-06-13;0;0;5122;4251;51.4;42.7
07;2021-06-14;0;0;5122;4251;51.4;42.7
07;2021-06-15;0;1;5122;4252;51.4;42.7
07;2021-06-16;0;0;5122;4252;51.4;42.7
07;2021-06-17;2;6;5124;4258;51.4;42.7
07;2021-06-18;0;2;5124;4260;51.4;42.8
07;2021-06-19;25;49;5149;4309;51.7;43.3
07;2021-06-20;0;0;5149;4309;51.7;43.3
07;2021-06-21;0;2;5149;4311;51.7;43.3
07;2021-06-22;8;0;5157;4311;51.8;43.3
07;2021-06-23;15;9;5172;4320;51.9;43.4
07;2021-06-24;10;5;5182;4325;52.0;43.4
07;2021-06-25;0;0;5182;4325;52.0;43.4
07;2021-06-26;28;49;5210;4374;52.3;43.9
07;2021-06-27;0;0;5210;4374;52.3;43.9
07;2021-06-28;0;1;5210;4375;52.3;43.9
08;2020-12-27;0;0;0;0;0.0;0.0
08;2020-12-28;0;0;0;0;0.0;0.0
08;2020-12-29;0;0;0;0;0.0;0.0
08;2020-12-30;0;0;0;0;0.0;0.0
08;2020-12-31;0;0;0;0;0.0;0.0
08;2021-01-01;0;0;0;0;0.0;0.0
08;2021-01-02;0;0;0;0;0.0;0.0
08;2021-01-03;0;0;0;0;0.0;0.0
08;2021-01-04;0;0;0;0;0.0;0.0
08;2021-01-05;0;0;0;0;0.0;0.0
08;2021-01-06;0;0;0;0;0.0;0.0
08;2021-01-07;0;0;0;0;0.0;0.0
08;2021-01-08;0;0;0;0;0.0;0.0
08;2021-01-09;0;0;0;0;0.0;0.0
08;2021-01-10;0;0;0;0;0.0;0.0
08;2021-01-11;0;0;0;0;0.0;0.0
08;2021-01-12;0;0;0;0;0.0;0.0
08;2021-01-13;10;0;10;0;0.0;0.0
08;2021-01-14;12;0;22;0;0.1;0.0
08;2021-01-15;7;0;29;0;0.1;0.0
08;2021-01-16;0;0;29;0;0.1;0.0
08;2021-01-17;0;0;29;0;0.1;0.0
08;2021-01-18;0;0;29;0;0.1;0.0
08;2021-01-19;12;0;41;0;0.1;0.0
08;2021-01-20;12;0;53;0;0.1;0.0
08;2021-01-21;6;0;59;0;0.2;0.0
08;2021-01-22;0;0;59;0;0.2;0.0
08;2021-01-23;0;0;59;0;0.2;0.0
08;2021-01-24;0;0;59;0;0.2;0.0
08;2021-01-25;0;0;59;0;0.2;0.0
08;2021-01-26;9;0;68;0;0.2;0.0
08;2021-01-27;10;0;78;0;0.2;0.0
08;2021-01-28;6;0;84;0;0.2;0.0
08;2021-01-29;0;0;84;0;0.2;0.0
08;2021-01-30;0;0;84;0;0.2;0.0
08;2021-01-31;0;0;84;0;0.2;0.0
08;2021-02-01;0;0;84;0;0.2;0.0
08;2021-02-02;38;0;122;0;0.3;0.0
08;2021-02-03;10;0;132;0;0.4;0.0
08;2021-02-04;29;0;161;0;0.5;0.0
08;2021-02-05;7;0;168;0;0.5;0.0
08;2021-02-06;0;0;168;0;0.5;0.0
08;2021-02-07;0;0;168;0;0.5;0.0
08;2021-02-08;0;0;168;0;0.5;0.0
08;2021-02-09;38;0;206;0;0.6;0.0
08;2021-02-10;27;1;233;1;0.7;0.0
08;2021-02-11;0;0;233;1;0.7;0.0
08;2021-02-12;36;0;269;1;0.8;0.0
08;2021-02-13;0;0;269;1;0.8;0.0
08;2021-02-14;0;0;269;1;0.8;0.0
08;2021-02-15;50;0;319;1;0.9;0.0
08;2021-02-16;0;0;319;1;0.9;0.0
08;2021-02-17;0;0;319;1;0.9;0.0
08;2021-02-18;27;0;346;1;1.0;0.0
08;2021-02-19;44;0;390;1;1.1;0.0
08;2021-02-20;0;0;390;1;1.1;0.0
08;2021-02-21;0;0;390;1;1.1;0.0
08;2021-02-22;46;4;436;5;1.2;0.0
08;2021-02-23;41;29;477;34;1.3;0.1
08;2021-02-24;35;1;512;35;1.4;0.1
08;2021-02-25;55;36;567;71;1.6;0.2
08;2021-02-26;39;5;606;76;1.7;0.2
08;2021-02-27;0;0;606;76;1.7;0.2
08;2021-02-28;0;0;606;76;1.7;0.2
08;2021-03-01;48;5;654;81;1.9;0.2
08;2021-03-02;7;27;661;108;1.9;0.3
08;2021-03-03;38;27;699;135;2.0;0.4
08;2021-03-04;30;26;729;161;2.1;0.5
08;2021-03-05;46;11;775;172;2.2;0.5
08;2021-03-06;0;0;775;172;2.2;0.5
08;2021-03-07;0;0;775;172;2.2;0.5
08;2021-03-08;30;7;805;179;2.3;0.5
08;2021-03-09;19;27;824;206;2.3;0.6
08;2021-03-10;32;28;856;234;2.4;0.7
08;2021-03-11;2;0;858;234;2.4;0.7
08;2021-03-12;52;21;910;255;2.6;0.7
08;2021-03-13;11;0;921;255;2.6;0.7
08;2021-03-14;0;0;921;255;2.6;0.7
08;2021-03-15;31;43;952;298;2.7;0.8
08;2021-03-16;73;6;1025;304;2.9;0.9
08;2021-03-17;67;13;1092;317;3.1;0.9
08;2021-03-18;82;39;1174;356;3.3;1.0
08;2021-03-19;30;51;1204;407;3.4;1.2
08;2021-03-20;0;0;1204;407;3.4;1.2
08;2021-03-21;0;0;1204;407;3.4;1.2
08;2021-03-22;34;45;1238;452;3.5;1.3
08;2021-03-23;30;43;1268;495;3.6;1.4
08;2021-03-24;38;42;1306;537;3.7;1.5
08;2021-03-25;92;34;1398;571;4.0;1.6
08;2021-03-26;45;33;1443;604;4.1;1.7
08;2021-03-27;93;3;1536;607;4.3;1.7
08;2021-03-28;0;0;1536;607;4.3;1.7
08;2021-03-29;69;49;1605;656;4.5;1.9
08;2021-03-30;98;24;1703;680;4.8;1.9
08;2021-03-31;89;47;1792;727;5.1;2.1
08;2021-04-01;56;48;1848;775;5.2;2.2
08;2021-04-02;0;0;1848;775;5.2;2.2
08;2021-04-03;0;0;1848;775;5.2;2.2
08;2021-04-04;0;0;1848;775;5.2;2.2
08;2021-04-05;0;0;1848;775;5.2;2.2
08;2021-04-06;49;63;1897;838;5.4;2.4
08;2021-04-07;91;32;1988;870;5.6;2.5
08;2021-04-08;120;7;2108;877;6.0;2.5
08;2021-04-09;89;39;2197;916;6.2;2.6
08;2021-04-10;162;8;2359;924;6.7;2.6
08;2021-04-11;0;0;2359;924;6.7;2.6
08;2021-04-12;41;76;2400;1000;6.8;2.8
08;2021-04-13;48;71;2448;1071;6.9;3.0
08;2021-04-14;81;45;2529;1116;7.2;3.2
08;2021-04-15;92;25;2621;1141;7.4;3.2
08;2021-04-16;77;42;2698;1183;7.6;3.3
08;2021-04-17;165;4;2863;1187;8.1;3.4
08;2021-04-18;0;0;2863;1187;8.1;3.4
08;2021-04-19;52;67;2915;1254;8.2;3.5
08;2021-04-20;83;27;2998;1281;8.5;3.6
08;2021-04-21;91;29;3089;1310;8.7;3.7
08;2021-04-22;101;20;3190;1330;9.0;3.8
08;2021-04-23;44;66;3234;1396;9.2;4.0
08;2021-04-24;99;78;3333;1474;9.4;4.2
08;2021-04-25;0;0;3333;1474;9.4;4.2
08;2021-04-26;28;93;3361;1567;9.5;4.4
08;2021-04-27;58;63;3419;1630;9.7;4.6
08;2021-04-28;88;39;3507;1669;9.9;4.7
08;2021-04-29;90;34;3597;1703;10.2;4.8
08;2021-04-30;104;15;3701;1718;10.5;4.9
08;2021-05-01;0;8;3701;1726;10.5;4.9
08;2021-05-02;0;0;3701;1726;10.5;4.9
08;2021-05-03;24;102;3725;1828;10.5;5.2
08;2021-05-04;157;103;3882;1931;11.0;5.5
08;2021-05-05;141;59;4023;1990;11.4;5.6
08;2021-05-06;199;49;4222;2039;11.9;5.8
08;2021-05-07;127;71;4349;2110;12.3;6.0
08;2021-05-08;69;122;4418;2232;12.5;6.3
08;2021-05-09;0;0;4418;2232;12.5;6.3
08;2021-05-10;123;102;4541;2334;12.9;6.6
08;2021-05-11;132;77;4673;2411;13.2;6.8
08;2021-05-12;156;76;4829;2487;13.7;7.0
08;2021-05-13;82;6;4911;2493;13.9;7.1
08;2021-05-14;129;62;5040;2555;14.3;7.2
08;2021-05-15;85;4;5125;2559;14.5;7.2
08;2021-05-16;0;0;5125;2559;14.5;7.2
08;2021-05-17;145;112;5270;2671;14.9;7.6
08;2021-05-18;151;95;5421;2766;15.3;7.8
08;2021-05-19;84;70;5505;2836;15.6;8.0
08;2021-05-20;103;26;5608;2862;15.9;8.1
08;2021-05-21;97;52;5705;2914;16.1;8.2
08;2021-05-22;99;11;5804;2925;16.4;8.3
08;2021-05-23;0;0;5804;2925;16.4;8.3
08;2021-05-24;33;7;5837;2932;16.5;8.3
08;2021-05-25;119;78;5956;3010;16.9;8.5
08;2021-05-26;107;51;6063;3061;17.2;8.7
08;2021-05-27;109;42;6172;3103;17.5;8.8
08;2021-05-28;33;1;6205;3104;17.6;8.8
08;2021-05-29;59;215;6264;3319;17.7;9.4
08;2021-05-30;0;0;6264;3319;17.7;9.4
08;2021-05-31;108;64;6372;3383;18.0;9.6
08;2021-06-01;112;63;6484;3446;18.4;9.8
08;2021-06-02;130;33;6614;3479;18.7;9.8
08;2021-06-03;100;38;6714;3517;19.0;10.0
08;2021-06-04;128;71;6842;3588;19.4;10.2
08;2021-06-05;82;21;6924;3609;19.6;10.2
08;2021-06-06;0;0;6924;3609;19.6;10.2
08;2021-06-07;96;95;7020;3704;19.9;10.5
08;2021-06-08;79;90;7099;3794;20.1;10.7
08;2021-06-09;98;74;7197;3868;20.4;10.9
08;2021-06-10;111;66;7308;3934;20.7;11.1
08;2021-06-11;116;108;7424;4042;21.0;11.4
08;2021-06-12;57;30;7481;4072;21.2;11.5
08;2021-06-13;0;0;7481;4072;21.2;11.5
08;2021-06-14;106;128;7587;4200;21.5;11.9
08;2021-06-15;86;118;7673;4318;21.7;12.2
08;2021-06-16;103;148;7776;4466;22.0;12.6
08;2021-06-17;84;72;7860;4538;22.2;12.8
08;2021-06-18;65;99;7925;4637;22.4;13.1
08;2021-06-19;64;80;7989;4717;22.6;13.3
08;2021-06-20;0;0;7989;4717;22.6;13.3
08;2021-06-21;78;149;8067;4866;22.8;13.8
08;2021-06-22;69;100;8136;4966;23.0;14.1
08;2021-06-23;68;113;8204;5079;23.2;14.4
08;2021-06-24;42;73;8246;5152;23.3;14.6
08;2021-06-25;62;99;8308;5251;23.5;14.9
08;2021-06-26;35;61;8343;5312;23.6;15.0
08;2021-06-27;0;0;8343;5312;23.6;15.0
08;2021-06-28;70;127;8413;5439;23.8;15.4
11;2020-12-27;13;2;13;2;0.0;0.0
11;2020-12-28;11;0;24;2;0.0;0.0
11;2020-12-29;56;0;80;2;0.0;0.0
11;2020-12-30;91;0;171;2;0.0;0.0
11;2020-12-31;39;0;210;2;0.0;0.0
11;2021-01-01;30;1;240;3;0.0;0.0
11;2021-01-02;64;1;304;4;0.0;0.0
11;2021-01-03;78;0;382;4;0.0;0.0
11;2021-01-04;554;5;936;9;0.0;0.0
11;2021-01-05;2069;17;3005;26;0.0;0.0
11;2021-01-06;3019;23;6024;49;0.0;0.0
11;2021-01-07;5388;38;11412;87;0.1;0.0
11;2021-01-08;7123;48;18535;135;0.2;0.0
11;2021-01-09;1890;7;20425;142;0.2;0.0
11;2021-01-10;1755;7;22180;149;0.2;0.0
11;2021-01-11;8012;67;30192;216;0.2;0.0
11;2021-01-12;10372;101;40564;317;0.3;0.0
11;2021-01-13;10020;101;50584;418;0.4;0.0
11;2021-01-14;10126;136;60710;554;0.5;0.0
11;2021-01-15;8920;88;69630;642;0.6;0.0
11;2021-01-16;2413;37;72043;679;0.6;0.0
11;2021-01-17;1090;19;73133;698;0.6;0.0
11;2021-01-18;12260;135;85393;833;0.7;0.0
11;2021-01-19;15857;128;101250;961;0.8;0.0
11;2021-01-20;18382;121;119632;1082;1.0;0.0
11;2021-01-21;22293;155;141925;1237;1.2;0.0
11;2021-01-22;17104;168;159029;1405;1.3;0.0
11;2021-01-23;4960;21;163989;1426;1.3;0.0
11;2021-01-24;1282;6;165271;1432;1.3;0.0
11;2021-01-25;8873;192;174144;1624;1.4;0.0
11;2021-01-26;12340;387;186484;2011;1.5;0.0
11;2021-01-27;16229;693;202713;2704;1.7;0.0
11;2021-01-28;20302;1197;223015;3901;1.8;0.0
11;2021-01-29;15396;1388;238411;5289;1.9;0.0
11;2021-01-30;4465;106;242876;5395;2.0;0.0
11;2021-01-31;585;22;243461;5417;2.0;0.0
11;2021-02-01;7389;1960;250850;7377;2.0;0.1
11;2021-02-02;8353;2820;259203;10197;2.1;0.1
11;2021-02-03;8122;3807;267325;14004;2.2;0.1
11;2021-02-04;8784;4597;276109;18601;2.2;0.2
11;2021-02-05;8952;4431;285061;23032;2.3;0.2
11;2021-02-06;3271;752;288332;23784;2.3;0.2
11;2021-02-07;588;542;288920;24326;2.4;0.2
11;2021-02-08;6229;5925;295149;30251;2.4;0.2
11;2021-02-09;8433;9691;303582;39942;2.5;0.3
11;2021-02-10;9955;11227;313537;51169;2.6;0.4
11;2021-02-11;12367;16524;325904;67693;2.7;0.6
11;2021-02-12;11867;10620;337771;78313;2.8;0.6
11;2021-02-13;2592;2590;340363;80903;2.8;0.7
11;2021-02-14;312;560;340675;81463;2.8;0.7
11;2021-02-15;4454;12036;345129;93499;2.8;0.8
11;2021-02-16;5666;18522;350795;112021;2.9;0.9
11;2021-02-17;5677;15634;356472;127655;2.9;1.0
11;2021-02-18;8639;20819;365111;148474;3.0;1.2
11;2021-02-19;9042;15461;374153;163935;3.0;1.3
11;2021-02-20;1691;4848;375844;168783;3.1;1.4
11;2021-02-21;396;831;376240;169614;3.1;1.4
11;2021-02-22;4229;9933;380469;179547;3.1;1.5
11;2021-02-23;4946;10559;385415;190106;3.1;1.5
11;2021-02-24;5407;9899;390822;200005;3.2;1.6
11;2021-02-25;8620;14184;399442;214189;3.3;1.7
11;2021-02-26;11190;10202;410632;224391;3.3;1.8
11;2021-02-27;5068;3340;415700;227731;3.4;1.9
11;2021-02-28;741;662;416441;228393;3.4;1.9
11;2021-03-01;8845;8012;425286;236405;3.5;1.9
11;2021-03-02;14386;9675;439672;246080;3.6;2.0
11;2021-03-03;18677;10157;458349;256237;3.7;2.1
11;2021-03-04;28260;11173;486609;267410;4.0;2.2
11;2021-03-05;36504;11162;523113;278572;4.3;2.3
11;2021-03-06;46430;3611;569543;282183;4.6;2.3
11;2021-03-07;34305;2807;603848;284990;4.9;2.3
11;2021-03-08;17772;7445;621620;292435;5.1;2.4
11;2021-03-09;26869;7771;648489;300206;5.3;2.4
11;2021-03-10;27652;8406;676141;308612;5.5;2.5
11;2021-03-11;37053;9969;713194;318581;5.8;2.6
11;2021-03-12;44802;9512;757996;328093;6.2;2.7
11;2021-03-13;39881;2720;797877;330813;6.5;2.7
11;2021-03-14;14273;824;812150;331637;6.6;2.7
11;2021-03-15;29226;4055;841376;335692;6.9;2.7
11;2021-03-16;23759;3887;865135;339579;7.0;2.8
11;2021-03-17;24440;3697;889575;343276;7.2;2.8
11;2021-03-18;29024;4173;918599;347449;7.5;2.8
11;2021-03-19;39666;4362;958265;351811;7.8;2.9
11;2021-03-20;25864;1624;984129;353435;8.0;2.9
11;2021-03-21;5628;1340;989757;354775;8.1;2.9
11;2021-03-22;32139;4291;1021896;359066;8.3;2.9
11;2021-03-23;43320;5516;1065216;364582;8.7;3.0
11;2021-03-24;42658;5131;1107874;369713;9.0;3.0
11;2021-03-25;57936;5339;1165810;375052;9.5;3.1
11;2021-03-26;57738;6097;1223548;381149;10.0;3.1
11;2021-03-27;34506;2152;1258054;383301;10.2;3.1
11;2021-03-28;10160;505;1268214;383806;10.3;3.1
11;2021-03-29;33064;8244;1301278;392050;10.6;3.2
11;2021-03-30;44879;11690;1346157;403740;11.0;3.3
11;2021-03-31;39897;14008;1386054;417748;11.3;3.4
11;2021-04-01;45379;21923;1431433;439671;11.7;3.6
11;2021-04-02;39388;24217;1470821;463888;12.0;3.8
11;2021-04-03;18386;21195;1489207;485083;12.1;4.0
11;2021-04-04;6115;7364;1495322;492447;12.2;4.0
11;2021-04-05;5960;2170;1501282;494617;12.2;4.0
11;2021-04-06;29975;18523;1531257;513140;12.5;4.2
11;2021-04-07;37555;20121;1568812;533261;12.8;4.3
11;2021-04-08;46681;21236;1615493;554497;13.2;4.5
11;2021-04-09;53798;21727;1669291;576224;13.6;4.7
11;2021-04-10;28965;19782;1698256;596006;13.8;4.9
11;2021-04-11;6550;7237;1704806;603243;13.9;4.9
11;2021-04-12;30315;19356;1735121;622599;14.1;5.1
11;2021-04-13;37314;27684;1772435;650283;14.4;5.3
11;2021-04-14;35014;24436;1807449;674719;14.7;5.5
11;2021-04-15;39170;28615;1846619;703334;15.0;5.7
11;2021-04-16;41045;27922;1887664;731256;15.4;6.0
11;2021-04-17;22787;15044;1910451;746300;15.6;6.1
11;2021-04-18;5299;3746;1915750;750046;15.6;6.1
11;2021-04-19;25096;23268;1940846;773314;15.8;6.3
11;2021-04-20;30590;27985;1971436;801299;16.1;6.5
11;2021-04-21;32234;28301;2003670;829600;16.3;6.8
11;2021-04-22;34492;34850;2038162;864450;16.6;7.0
11;2021-04-23;37943;32426;2076105;896876;16.9;7.3
11;2021-04-24;37962;23259;2114067;920135;17.2;7.5
11;2021-04-25;20517;8042;2134584;928177;17.4;7.6
11;2021-04-26;33888;25319;2168472;953496;17.7;7.8
11;2021-04-27;45753;30205;2214225;983701;18.0;8.0
11;2021-04-28;48427;29939;2262652;1013640;18.4;8.3
11;2021-04-29;57796;32436;2320448;1046076;18.9;8.5
11;2021-04-30;61316;31233;2381764;1077309;19.4;8.8
11;2021-05-01;24102;6074;2405866;1083383;19.6;8.8
11;2021-05-02;14629;5038;2420495;1088421;19.7;8.9
11;2021-05-03;54422;35362;2474917;1123783;20.2;9.2
11;2021-05-04;59724;34031;2534641;1157814;20.6;9.4
11;2021-05-05;60322;34225;2594963;1192039;21.1;9.7
11;2021-05-06;67260;38191;2662223;1230230;21.7;10.0
11;2021-05-07;65571;40123;2727794;1270353;22.2;10.3
11;2021-05-08;51163;16999;2778957;1287352;22.6;10.5
11;2021-05-09;33181;10252;2812138;1297604;22.9;10.6
11;2021-05-10;70791;30692;2882929;1328296;23.5;10.8
11;2021-05-11;81822;38221;2964751;1366517;24.1;11.1
11;2021-05-12;83645;32595;3048396;1399112;24.8;11.4
11;2021-05-13;68188;10092;3116584;1409204;25.4;11.5
11;2021-05-14;84609;22266;3201193;1431470;26.1;11.7
11;2021-05-15;66769;15510;3267962;1446980;26.6;11.8
11;2021-05-16;36677;5223;3304639;1452203;26.9;11.8
11;2021-05-17;82870;17023;3387509;1469226;27.6;12.0
11;2021-05-18;98936;20028;3486445;1489254;28.4;12.1
11;2021-05-19;98008;27945;3584453;1517199;29.2;12.4
11;2021-05-20;106713;28923;3691166;1546122;30.1;12.6
11;2021-05-21;101071;26101;3792237;1572223;30.9;12.8
11;2021-05-22;79517;14926;3871754;1587149;31.5;12.9
11;2021-05-23;41699;6098;3913453;1593247;31.9;13.0
11;2021-05-24;59664;8836;3973117;1602083;32.4;13.0
11;2021-05-25;85400;32327;4058517;1634410;33.1;13.3
11;2021-05-26;83905;32595;4142422;1667005;33.7;13.6
11;2021-05-27;92133;40659;4234555;1707664;34.5;13.9
11;2021-05-28;86766;45703;4321321;1753367;35.2;14.3
11;2021-05-29;68146;27619;4389467;1780986;35.8;14.5
11;2021-05-30;35926;8545;4425393;1789531;36.0;14.6
11;2021-05-31;77873;40042;4503266;1829573;36.7;14.9
11;2021-06-01;86857;51038;4590123;1880611;37.4;15.3
11;2021-06-02;82950;45639;4673073;1926250;38.1;15.7
11;2021-06-03;88752;53781;4761825;1980031;38.8;16.1
11;2021-06-04;84551;58847;4846376;2038878;39.5;16.6
11;2021-06-05;63524;49988;4909900;2088866;40.0;17.0
11;2021-06-06;37882;17610;4947782;2106476;40.3;17.2
11;2021-06-07;68838;53707;5016620;2160183;40.9;17.6
11;2021-06-08;72171;61951;5088791;2222134;41.4;18.1
11;2021-06-09;70418;63167;5159209;2285301;42.0;18.6
11;2021-06-10;70895;80885;5230104;2366186;42.6;19.3
11;2021-06-11;65485;72163;5295589;2438349;43.1;19.9
11;2021-06-12;63660;47717;5359249;2486066;43.6;20.2
11;2021-06-13;29513;22886;5388762;2508952;43.9;20.4
11;2021-06-14;43129;75306;5431891;2584258;44.2;21.0
11;2021-06-15;51016;82984;5482907;2667242;44.7;21.7
11;2021-06-16;52296;78284;5535203;2745526;45.1;22.4
11;2021-06-17;53971;81775;5589174;2827301;45.5;23.0
11;2021-06-18;49875;96027;5639049;2923328;45.9;23.8
11;2021-06-19;43449;69206;5682498;2992534;46.3;24.4
11;2021-06-20;16291;36074;5698789;3028608;46.4;24.7
11;2021-06-21;34306;84365;5733095;3112973;46.7;25.4
11;2021-06-22;38912;101194;5772007;3214167;47.0;26.2
11;2021-06-23;39371;98193;5811378;3312360;47.3;27.0
11;2021-06-24;42133;96080;5853511;3408440;47.7;27.8
11;2021-06-25;38425;110688;5891936;3519128;48.0;28.7
11;2021-06-26;35194;86015;5927130;3605143;48.3;29.4
11;2021-06-27;13267;40343;5940397;3645486;48.4;29.7
11;2021-06-28;29869;95792;5970266;3741278;48.6;30.5
24;2020-12-27;0;0;0;0;0.0;0.0
24;2020-12-28;17;0;17;0;0.0;0.0
24;2020-12-29;10;0;27;0;0.0;0.0
24;2020-12-30;1;0;28;0;0.0;0.0
24;2020-12-31;0;0;28;0;0.0;0.0
24;2021-01-01;1;0;29;0;0.0;0.0
24;2021-01-02;0;0;29;0;0.0;0.0
24;2021-01-03;0;0;29;0;0.0;0.0
24;2021-01-04;24;0;53;0;0.0;0.0
24;2021-01-05;163;0;216;0;0.0;0.0
24;2021-01-06;328;0;544;0;0.0;0.0
24;2021-01-07;492;1;1036;1;0.0;0.0
24;2021-01-08;952;2;1988;3;0.1;0.0
24;2021-01-09;504;0;2492;3;0.1;0.0
24;2021-01-10;395;0;2887;3;0.1;0.0
24;2021-01-11;1279;2;4166;5;0.2;0.0
24;2021-01-12;2575;9;6741;14;0.3;0.0
24;2021-01-13;2189;8;8930;22;0.3;0.0
24;2021-01-14;2503;52;11433;74;0.4;0.0
24;2021-01-15;2114;9;13547;83;0.5;0.0
24;2021-01-16;857;5;14404;88;0.6;0.0
24;2021-01-17;322;3;14726;91;0.6;0.0
24;2021-01-18;3214;16;17940;107;0.7;0.0
24;2021-01-19;6325;17;24265;124;0.9;0.0
24;2021-01-20;7166;10;31431;134;1.2;0.0
24;2021-01-21;7418;4;38849;138;1.5;0.0
24;2021-01-22;5119;5;43968;143;1.7;0.0
24;2021-01-23;1275;1;45243;144;1.8;0.0
24;2021-01-24;225;1;45468;145;1.8;0.0
24;2021-01-25;3114;24;48582;169;1.9;0.0
24;2021-01-26;4849;88;53431;257;2.1;0.0
24;2021-01-27;5045;185;58476;442;2.3;0.0
24;2021-01-28;5634;508;64110;950;2.5;0.0
24;2021-01-29;3422;731;67532;1681;2.6;0.1
24;2021-01-30;1207;398;68739;2079;2.7;0.1
24;2021-01-31;251;368;68990;2447;2.7;0.1
24;2021-02-01;2170;928;71160;3375;2.8;0.1
24;2021-02-02;3032;1891;74192;5266;2.9;0.2
24;2021-02-03;3110;1768;77302;7034;3.0;0.3
24;2021-02-04;3234;1618;80536;8652;3.1;0.3
24;2021-02-05;2394;1370;82930;10022;3.2;0.4
24;2021-02-06;707;263;83637;10285;3.3;0.4
24;2021-02-07;134;32;83771;10317;3.3;0.4
24;2021-02-08;1967;1571;85738;11888;3.4;0.5
24;2021-02-09;3412;3320;89150;15208;3.5;0.6
24;2021-02-10;4085;3757;93235;18965;3.6;0.7
24;2021-02-11;4655;4776;97890;23741;3.8;0.9
24;2021-02-12;3481;3272;101371;27013;4.0;1.1
24;2021-02-13;839;770;102210;27783;4.0;1.1
24;2021-02-14;426;256;102636;28039;4.0;1.1
24;2021-02-15;1963;2861;104599;30900;4.1;1.2
24;2021-02-16;2848;4498;107447;35398;4.2;1.4
24;2021-02-17;2691;5107;110138;40505;4.3;1.6
24;2021-02-18;3519;5175;113657;45680;4.4;1.8
24;2021-02-19;3200;3557;116857;49237;4.6;1.9
24;2021-02-20;1288;985;118145;50222;4.6;2.0
24;2021-02-21;433;239;118578;50461;4.6;2.0
24;2021-02-22;1650;3061;120228;53522;4.7;2.1
24;2021-02-23;2340;3139;122568;56661;4.8;2.2
24;2021-02-24;2093;3466;124661;60127;4.9;2.3
24;2021-02-25;3620;3167;128281;63294;5.0;2.5
24;2021-02-26;4466;2622;132747;65916;5.2;2.6
24;2021-02-27;1877;995;134624;66911;5.3;2.6
24;2021-02-28;97;219;134721;67130;5.3;2.6
24;2021-03-01;2172;2024;136893;69154;5.3;2.7
24;2021-03-02;3430;2893;140323;72047;5.5;2.8
24;2021-03-03;3550;3411;143873;75458;5.6;2.9
24;2021-03-04;5336;3721;149209;79179;5.8;3.1
24;2021-03-05;7037;3177;156246;82356;6.1;3.2
24;2021-03-06;7375;751;163621;83107;6.4;3.2
24;2021-03-07;2429;289;166050;83396;6.5;3.3
24;2021-03-08;2689;2624;168739;86020;6.6;3.4
24;2021-03-09;5778;2849;174517;88869;6.8;3.5
24;2021-03-10;6407;3528;180924;92397;7.1;3.6
24;2021-03-11;7802;3515;188726;95912;7.4;3.7
24;2021-03-12;10787;2696;199513;98608;7.8;3.9
24;2021-03-13;7118;723;206631;99331;8.1;3.9
24;2021-03-14;1549;270;208180;99601;8.1;3.9
24;2021-03-15;4559;1976;212739;101577;8.3;4.0
24;2021-03-16;4595;2370;217334;103947;8.5;4.1
24;2021-03-17;4462;1987;221796;105934;8.7;4.1
24;2021-03-18;5063;2093;226859;108027;8.9;4.2
24;2021-03-19;7776;1684;234635;109711;9.2;4.3
24;2021-03-20;4432;884;239067;110595;9.3;4.3
24;2021-03-21;557;349;239624;110944;9.4;4.3
24;2021-03-22;4860;1719;244484;112663;9.6;4.4
24;2021-03-23;8037;2299;252521;114962;9.9;4.5
24;2021-03-24;8815;2014;261336;116976;10.2;4.6
24;2021-03-25;12139;1966;273475;118942;10.7;4.6
24;2021-03-26;13273;1995;286748;120937;11.2;4.7
24;2021-03-27;5778;679;292526;121616;11.4;4.8
24;2021-03-28;520;97;293046;121713;11.5;4.8
24;2021-03-29;6760;1879;299806;123592;11.7;4.8
24;2021-03-30;10173;2801;309979;126393;12.1;4.9
24;2021-03-31;9890;2351;319869;128744;12.5;5.0
24;2021-04-01;12041;3400;331910;132144;13.0;5.2
24;2021-04-02;10623;3346;342533;135490;13.4;5.3
24;2021-04-03;3412;1717;345945;137207;13.5;5.4
24;2021-04-04;394;344;346339;137551;13.5;5.4
24;2021-04-05;397;51;346736;137602;13.5;5.4
24;2021-04-06;8315;3424;355051;141026;13.9;5.5
24;2021-04-07;11063;4555;366114;145581;14.3;5.7
24;2021-04-08;14180;4756;380294;150337;14.9;5.9
24;2021-04-09;17748;3726;398042;154063;15.6;6.0
24;2021-04-10;9383;2084;407425;156147;15.9;6.1
24;2021-04-11;2909;1248;410334;157395;16.0;6.2
24;2021-04-12;10842;3449;421176;160844;16.5;6.3
24;2021-04-13;14990;4826;436166;165670;17.0;6.5
24;2021-04-14;13459;4932;449625;170602;17.6;6.7
24;2021-04-15;15336;5132;464961;175734;18.2;6.9
24;2021-04-16;15670;4343;480631;180077;18.8;7.0
24;2021-04-17;8192;1323;488823;181400;19.1;7.1
24;2021-04-18;1100;286;489923;181686;19.1;7.1
24;2021-04-19;9440;4143;499363;185829;19.5;7.3
24;2021-04-20;12721;5979;512084;191808;20.0;7.5
24;2021-04-21;12326;6004;524410;197812;20.5;7.7
24;2021-04-22;13862;7543;538272;205355;21.0;8.0
24;2021-04-23;13694;7047;551966;212402;21.6;8.3
24;2021-04-24;10238;3256;562204;215658;22.0;8.4
24;2021-04-25;3048;433;565252;216091;22.1;8.4
24;2021-04-26;10203;5429;575455;221520;22.5;8.7
24;2021-04-27;13875;7757;589330;229277;23.0;9.0
24;2021-04-28;13017;8456;602347;237733;23.5;9.3
24;2021-04-29;16580;8591;618927;246324;24.2;9.6
24;2021-04-30;17469;7241;636396;253565;24.9;9.9
24;2021-05-01;2911;671;639307;254236;25.0;9.9
24;2021-05-02;2140;320;641447;254556;25.1;9.9
24;2021-05-03;11285;6116;652732;260672;25.5;10.2
24;2021-05-04;12804;10297;665536;270969;26.0;10.6
24;2021-05-05;13874;9581;679410;280550;26.5;11.0
24;2021-05-06;17476;9673;696886;290223;27.2;11.3
24;2021-05-07;14537;11988;711423;302211;27.8;11.8
24;2021-05-08;3706;2376;715129;304587;27.9;11.9
24;2021-05-09;2326;3731;717455;308318;28.0;12.0
24;2021-05-10;11511;12199;728966;320517;28.5;12.5
24;2021-05-11;16356;14204;745322;334721;29.1;13.1
24;2021-05-12;18219;13155;763541;347876;29.8;13.6
24;2021-05-13;6923;3169;770464;351045;30.1;13.7
24;2021-05-14;14509;9181;784973;360226;30.7;14.1
24;2021-05-15;10468;5054;795441;365280;31.1;14.3
24;2021-05-16;3167;1188;798608;366468;31.2;14.3
24;2021-05-17;13319;7667;811927;374135;31.7;14.6
24;2021-05-18;18406;8215;830333;382350;32.4;14.9
24;2021-05-19;19015;7502;849348;389852;33.2;15.2
24;2021-05-20;21306;8430;870654;398282;34.0;15.6
24;2021-05-21;18373;9090;889027;407372;34.7;15.9
24;2021-05-22;7621;4191;896648;411563;35.0;16.1
24;2021-05-23;2981;942;899629;412505;35.2;16.1
24;2021-05-24;8333;1594;907962;414099;35.5;16.2
24;2021-05-25;17731;8857;925693;422956;36.2;16.5
24;2021-05-26;19246;8298;944939;431254;36.9;16.9
24;2021-05-27;20875;10038;965814;441292;37.7;17.2
24;2021-05-28;20443;12263;986257;453555;38.5;17.7
24;2021-05-29;12414;5903;998671;459458;39.0;18.0
24;2021-05-30;2032;1485;1000703;460943;39.1;18.0
24;2021-05-31;14577;8906;1015280;469849;39.7;18.4
24;2021-06-01;19676;12023;1034956;481872;40.4;18.8
24;2021-06-02;17743;10797;1052699;492669;41.1;19.3
24;2021-06-03;20858;11910;1073557;504579;42.0;19.7
24;2021-06-04;19923;13853;1093480;518432;42.7;20.3
24;2021-06-05;9863;8854;1103343;527286;43.1;20.6
24;2021-06-06;1992;3020;1105335;530306;43.2;20.7
24;2021-06-07;14413;12016;1119748;542322;43.8;21.2
24;2021-06-08;16056;14953;1135804;557275;44.4;21.8
24;2021-06-09;16452;12766;1152256;570041;45.0;22.3
24;2021-06-10;17862;12112;1170118;582153;45.7;22.7
24;2021-06-11;17156;15305;1187274;597458;46.4;23.3
24;2021-06-12;10069;7334;1197343;604792;46.8;23.6
24;2021-06-13;892;1313;1198235;606105;46.8;23.7
24;2021-06-14;10446;15264;1208681;621369;47.2;24.3
24;2021-06-15;12965;17118;1221646;638487;47.7;24.9
24;2021-06-16;13437;16273;1235083;654760;48.3;25.6
24;2021-06-17;13107;17309;1248190;672069;48.8;26.3
24;2021-06-18;14524;19824;1262714;691893;49.3;27.0
24;2021-06-19;7921;6653;1270635;698546;49.7;27.3
24;2021-06-20;554;858;1271189;699404;49.7;27.3
24;2021-06-21;8833;16479;1280022;715883;50.0;28.0
24;2021-06-22;10198;19410;1290220;735293;50.4;28.7
24;2021-06-23;9692;17855;1299912;753148;50.8;29.4
24;2021-06-24;8977;12867;1308889;766015;51.1;29.9
24;2021-06-25;10616;19866;1319505;785881;51.6;30.7
24;2021-06-26;5277;10963;1324782;796844;51.8;31.1
24;2021-06-27;795;2214;1325577;799058;51.8;31.2
24;2021-06-28;6464;18522;1332041;817580;52.1;31.9
27;2020-12-27;4;0;4;0;0.0;0.0
27;2020-12-28;0;0;4;0;0.0;0.0
27;2020-12-29;19;0;23;0;0.0;0.0
27;2020-12-30;20;0;43;0;0.0;0.0
27;2020-12-31;2;0;45;0;0.0;0.0
27;2021-01-01;0;0;45;0;0.0;0.0
27;2021-01-02;1;0;46;0;0.0;0.0
27;2021-01-03;1;0;47;0;0.0;0.0
27;2021-01-04;27;0;74;0;0.0;0.0
27;2021-01-05;263;2;337;2;0.0;0.0
27;2021-01-06;718;1;1055;3;0.0;0.0
27;2021-01-07;1581;3;2636;6;0.1;0.0
27;2021-01-08;1896;4;4532;10;0.2;0.0
27;2021-01-09;689;0;5221;10;0.2;0.0
27;2021-01-10;3;0;5224;10;0.2;0.0
27;2021-01-11;2420;4;7644;14;0.3;0.0
27;2021-01-12;3823;4;11467;18;0.4;0.0
27;2021-01-13;3848;8;15315;26;0.6;0.0
27;2021-01-14;4752;48;20067;74;0.7;0.0
27;2021-01-15;3593;22;23660;96;0.9;0.0
27;2021-01-16;793;11;24453;107;0.9;0.0
27;2021-01-17;116;1;24569;108;0.9;0.0
27;2021-01-18;6251;20;30820;128;1.1;0.0
27;2021-01-19;8398;23;39218;151;1.4;0.0
27;2021-01-20;7906;59;47124;210;1.7;0.0
27;2021-01-21;9455;23;56579;233;2.0;0.0
27;2021-01-22;7707;17;64286;250;2.3;0.0
27;2021-01-23;2986;6;67272;256;2.4;0.0
27;2021-01-24;347;0;67619;256;2.4;0.0
27;2021-01-25;5220;30;72839;286;2.6;0.0
27;2021-01-26;7390;230;80229;516;2.9;0.0
27;2021-01-27;7096;355;87325;871;3.1;0.0
27;2021-01-28;6335;896;93660;1767;3.4;0.1
27;2021-01-29;5930;1267;99590;3034;3.6;0.1
27;2021-01-30;2496;347;102086;3381;3.7;0.1
27;2021-01-31;252;22;102338;3403;3.7;0.1
27;2021-02-01;3359;1403;105697;4806;3.8;0.2
27;2021-02-02;4040;2225;109737;7031;3.9;0.3
27;2021-02-03;3618;2397;113355;9428;4.1;0.3
27;2021-02-04;3703;3153;117058;12581;4.2;0.5
27;2021-02-05;3240;2588;120298;15169;4.3;0.5
27;2021-02-06;1608;672;121906;15841;4.4;0.6
27;2021-02-07;5;87;121911;15928;4.4;0.6
27;2021-02-08;2911;2686;124822;18614;4.5;0.7
27;2021-02-09;3015;3662;127837;22276;4.6;0.8
27;2021-02-10;3054;3413;130891;25689;4.7;0.9
27;2021-02-11;3316;4654;134207;30343;4.8;1.1
27;2021-02-12;2726;4464;136933;34807;4.9;1.3
27;2021-02-13;986;1467;137919;36274;5.0;1.3
27;2021-02-14;258;301;138177;36575;5.0;1.3
27;2021-02-15;1239;5759;139416;42334;5.0;1.5
27;2021-02-16;1507;7440;140923;49774;5.1;1.8
27;2021-02-17;1807;6918;142730;56692;5.1;2.0
27;2021-02-18;2147;6472;144877;63164;5.2;2.3
27;2021-02-19;1736;5673;146613;68837;5.3;2.5
27;2021-02-20;712;2180;147325;71017;5.3;2.6
27;2021-02-21;2;280;147327;71297;5.3;2.6
27;2021-02-22;978;4902;148305;76199;5.3;2.7
27;2021-02-23;1203;5449;149508;81648;5.4;2.9
27;2021-02-24;1508;4871;151016;86519;5.4;3.1
27;2021-02-25;2921;5066;153937;91585;5.5;3.3
27;2021-02-26;3684;4221;157621;95806;5.7;3.4
27;2021-02-27;1911;1959;159532;97765;5.7;3.5
27;2021-02-28;107;282;159639;98047;5.7;3.5
27;2021-03-01;3672;3514;163311;101561;5.9;3.6
27;2021-03-02;5410;4344;168721;105905;6.1;3.8
27;2021-03-03;5962;3576;174683;109481;6.3;3.9
27;2021-03-04;7708;3576;182391;113057;6.6;4.1
27;2021-03-05;9700;3204;192091;116261;6.9;4.2
27;2021-03-06;6228;1087;198319;117348;7.1;4.2
27;2021-03-07;872;187;199191;117535;7.2;4.2
27;2021-03-08;4542;3427;203733;120962;7.3;4.3
27;2021-03-09;8421;3406;212154;124368;7.6;4.5
27;2021-03-10;8720;2817;220874;127185;7.9;4.6
27;2021-03-11;10267;3212;231141;130397;8.3;4.7
27;2021-03-12;11893;2475;243034;132872;8.7;4.8
27;2021-03-13;7049;700;250083;133572;9.0;4.8
27;2021-03-14;213;60;250296;133632;9.0;4.8
27;2021-03-15;7321;1386;257617;135018;9.3;4.9
27;2021-03-16;8247;1091;265864;136109;9.6;4.9
27;2021-03-17;8536;1183;274400;137292;9.9;4.9
27;2021-03-18;8626;1420;283026;138712;10.2;5.0
27;2021-03-19;9443;1099;292469;139811;10.5;5.0
27;2021-03-20;5670;399;298139;140210;10.7;5.0
27;2021-03-21;238;11;298377;140221;10.7;5.0
27;2021-03-22;9335;964;307712;141185;11.1;5.1
27;2021-03-23;14721;1201;322433;142386;11.6;5.1
27;2021-03-24;15188;1254;337621;143640;12.1;5.2
27;2021-03-25;18383;1469;356004;145109;12.8;5.2
27;2021-03-26;18392;1271;374396;146380;13.5;5.3
27;2021-03-27;7684;413;382080;146793;13.7;5.3
27;2021-03-28;492;124;382572;146917;13.7;5.3
27;2021-03-29;10031;3406;392603;150323;14.1;5.4
27;2021-03-30;12969;4015;405572;154338;14.6;5.5
27;2021-03-31;12835;4215;418407;158553;15.0;5.7
27;2021-04-01;14551;4152;432958;162705;15.6;5.8
27;2021-04-02;12953;4055;445911;166760;16.0;6.0
27;2021-04-03;4478;1138;450389;167898;16.2;6.0
27;2021-04-04;69;35;450458;167933;16.2;6.0
27;2021-04-05;345;7;450803;167940;16.2;6.0
27;2021-04-06;9561;6186;460364;174126;16.5;6.3
27;2021-04-07;10193;6470;470557;180596;16.9;6.5
27;2021-04-08;15727;6158;486284;186754;17.5;6.7
27;2021-04-09;17837;6010;504121;192764;18.1;6.9
27;2021-04-10;6068;1952;510189;194716;18.3;7.0
27;2021-04-11;420;83;510609;194799;18.3;7.0
27;2021-04-12;9063;6803;519672;201602;18.7;7.2
27;2021-04-13;11742;8513;531414;210115;19.1;7.5
27;2021-04-14;10289;7840;541703;217955;19.5;7.8
27;2021-04-15;12958;7682;554661;225637;19.9;8.1
27;2021-04-16;12753;6450;567414;232087;20.4;8.3
27;2021-04-17;5920;3037;573334;235124;20.6;8.4
27;2021-04-18;354;189;573688;235313;20.6;8.5
27;2021-04-19;6969;8860;580657;244173;20.9;8.8
27;2021-04-20;8476;10537;589133;254710;21.2;9.2
27;2021-04-21;8339;10146;597472;264856;21.5;9.5
27;2021-04-22;9854;11533;607326;276389;21.8;9.9
27;2021-04-23;11333;10300;618659;286689;22.2;10.3
27;2021-04-24;5167;3959;623826;290648;22.4;10.4
27;2021-04-25;440;295;624266;290943;22.4;10.5
27;2021-04-26;9539;8755;633805;299698;22.8;10.8
27;2021-04-27;13457;10250;647262;309948;23.3;11.1
27;2021-04-28;14192;10358;661454;320306;23.8;11.5
27;2021-04-29;17872;11524;679326;331830;24.4;11.9
27;2021-04-30;18721;9489;698047;341319;25.1;12.3
27;2021-05-01;5426;1544;703473;342863;25.3;12.3
27;2021-05-02;602;73;704075;342936;25.3;12.3
27;2021-05-03;14902;6323;718977;349259;25.8;12.5
27;2021-05-04;13941;10792;732918;360051;26.3;12.9
27;2021-05-05;15555;10017;748473;370068;26.9;13.3
27;2021-05-06;18271;12329;766744;382397;27.6;13.7
27;2021-05-07;17216;11752;783960;394149;28.2;14.2
27;2021-05-08;5947;1507;789907;395656;28.4;14.2
27;2021-05-09;533;439;790440;396095;28.4;14.2
27;2021-05-10;15275;9876;805715;405971;29.0;14.6
27;2021-05-11;20747;12888;826462;418859;29.7;15.1
27;2021-05-12;19658;11744;846120;430603;30.4;15.5
27;2021-05-13;12292;2036;858412;432639;30.8;15.5
27;2021-05-14;22925;8387;881337;441026;31.7;15.8
27;2021-05-15;15412;3399;896749;444425;32.2;16.0
27;2021-05-16;1890;235;898639;444660;32.3;16.0
27;2021-05-17;18961;6793;917600;451453;33.0;16.2
27;2021-05-18;20609;9289;938209;460742;33.7;16.6
27;2021-05-19;22228;7292;960437;468034;34.5;16.8
27;2021-05-20;23187;8198;983624;476232;35.3;17.1
27;2021-05-21;21074;10037;1004698;486269;36.1;17.5
27;2021-05-22;8261;3599;1012959;489868;36.4;17.6
27;2021-05-23;903;305;1013862;490173;36.4;17.6
27;2021-05-24;4227;1083;1018089;491256;36.6;17.7
27;2021-05-25;14854;11619;1032943;502875;37.1;18.1
27;2021-05-26;15353;10637;1048296;513512;37.7;18.5
27;2021-05-27;18379;11803;1066675;525315;38.3;18.9
27;2021-05-28;16069;14119;1082744;539434;38.9;19.4
27;2021-05-29;6810;5154;1089554;544588;39.1;19.6
27;2021-05-30;391;255;1089945;544843;39.2;19.6
27;2021-05-31;13305;10929;1103250;555772;39.6;20.0
27;2021-06-01;16507;13431;1119757;569203;40.2;20.5
27;2021-06-02;16149;11443;1135906;580646;40.8;20.9
27;2021-06-03;17728;11858;1153634;592504;41.5;21.3
27;2021-06-04;16159;14614;1169793;607118;42.0;21.8
27;2021-06-05;8339;6758;1178132;613876;42.3;22.1
27;2021-06-06;1716;645;1179848;614521;42.4;22.1
27;2021-06-07;17426;13087;1197274;627608;43.0;22.6
27;2021-06-08;19644;15322;1216918;642930;43.7;23.1
27;2021-06-09;19033;12487;1235951;655417;44.4;23.6
27;2021-06-10;18985;13892;1254936;669309;45.1;24.0
27;2021-06-11;18098;17080;1273034;686389;45.7;24.7
27;2021-06-12;9468;7841;1282502;694230;46.1;24.9
27;2021-06-13;942;947;1283444;695177;46.1;25.0
27;2021-06-14;11052;17038;1294496;712215;46.5;25.6
27;2021-06-15;14127;17620;1308623;729835;47.0;26.2
27;2021-06-16;14675;15599;1323298;745434;47.5;26.8
27;2021-06-17;15148;17241;1338446;762675;48.1;27.4
27;2021-06-18;14766;20171;1353212;782846;48.6;28.1
27;2021-06-19;7652;8652;1360864;791498;48.9;28.4
27;2021-06-20;170;457;1361034;791955;48.9;28.5
27;2021-06-21;7753;19018;1368787;810973;49.2;29.1
27;2021-06-22;9552;24245;1378339;835218;49.5;30.0
27;2021-06-23;11241;19286;1389580;854504;49.9;30.7
27;2021-06-24;10453;17953;1400033;872457;50.3;31.3
27;2021-06-25;9316;26975;1409349;899432;50.6;32.3
27;2021-06-26;5062;15788;1414411;915220;50.8;32.9
27;2021-06-27;664;1883;1415075;917103;50.8;33.0
27;2021-06-28;6198;21936;1421273;939039;51.1;33.7
28;2020-12-27;0;0;0;0;0.0;0.0
28;2020-12-28;1;0;1;0;0.0;0.0
28;2020-12-29;2;0;3;0;0.0;0.0
28;2020-12-30;0;0;3;0;0.0;0.0
28;2020-12-31;1;0;4;0;0.0;0.0
28;2021-01-01;2;0;6;0;0.0;0.0
28;2021-01-02;1;0;7;0;0.0;0.0
28;2021-01-03;1;0;8;0;0.0;0.0
28;2021-01-04;16;0;24;0;0.0;0.0
28;2021-01-05;169;0;193;0;0.0;0.0
28;2021-01-06;1393;2;1586;2;0.0;0.0
28;2021-01-07;2599;9;4185;11;0.1;0.0
28;2021-01-08;3428;3;7613;14;0.2;0.0
28;2021-01-09;1331;3;8944;17;0.3;0.0
28;2021-01-10;705;1;9649;18;0.3;0.0
28;2021-01-11;3179;4;12828;22;0.4;0.0
28;2021-01-12;3978;3;16806;25;0.5;0.0
28;2021-01-13;4302;7;21108;32;0.6;0.0
28;2021-01-14;8097;73;29205;105;0.9;0.0
28;2021-01-15;6219;25;35424;130;1.1;0.0
28;2021-01-16;2086;9;37510;139;1.1;0.0
28;2021-01-17;4071;24;41581;163;1.3;0.0
28;2021-01-18;8784;17;50365;180;1.5;0.0
28;2021-01-19;7142;13;57507;193;1.7;0.0
28;2021-01-20;6507;11;64014;204;1.9;0.0
28;2021-01-21;5993;9;70007;213;2.1;0.0
28;2021-01-22;5440;12;75447;225;2.3;0.0
28;2021-01-23;2020;8;77467;233;2.3;0.0
28;2021-01-24;1447;11;78914;244;2.4;0.0
28;2021-01-25;6239;179;85153;423;2.6;0.0
28;2021-01-26;4575;394;89728;817;2.7;0.0
28;2021-01-27;4034;765;93762;1582;2.8;0.0
28;2021-01-28;3755;1049;97517;2631;3.0;0.1
28;2021-01-29;3488;1306;101005;3937;3.1;0.1
28;2021-01-30;1386;517;102391;4454;3.1;0.1
28;2021-01-31;195;126;102586;4580;3.1;0.1
28;2021-02-01;2781;1661;105367;6241;3.2;0.2
28;2021-02-02;2985;2392;108352;8633;3.3;0.3
28;2021-02-03;2948;2671;111300;11304;3.4;0.3
28;2021-02-04;3726;5209;115026;16513;3.5;0.5
28;2021-02-05;3885;4393;118911;20906;3.6;0.6
28;2021-02-06;1140;1549;120051;22455;3.6;0.7
28;2021-02-07;715;1975;120766;24430;3.7;0.7
28;2021-02-08;3800;6863;124566;31293;3.8;0.9
28;2021-02-09;3459;6034;128025;37327;3.9;1.1
28;2021-02-10;3455;5078;131480;42405;4.0;1.3
28;2021-02-11;4209;4900;135689;47305;4.1;1.4
28;2021-02-12;4043;4619;139732;51924;4.2;1.6
28;2021-02-13;1124;1585;140856;53509;4.3;1.6
28;2021-02-14;285;1388;141141;54897;4.3;1.7
28;2021-02-15;2213;6288;143354;61185;4.3;1.9
28;2021-02-16;2654;5670;146008;66855;4.4;2.0
28;2021-02-17;1951;4557;147959;71412;4.5;2.2
28;2021-02-18;2569;4314;150528;75726;4.6;2.3
28;2021-02-19;2547;3725;153075;79451;4.6;2.4
28;2021-02-20;945;1260;154020;80711;4.7;2.4
28;2021-02-21;103;416;154123;81127;4.7;2.5
28;2021-02-22;1669;4234;155792;85361;4.7;2.6
28;2021-02-23;2173;3842;157965;89203;4.8;2.7
28;2021-02-24;2372;3899;160337;93102;4.9;2.8
28;2021-02-25;4772;4202;165109;97304;5.0;2.9
28;2021-02-26;5959;3746;171068;101050;5.2;3.1
28;2021-02-27;3008;1032;174076;102082;5.3;3.1
28;2021-02-28;340;387;174416;102469;5.3;3.1
28;2021-03-01;2524;4664;176940;107133;5.4;3.2
28;2021-03-02;3900;4106;180840;111239;5.5;3.4
28;2021-03-03;4789;3489;185629;114728;5.6;3.5
28;2021-03-04;7304;2865;192933;117593;5.8;3.6
28;2021-03-05;10145;2504;203078;120097;6.1;3.6
28;2021-03-06;9807;796;212885;120893;6.4;3.7
28;2021-03-07;3771;127;216656;121020;6.6;3.7
28;2021-03-08;5865;3278;222521;124298;6.7;3.8
28;2021-03-09;9284;2825;231805;127123;7.0;3.8
28;2021-03-10;9804;2444;241609;129567;7.3;3.9
28;2021-03-11;13960;2021;255569;131588;7.7;4.0
28;2021-03-12;17984;1556;273553;133144;8.3;4.0
28;2021-03-13;11148;528;284701;133672;8.6;4.0
28;2021-03-14;2259;99;286960;133771;8.7;4.0
28;2021-03-15;8644;870;295604;134641;8.9;4.1
28;2021-03-16;7488;1189;303092;135830;9.2;4.1
28;2021-03-17;7718;1190;310810;137020;9.4;4.1
28;2021-03-18;8164;1372;318974;138392;9.7;4.2
28;2021-03-19;11565;1461;330539;139853;10.0;4.2
28;2021-03-20;9667;539;340206;140392;10.3;4.2
28;2021-03-21;2409;22;342615;140414;10.4;4.3
28;2021-03-22;9385;1638;352000;142052;10.7;4.3
28;2021-03-23;12483;1514;364483;143566;11.0;4.3
28;2021-03-24;13252;1598;377735;145164;11.4;4.4
28;2021-03-25;17617;1816;395352;146980;12.0;4.4
28;2021-03-26;20826;1881;416178;148861;12.6;4.5
28;2021-03-27;11496;1127;427674;149988;12.9;4.5
28;2021-03-28;2966;92;430640;150080;13.0;4.5
28;2021-03-29;11765;2960;442405;153040;13.4;4.6
28;2021-03-30;14419;3075;456824;156115;13.8;4.7
28;2021-03-31;14391;3566;471215;159681;14.3;4.8
28;2021-04-01;18031;5552;489246;165233;14.8;5.0
28;2021-04-02;16808;6388;506054;171621;15.3;5.2
28;2021-04-03;6999;3965;513053;175586;15.5;5.3
28;2021-04-04;1776;802;514829;176388;15.6;5.3
28;2021-04-05;3288;738;518117;177126;15.7;5.4
28;2021-04-06;10808;7383;528925;184509;16.0;5.6
28;2021-04-07;12693;6958;541618;191467;16.4;5.8
28;2021-04-08;17661;7554;559279;199021;16.9;6.0
28;2021-04-09;23807;7844;583086;206865;17.7;6.3
28;2021-04-10;13828;4124;596914;210989;18.1;6.4
28;2021-04-11;3028;1194;599942;212183;18.2;6.4
28;2021-04-12;13771;8037;613713;220220;18.6;6.7
28;2021-04-13;16175;8053;629888;228273;19.1;6.9
28;2021-04-14;14310;8034;644198;236307;19.5;7.2
28;2021-04-15;17216;8405;661414;244712;20.0;7.4
28;2021-04-16;20266;7842;681680;252554;20.6;7.6
28;2021-04-17;12746;5032;694426;257586;21.0;7.8
28;2021-04-18;2287;1242;696713;258828;21.1;7.8
28;2021-04-19;10866;8873;707579;267701;21.4;8.1
28;2021-04-20;13901;9775;721480;277476;21.8;8.4
28;2021-04-21;13281;10001;734761;287477;22.2;8.7
28;2021-04-22;15287;11908;750048;299385;22.7;9.1
28;2021-04-23;16423;12326;766471;311711;23.2;9.4
28;2021-04-24;12581;7269;779052;318980;23.6;9.7
28;2021-04-25;3293;1917;782345;320897;23.7;9.7
28;2021-04-26;12535;10191;794880;331088;24.1;10.0
28;2021-04-27;14856;11742;809736;342830;24.5;10.4
28;2021-04-28;15042;10710;824778;353540;25.0;10.7
28;2021-04-29;18450;11775;843228;365315;25.5;11.1
28;2021-04-30;20369;11899;863597;377214;26.1;11.4
28;2021-05-01;12805;2973;876402;380187;26.5;11.5
28;2021-05-02;5986;1838;882388;382025;26.7;11.6
28;2021-05-03;12852;10005;895240;392030;27.1;11.9
28;2021-05-04;13810;13136;909050;405166;27.5;12.3
28;2021-05-05;13943;14470;922993;419636;27.9;12.7
28;2021-05-06;18302;15097;941295;434733;28.5;13.2
28;2021-05-07;17828;17379;959123;452112;29.0;13.7
28;2021-05-08;12622;4699;971745;456811;29.4;13.8
28;2021-05-09;7146;1825;978891;458636;29.6;13.9
28;2021-05-10;14199;14800;993090;473436;30.1;14.3
28;2021-05-11;18106;15341;1011196;488777;30.6;14.8
28;2021-05-12;18784;13974;1029980;502751;31.2;15.2
28;2021-05-13;19676;3735;1049656;506486;31.8;15.3
28;2021-05-14;26349;12524;1076005;519010;32.6;15.7
28;2021-05-15;26930;7108;1102935;526118;33.4;15.9
28;2021-05-16;14143;1578;1117078;527696;33.8;16.0
28;2021-05-17;16208;9443;1133286;537139;34.3;16.3
28;2021-05-18;21029;8762;1154315;545901;34.9;16.5
28;2021-05-19;20873;8483;1175188;554384;35.6;16.8
28;2021-05-20;23093;9661;1198281;564045;36.3;17.1
28;2021-05-21;21417;12071;1219698;576116;36.9;17.4
28;2021-05-22;17560;5984;1237258;582100;37.5;17.6
28;2021-05-23;9112;934;1246370;583034;37.7;17.6
28;2021-05-24;13396;3169;1259766;586203;38.1;17.7
28;2021-05-25;19129;11590;1278895;597793;38.7;18.1
28;2021-05-26;19255;10009;1298150;607802;39.3;18.4
28;2021-05-27;21699;12372;1319849;620174;40.0;18.8
28;2021-05-28;21592;16511;1341441;636685;40.6;19.3
28;2021-05-29;17546;10163;1358987;646848;41.1;19.6
28;2021-05-30;6266;1271;1365253;648119;41.3;19.6
28;2021-05-31;19855;11933;1385108;660052;41.9;20.0
28;2021-06-01;23696;13850;1408804;673902;42.6;20.4
28;2021-06-02;20795;12322;1429599;686224;43.3;20.8
28;2021-06-03;26450;14656;1456049;700880;44.1;21.2
28;2021-06-04;24562;18927;1480611;719807;44.8;21.8
28;2021-06-05;18351;12078;1498962;731885;45.4;22.2
28;2021-06-06;7663;2407;1506625;734292;45.6;22.2
28;2021-06-07;19213;14163;1525838;748455;46.2;22.7
28;2021-06-08;22611;15539;1548449;763994;46.9;23.1
28;2021-06-09;19729;14682;1568178;778676;47.5;23.6
28;2021-06-10;21189;14775;1589367;793451;48.1;24.0
28;2021-06-11;21010;21129;1610377;814580;48.7;24.7
28;2021-06-12;17910;17128;1628287;831708;49.3;25.2
28;2021-06-13;6337;5886;1634624;837594;49.5;25.4
28;2021-06-14;13879;17721;1648503;855315;49.9;25.9
28;2021-06-15;16204;18714;1664707;874029;50.4;26.5
28;2021-06-16;16666;18565;1681373;892594;50.9;27.0
28;2021-06-17;17227;20493;1698600;913087;51.4;27.6
28;2021-06-18;18492;24411;1717092;937498;52.0;28.4
28;2021-06-19;14788;15795;1731880;953293;52.4;28.9
28;2021-06-20;4980;5126;1736860;958419;52.6;29.0
28;2021-06-21;11321;20737;1748181;979156;52.9;29.6
28;2021-06-22;12726;23853;1760907;1003009;53.3;30.4
28;2021-06-23;11873;23574;1772780;1026583;53.7;31.1
28;2021-06-24;12609;24452;1785389;1051035;54.0;31.8
28;2021-06-25;12351;29404;1797740;1080439;54.4;32.7
28;2021-06-26;9185;23397;1806925;1103836;54.7;33.4
28;2021-06-27;2901;10103;1809826;1113939;54.8;33.7
28;2021-06-28;8045;22859;1817871;1136798;55.0;34.4
32;2020-12-27;1;0;1;0;0.0;0.0
32;2020-12-28;26;0;27;0;0.0;0.0
32;2020-12-29;12;0;39;0;0.0;0.0
32;2020-12-30;0;0;39;0;0.0;0.0
32;2020-12-31;0;0;39;0;0.0;0.0
32;2021-01-01;1;0;40;0;0.0;0.0
32;2021-01-02;6;0;46;0;0.0;0.0
32;2021-01-03;4;0;50;0;0.0;0.0
32;2021-01-04;82;0;132;0;0.0;0.0
32;2021-01-05;300;0;432;0;0.0;0.0
32;2021-01-06;787;2;1219;2;0.0;0.0
32;2021-01-07;2431;4;3650;6;0.1;0.0
32;2021-01-08;3165;9;6815;15;0.1;0.0
32;2021-01-09;957;3;7772;18;0.1;0.0
32;2021-01-10;640;0;8412;18;0.1;0.0
32;2021-01-11;3269;6;11681;24;0.2;0.0
32;2021-01-12;5018;7;16699;31;0.3;0.0
32;2021-01-13;4942;11;21641;42;0.4;0.0
32;2021-01-14;5724;44;27365;86;0.5;0.0
32;2021-01-15;5224;28;32589;114;0.5;0.0
32;2021-01-16;1636;12;34225;126;0.6;0.0
32;2021-01-17;860;3;35085;129;0.6;0.0
32;2021-01-18;7233;21;42318;150;0.7;0.0
32;2021-01-19;9899;37;52217;187;0.9;0.0
32;2021-01-20;10354;30;62571;217;1.0;0.0
32;2021-01-21;12706;46;75277;263;1.3;0.0
32;2021-01-22;9878;28;85155;291;1.4;0.0
32;2021-01-23;3411;4;88566;295;1.5;0.0
32;2021-01-24;1119;3;89685;298;1.5;0.0
32;2021-01-25;6865;85;96550;383;1.6;0.0
32;2021-01-26;7447;183;103997;566;1.7;0.0
32;2021-01-27;4837;512;108834;1078;1.8;0.0
32;2021-01-28;8597;1692;117431;2770;2.0;0.0
32;2021-01-29;5383;1861;122814;4631;2.1;0.1
32;2021-01-30;534;413;123348;5044;2.1;0.1
32;2021-01-31;67;74;123415;5118;2.1;0.1
32;2021-02-01;191;1816;123606;6934;2.1;0.1
32;2021-02-02;786;3170;124392;10104;2.1;0.2
32;2021-02-03;4074;3190;128466;13294;2.2;0.2
32;2021-02-04;3684;3622;132150;16916;2.2;0.3
32;2021-02-05;1962;3279;134112;20195;2.2;0.3
32;2021-02-06;517;875;134629;21070;2.3;0.4
32;2021-02-07;539;100;135168;21170;2.3;0.4
32;2021-02-08;1865;3684;137033;24854;2.3;0.4
32;2021-02-09;2550;4370;139583;29224;2.3;0.5
32;2021-02-10;2984;5345;142567;34569;2.4;0.6
32;2021-02-11;4778;6199;147345;40768;2.5;0.7
32;2021-02-12;5092;4674;152437;45442;2.6;0.8
32;2021-02-13;939;1894;153376;47336;2.6;0.8
32;2021-02-14;116;711;153492;48047;2.6;0.8
32;2021-02-15;3613;6934;157105;54981;2.6;0.9
32;2021-02-16;4029;8245;161134;63226;2.7;1.1
32;2021-02-17;4303;8697;165437;71923;2.8;1.2
32;2021-02-18;7039;11447;172476;83370;2.9;1.4
32;2021-02-19;7084;8320;179560;91690;3.0;1.5
32;2021-02-20;2517;3018;182077;94708;3.1;1.6
32;2021-02-21;434;490;182511;95198;3.1;1.6
32;2021-02-22;3260;5337;185771;100535;3.1;1.7
32;2021-02-23;5504;5928;191275;106463;3.2;1.8
32;2021-02-24;7443;6072;198718;112535;3.3;1.9
32;2021-02-25;12832;5044;211550;117579;3.5;2.0
32;2021-02-26;12536;2900;224086;120479;3.8;2.0
32;2021-02-27;6486;320;230572;120799;3.9;2.0
32;2021-02-28;364;134;230936;120933;3.9;2.0
32;2021-03-01;7243;864;238179;121797;4.0;2.0
32;2021-03-02;10959;998;249138;122795;4.2;2.1
32;2021-03-03;11991;1745;261129;124540;4.4;2.1
32;2021-03-04;15097;2459;276226;126999;4.6;2.1
32;2021-03-05;17124;2119;293350;129118;4.9;2.2
32;2021-03-06;28093;1067;321443;130185;5.4;2.2
32;2021-03-07;19862;498;341305;130683;5.7;2.2
32;2021-03-08;8916;2574;350221;133257;5.9;2.2
32;2021-03-09;14289;3323;364510;136580;6.1;2.3
32;2021-03-10;15764;3237;380274;139817;6.4;2.3
32;2021-03-11;20923;4741;401197;144558;6.7;2.4
32;2021-03-12;26064;4267;427261;148825;7.2;2.5
32;2021-03-13;41594;2041;468855;150866;7.9;2.5
32;2021-03-14;20100;592;488955;151458;8.2;2.5
32;2021-03-15;13052;3607;502007;155065;8.4;2.6
32;2021-03-16;9791;3484;511798;158549;8.6;2.7
32;2021-03-17;9713;4138;521511;162687;8.7;2.7
32;2021-03-18;10013;5046;531524;167733;8.9;2.8
32;2021-03-19;17942;3826;549466;171559;9.2;2.9
32;2021-03-20;36495;1983;585961;173542;9.8;2.9
32;2021-03-21;19837;791;605798;174333;10.2;2.9
32;2021-03-22;12150;4297;617948;178630;10.4;3.0
32;2021-03-23;18924;5943;636872;184573;10.7;3.1
32;2021-03-24;17909;6163;654781;190736;11.0;3.2
32;2021-03-25;25288;5722;680069;196458;11.4;3.3
32;2021-03-26;28987;5915;709056;202373;11.9;3.4
32;2021-03-27;36665;2172;745721;204545;12.5;3.4
32;2021-03-28;18642;630;764363;205175;12.8;3.4
32;2021-03-29;14578;7045;778941;212220;13.1;3.6
32;2021-03-30;18872;8668;797813;220888;13.4;3.7
32;2021-03-31;15788;9316;813601;230204;13.6;3.9
32;2021-04-01;18212;11050;831813;241254;14.0;4.0
32;2021-04-02;19963;12579;851776;253833;14.3;4.3
32;2021-04-03;30027;10185;881803;264018;14.8;4.4
32;2021-04-04;11655;4736;893458;268754;15.0;4.5
32;2021-04-05;9590;2334;903048;271088;15.1;4.5
32;2021-04-06;14263;10885;917311;281973;15.4;4.7
32;2021-04-07;18074;12573;935385;294546;15.7;4.9
32;2021-04-08;23504;12973;958889;307519;16.1;5.2
32;2021-04-09;29911;13151;988800;320670;16.6;5.4
32;2021-04-10;26125;18813;1014925;339483;17.0;5.7
32;2021-04-11;9137;12014;1024062;351497;17.2;5.9
32;2021-04-12;15384;9512;1039446;361009;17.4;6.1
32;2021-04-13;21781;11581;1061227;372590;17.8;6.2
32;2021-04-14;22467;11129;1083694;383719;18.2;6.4
32;2021-04-15;25708;11140;1109402;394859;18.6;6.6
32;2021-04-16;25289;12451;1134691;407310;19.0;6.8
32;2021-04-17;17958;22995;1152649;430305;19.3;7.2
32;2021-04-18;6389;14046;1159038;444351;19.4;7.5
32;2021-04-19;11651;9810;1170689;454161;19.6;7.6
32;2021-04-20;16402;12285;1187091;466446;19.9;7.8
32;2021-04-21;15781;12569;1202872;479015;20.2;8.0
32;2021-04-22;19026;15005;1221898;494020;20.5;8.3
32;2021-04-23;19640;15968;1241538;509988;20.8;8.6
32;2021-04-24;15448;21027;1256986;531015;21.1;8.9
32;2021-04-25;6960;12291;1263946;543306;21.2;9.1
32;2021-04-26;13206;10729;1277152;554035;21.4;9.3
32;2021-04-27;18685;14110;1295837;568145;21.7;9.5
32;2021-04-28;20188;16051;1316025;584196;22.1;9.8
32;2021-04-29;22394;19937;1338419;604133;22.4;10.1
32;2021-04-30;25002;21571;1363421;625704;22.9;10.5
32;2021-05-01;23027;13939;1386448;639643;23.3;10.7
32;2021-05-02;20942;10341;1407390;649984;23.6;10.9
32;2021-05-03;21931;11297;1429321;661281;24.0;11.1
32;2021-05-04;23833;16278;1453154;677559;24.4;11.4
32;2021-05-05;23932;17416;1477086;694975;24.8;11.7
32;2021-05-06;25718;19879;1502804;714854;25.2;12.0
32;2021-05-07;30731;21501;1533535;736355;25.7;12.3
32;2021-05-08;34574;9067;1568109;745422;26.3;12.5
32;2021-05-09;26798;6506;1594907;751928;26.7;12.6
32;2021-05-10;24210;16130;1619117;768058;27.2;12.9
32;2021-05-11;31301;19034;1650418;787092;27.7;13.2
32;2021-05-12;37272;18820;1687690;805912;28.3;13.5
32;2021-05-13;40524;7345;1728214;813257;29.0;13.6
32;2021-05-14;41775;14620;1769989;827877;29.7;13.9
32;2021-05-15;59639;12196;1829628;840073;30.7;14.1
32;2021-05-16;47869;4880;1877497;844953;31.5;14.2
32;2021-05-17;31451;10963;1908948;855916;32.0;14.4
32;2021-05-18;36663;12476;1945611;868392;32.6;14.6
32;2021-05-19;38767;11553;1984378;879945;33.3;14.8
32;2021-05-20;39709;14908;2024087;894853;33.9;15.0
32;2021-05-21;42296;16970;2066383;911823;34.7;15.3
32;2021-05-22;57712;13069;2124095;924892;35.6;15.5
32;2021-05-23;38889;4390;2162984;929282;36.3;15.6
32;2021-05-24;28440;3830;2191424;933112;36.8;15.6
32;2021-05-25;31061;14881;2222485;947993;37.3;15.9
32;2021-05-26;34006;16766;2256491;964759;37.8;16.2
32;2021-05-27;34616;20675;2291107;985434;38.4;16.5
32;2021-05-28;34275;25160;2325382;1010594;39.0;16.9
32;2021-05-29;37403;19645;2362785;1030239;39.6;17.3
32;2021-05-30;16097;3517;2378882;1033756;39.9;17.3
32;2021-05-31;27888;16532;2406770;1050288;40.4;17.6
32;2021-06-01;32748;24020;2439518;1074308;40.9;18.0
32;2021-06-02;32199;21688;2471717;1095996;41.5;18.4
32;2021-06-03;34279;25070;2505996;1121066;42.0;18.8
32;2021-06-04;35846;27704;2541842;1148770;42.6;19.3
32;2021-06-05;34359;22776;2576201;1171546;43.2;19.6
32;2021-06-06;16514;5721;2592715;1177267;43.5;19.7
32;2021-06-07;21168;19360;2613883;1196627;43.8;20.1
32;2021-06-08;26271;24339;2640154;1220966;44.3;20.5
32;2021-06-09;24354;24387;2664508;1245353;44.7;20.9
32;2021-06-10;24943;26452;2689451;1271805;45.1;21.3
32;2021-06-11;26322;36060;2715773;1307865;45.5;21.9
32;2021-06-12;25962;31517;2741735;1339382;46.0;22.5
32;2021-06-13;11802;14809;2753537;1354191;46.2;22.7
32;2021-06-14;13214;28042;2766751;1382233;46.4;23.2
32;2021-06-15;19588;34594;2786339;1416827;46.7;23.8
32;2021-06-16;20479;32436;2806818;1449263;47.1;24.3
32;2021-06-17;21380;34941;2828198;1484204;47.4;24.9
32;2021-06-18;21536;42584;2849734;1526788;47.8;25.6
32;2021-06-19;22554;43815;2872288;1570603;48.2;26.3
32;2021-06-20;9213;19108;2881501;1589711;48.3;26.7
32;2021-06-21;11353;34845;2892854;1624556;48.5;27.2
32;2021-06-22;13662;41763;2906516;1666319;48.7;27.9
32;2021-06-23;14236;43509;2920752;1709828;49.0;28.7
32;2021-06-24;15300;45735;2936052;1755563;49.2;29.4
32;2021-06-25;14658;53358;2950710;1808921;49.5;30.3
32;2021-06-26;14819;59492;2965529;1868413;49.7;31.3
32;2021-06-27;7453;33857;2972982;1902270;49.9;31.9
32;2021-06-28;10293;38977;2983275;1941247;50.0;32.6
44;2020-12-27;0;0;0;0;0.0;0.0
44;2020-12-28;0;0;0;0;0.0;0.0
44;2020-12-29;0;0;0;0;0.0;0.0
44;2020-12-30;0;0;0;0;0.0;0.0
44;2020-12-31;11;0;11;0;0.0;0.0
44;2021-01-01;1;0;12;0;0.0;0.0
44;2021-01-02;3;0;15;0;0.0;0.0
44;2021-01-03;3;0;18;0;0.0;0.0
44;2021-01-04;243;0;261;0;0.0;0.0
44;2021-01-05;771;0;1032;0;0.0;0.0
44;2021-01-06;1246;3;2278;3;0.0;0.0
44;2021-01-07;2426;4;4704;7;0.1;0.0
44;2021-01-08;3131;9;7835;16;0.1;0.0
44;2021-01-09;943;1;8778;17;0.2;0.0
44;2021-01-10;238;0;9016;17;0.2;0.0
44;2021-01-11;2986;7;12002;24;0.2;0.0
44;2021-01-12;5280;9;17282;33;0.3;0.0
44;2021-01-13;7664;19;24946;52;0.5;0.0
44;2021-01-14;9551;83;34497;135;0.6;0.0
44;2021-01-15;6700;27;41197;162;0.7;0.0
44;2021-01-16;1917;10;43114;172;0.8;0.0
44;2021-01-17;902;1;44016;173;0.8;0.0
44;2021-01-18;8717;26;52733;199;1.0;0.0
44;2021-01-19;10666;17;63399;216;1.2;0.0
44;2021-01-20;11028;46;74427;262;1.4;0.0
44;2021-01-21;11728;27;86155;289;1.6;0.0
44;2021-01-22;9633;30;95788;319;1.7;0.0
44;2021-01-23;3287;20;99075;339;1.8;0.0
44;2021-01-24;1568;5;100643;344;1.8;0.0
44;2021-01-25;6627;304;107270;648;1.9;0.0
44;2021-01-26;5643;435;112913;1083;2.0;0.0
44;2021-01-27;7374;603;120287;1686;2.2;0.0
44;2021-01-28;8829;1252;129116;2938;2.3;0.1
44;2021-01-29;6757;1804;135873;4742;2.5;0.1
44;2021-01-30;2549;496;138422;5238;2.5;0.1
44;2021-01-31;1252;55;139674;5293;2.5;0.1
44;2021-02-01;6384;2382;146058;7675;2.6;0.1
44;2021-02-02;6214;3812;152272;11487;2.8;0.2
44;2021-02-03;5596;4556;157868;16043;2.9;0.3
44;2021-02-04;6441;6970;164309;23013;3.0;0.4
44;2021-02-05;6389;5240;170698;28253;3.1;0.5
44;2021-02-06;1973;1207;172671;29460;3.1;0.5
44;2021-02-07;406;595;173077;30055;3.1;0.5
44;2021-02-08;3822;4471;176899;34526;3.2;0.6
44;2021-02-09;5719;5848;182618;40374;3.3;0.7
44;2021-02-10;6251;6050;188869;46424;3.4;0.8
44;2021-02-11;7060;6574;195929;52998;3.6;1.0
44;2021-02-12;7279;5559;203208;58557;3.7;1.1
44;2021-02-13;2545;1258;205753;59815;3.7;1.1
44;2021-02-14;1612;826;207365;60641;3.8;1.1
44;2021-02-15;3997;7219;211362;67860;3.8;1.2
44;2021-02-16;4564;7987;215926;75847;3.9;1.4
44;2021-02-17;4707;8554;220633;84401;4.0;1.5
44;2021-02-18;6039;9289;226672;93690;4.1;1.7
44;2021-02-19;5544;7517;232216;101207;4.2;1.8
44;2021-02-20;2339;2844;234555;104051;4.3;1.9
44;2021-02-21;541;1401;235096;105452;4.3;1.9
44;2021-02-22;4486;7034;239582;112486;4.3;2.0
44;2021-02-23;6027;7278;245609;119764;4.5;2.2
44;2021-02-24;6603;5950;252212;125714;4.6;2.3
44;2021-02-25;10529;7574;262741;133288;4.8;2.4
44;2021-02-26;12371;6377;275112;139665;5.0;2.5
44;2021-02-27;7888;2167;283000;141832;5.1;2.6
44;2021-02-28;2118;520;285118;142352;5.2;2.6
44;2021-03-01;6079;4676;291197;147028;5.3;2.7
44;2021-03-02;9390;5672;300587;152700;5.5;2.8
44;2021-03-03;11269;5597;311856;158297;5.7;2.9
44;2021-03-04;13263;5793;325119;164090;5.9;3.0
44;2021-03-05;17878;5698;342997;169788;6.2;3.1
44;2021-03-06;21350;2176;364347;171964;6.6;3.1
44;2021-03-07;12201;750;376548;172714;6.8;3.1
44;2021-03-08;9404;4263;385952;176977;7.0;3.2
44;2021-03-09;15194;4980;401146;181957;7.3;3.3
44;2021-03-10;16602;5194;417748;187151;7.6;3.4
44;2021-03-11;20344;5672;438092;192823;7.9;3.5
44;2021-03-12;26801;5534;464893;198357;8.4;3.6
44;2021-03-13;24213;2419;489106;200776;8.9;3.6
44;2021-03-14;6766;882;495872;201658;9.0;3.7
44;2021-03-15;12956;3475;508828;205133;9.2;3.7
44;2021-03-16;12834;3986;521662;209119;9.5;3.8
44;2021-03-17;14193;3641;535855;212760;9.7;3.9
44;2021-03-18;15409;3793;551264;216553;10.0;3.9
44;2021-03-19;21409;3905;572673;220458;10.4;4.0
44;2021-03-20;15561;1959;588234;222417;10.7;4.0
44;2021-03-21;4618;288;592852;222705;10.8;4.0
44;2021-03-22;12520;3917;605372;226622;11.0;4.1
44;2021-03-23;19437;5080;624809;231702;11.3;4.2
44;2021-03-24;22044;5196;646853;236898;11.7;4.3
44;2021-03-25;28188;5777;675041;242675;12.2;4.4
44;2021-03-26;30340;5490;705381;248165;12.8;4.5
44;2021-03-27;16226;4703;721607;252868;13.1;4.6
44;2021-03-28;4078;1979;725685;254847;13.2;4.6
44;2021-03-29;14307;6130;739992;260977;13.4;4.7
44;2021-03-30;21399;7830;761391;268807;13.8;4.9
44;2021-03-31;20113;8013;781504;276820;14.2;5.0
44;2021-04-01;23544;9345;805048;286165;14.6;5.2
44;2021-04-02;16234;6901;821282;293066;14.9;5.3
44;2021-04-03;10188;5765;831470;298831;15.1;5.4
44;2021-04-04;3133;1654;834603;300485;15.1;5.5
44;2021-04-05;4424;1415;839027;301900;15.2;5.5
44;2021-04-06;13407;10555;852434;312455;15.5;5.7
44;2021-04-07;17650;12111;870084;324566;15.8;5.9
44;2021-04-08;26010;12409;896094;336975;16.3;6.1
44;2021-04-09;32224;12754;928318;349729;16.8;6.3
44;2021-04-10;18246;10061;946564;359790;17.2;6.5
44;2021-04-11;3028;5967;949592;365757;17.2;6.6
44;2021-04-12;16954;11242;966546;376999;17.5;6.8
44;2021-04-13;21972;13773;988518;390772;17.9;7.1
44;2021-04-14;23099;14057;1011617;404829;18.4;7.3
44;2021-04-15;26270;15366;1037887;420195;18.8;7.6
44;2021-04-16;28085;15205;1065972;435400;19.3;7.9
44;2021-04-17;19816;9038;1085788;444438;19.7;8.1
44;2021-04-18;5049;4629;1090837;449067;19.8;8.1
44;2021-04-19;16925;11751;1107762;460818;20.1;8.4
44;2021-04-20;19104;14300;1126866;475118;20.4;8.6
44;2021-04-21;21124;14951;1147990;490069;20.8;8.9
44;2021-04-22;23690;15871;1171680;505940;21.3;9.2
44;2021-04-23;27797;16566;1199477;522506;21.8;9.5
44;2021-04-24;16973;9155;1216450;531661;22.1;9.6
44;2021-04-25;4826;3560;1221276;535221;22.2;9.7
44;2021-04-26;16696;12015;1237972;547236;22.5;9.9
44;2021-04-27;21148;14617;1259120;561853;22.8;10.2
44;2021-04-28;23776;14795;1282896;576648;23.3;10.5
44;2021-04-29;28120;16939;1311016;593587;23.8;10.8
44;2021-04-30;33101;16001;1344117;609588;24.4;11.1
44;2021-05-01;14844;7013;1358961;616601;24.7;11.2
44;2021-05-02;7897;3990;1366858;620591;24.8;11.3
44;2021-05-03;23998;12359;1390856;632950;25.2;11.5
44;2021-05-04;26959;17252;1417815;650202;25.7;11.8
44;2021-05-05;30796;19132;1448611;669334;26.3;12.1
44;2021-05-06;37975;21066;1486586;690400;27.0;12.5
44;2021-05-07;36116;24774;1522702;715174;27.6;13.0
44;2021-05-08;19553;6694;1542255;721868;28.0;13.1
44;2021-05-09;11300;2901;1553555;724769;28.2;13.1
44;2021-05-10;24478;20749;1578033;745518;28.6;13.5
44;2021-05-11;34408;22892;1612441;768410;29.3;13.9
44;2021-05-12;37095;23981;1649536;792391;29.9;14.4
44;2021-05-13;27871;6358;1677407;798749;30.4;14.5
44;2021-05-14;44184;18873;1721591;817622;31.2;14.8
44;2021-05-15;34019;14082;1755610;831704;31.9;15.1
44;2021-05-16;15597;3504;1771207;835208;32.1;15.2
44;2021-05-17;27185;14517;1798392;849725;32.6;15.4
44;2021-05-18;35166;15246;1833558;864971;33.3;15.7
44;2021-05-19;36840;16332;1870398;881303;33.9;16.0
44;2021-05-20;40789;16422;1911187;897725;34.7;16.3
44;2021-05-21;42734;20864;1953921;918589;35.5;16.7
44;2021-05-22;27653;11546;1981574;930135;36.0;16.9
44;2021-05-23;8660;1713;1990234;931848;36.1;16.9
44;2021-05-24;17887;4647;2008121;936495;36.4;17.0
44;2021-05-25;30190;17587;2038311;954082;37.0;17.3
44;2021-05-26;32331;19482;2070642;973564;37.6;17.7
44;2021-05-27;34502;20790;2105144;994354;38.2;18.0
44;2021-05-28;37455;27785;2142599;1022139;38.9;18.5
44;2021-05-29;26756;20112;2169355;1042251;39.4;18.9
44;2021-05-30;6118;4208;2175473;1046459;39.5;19.0
44;2021-05-31;26967;19677;2202440;1066136;40.0;19.3
44;2021-06-01;31487;22868;2233927;1089004;40.5;19.8
44;2021-06-02;33510;22893;2267437;1111897;41.1;20.2
44;2021-06-03;34523;25258;2301960;1137155;41.8;20.6
44;2021-06-04;39911;32159;2341871;1169314;42.5;21.2
44;2021-06-05;23036;20086;2364907;1189400;42.9;21.6
44;2021-06-06;8303;4450;2373210;1193850;43.1;21.7
44;2021-06-07;28082;22058;2401292;1215908;43.6;22.1
44;2021-06-08;32984;26642;2434276;1242550;44.2;22.5
44;2021-06-09;35590;24851;2469866;1267401;44.8;23.0
44;2021-06-10;34520;25573;2504386;1292974;45.4;23.5
44;2021-06-11;32317;35364;2536703;1328338;46.0;24.1
44;2021-06-12;25668;23427;2562371;1351765;46.5;24.5
44;2021-06-13;6763;6056;2569134;1357821;46.6;24.6
44;2021-06-14;17589;29546;2586723;1387367;46.9;25.2
44;2021-06-15;23551;34935;2610274;1422302;47.4;25.8
44;2021-06-16;24247;36556;2634521;1458858;47.8;26.5
44;2021-06-17;23750;39217;2658271;1498075;48.2;27.2
44;2021-06-18;26398;42927;2684669;1541002;48.7;28.0
44;2021-06-19;20991;28169;2705660;1569171;49.1;28.5
44;2021-06-20;3669;6645;2709329;1575816;49.2;28.6
44;2021-06-21;14778;34018;2724107;1609834;49.4;29.2
44;2021-06-22;15362;41529;2739469;1651363;49.7;30.0
44;2021-06-23;19938;41279;2759407;1692642;50.1;30.7
44;2021-06-24;16439;34183;2775846;1726825;50.4;31.3
44;2021-06-25;18727;49370;2794573;1776195;50.7;32.2
44;2021-06-26;13942;37271;2808515;1813466;51.0;32.9
44;2021-06-27;3319;11531;2811834;1824997;51.0;33.1
44;2021-06-28;11214;37354;2823048;1862351;51.2;33.8
52;2020-12-27;0;0;0;0;0.0;0.0
52;2020-12-28;1;0;1;0;0.0;0.0
52;2020-12-29;0;0;1;0;0.0;0.0
52;2020-12-30;0;0;1;0;0.0;0.0
52;2020-12-31;0;0;1;0;0.0;0.0
52;2021-01-01;5;0;6;0;0.0;0.0
52;2021-01-02;1;0;7;0;0.0;0.0
52;2021-01-03;1;0;8;0;0.0;0.0
52;2021-01-04;34;0;42;0;0.0;0.0
52;2021-01-05;168;0;210;0;0.0;0.0
52;2021-01-06;384;1;594;1;0.0;0.0
52;2021-01-07;963;0;1557;1;0.0;0.0
52;2021-01-08;1664;3;3221;4;0.1;0.0
52;2021-01-09;1049;2;4270;6;0.1;0.0
52;2021-01-10;643;1;4913;7;0.1;0.0
52;2021-01-11;2197;0;7110;7;0.2;0.0
52;2021-01-12;3169;4;10279;11;0.3;0.0
52;2021-01-13;2983;4;13262;15;0.3;0.0
52;2021-01-14;3303;25;16565;40;0.4;0.0
52;2021-01-15;3015;9;19580;49;0.5;0.0
52;2021-01-16;894;7;20474;56;0.5;0.0
52;2021-01-17;499;3;20973;59;0.6;0.0
52;2021-01-18;3200;6;24173;65;0.6;0.0
52;2021-01-19;6553;9;30726;74;0.8;0.0
52;2021-01-20;8333;12;39059;86;1.0;0.0
52;2021-01-21;12168;11;51227;97;1.3;0.0
52;2021-01-22;7273;30;58500;127;1.5;0.0
52;2021-01-23;1677;5;60177;132;1.6;0.0
52;2021-01-24;174;0;60351;132;1.6;0.0
52;2021-01-25;3006;13;63357;145;1.7;0.0
52;2021-01-26;6737;154;70094;299;1.8;0.0
52;2021-01-27;7285;151;77379;450;2.0;0.0
52;2021-01-28;9728;470;87107;920;2.3;0.0
52;2021-01-29;5957;911;93064;1831;2.4;0.0
52;2021-01-30;1258;271;94322;2102;2.5;0.1
52;2021-01-31;79;314;94401;2416;2.5;0.1
52;2021-02-01;2521;1191;96922;3607;2.5;0.1
52;2021-02-02;2970;1859;99892;5466;2.6;0.1
52;2021-02-03;2686;2161;102578;7627;2.7;0.2
52;2021-02-04;2962;2117;105540;9744;2.8;0.3
52;2021-02-05;2965;2206;108505;11950;2.9;0.3
52;2021-02-06;1075;662;109580;12612;2.9;0.3
52;2021-02-07;151;297;109731;12909;2.9;0.3
52;2021-02-08;1929;2119;111660;15028;2.9;0.4
52;2021-02-09;3174;3722;114834;18750;3.0;0.5
52;2021-02-10;3318;4763;118152;23513;3.1;0.6
52;2021-02-11;6099;9306;124251;32819;3.3;0.9
52;2021-02-12;4705;5148;128956;37967;3.4;1.0
52;2021-02-13;1150;1244;130106;39211;3.4;1.0
52;2021-02-14;22;541;130128;39752;3.4;1.0
52;2021-02-15;2030;3536;132158;43288;3.5;1.1
52;2021-02-16;4111;6759;136269;50047;3.6;1.3
52;2021-02-17;3874;6952;140143;56999;3.7;1.5
52;2021-02-18;6139;9299;146282;66298;3.8;1.7
52;2021-02-19;5330;5845;151612;72143;4.0;1.9
52;2021-02-20;1028;1476;152640;73619;4.0;1.9
52;2021-02-21;7;274;152647;73893;4.0;1.9
52;2021-02-22;2645;3494;155292;77387;4.1;2.0
52;2021-02-23;3424;3703;158716;81090;4.2;2.1
52;2021-02-24;3304;3040;162020;84130;4.3;2.2
52;2021-02-25;6344;3220;168364;87350;4.4;2.3
52;2021-02-26;6213;2932;174577;90282;4.6;2.4
52;2021-02-27;2216;1047;176793;91329;4.7;2.4
52;2021-02-28;76;88;176869;91417;4.7;2.4
52;2021-03-01;3113;2334;179982;93751;4.7;2.5
52;2021-03-02;4723;3441;184705;97192;4.9;2.6
52;2021-03-03;5278;3415;189983;100607;5.0;2.6
52;2021-03-04;7788;4782;197771;105389;5.2;2.8
52;2021-03-05;9005;3937;206776;109326;5.4;2.9
52;2021-03-06;5636;1157;212412;110483;5.6;2.9
52;2021-03-07;2661;136;215073;110619;5.7;2.9
52;2021-03-08;5841;2429;220914;113048;5.8;3.0
52;2021-03-09;9546;3339;230460;116387;6.1;3.1
52;2021-03-10;9390;3405;239850;119792;6.3;3.2
52;2021-03-11;13572;5062;253422;124854;6.7;3.3
52;2021-03-12;15328;3756;268750;128610;7.1;3.4
52;2021-03-13;8288;765;277038;129375;7.3;3.4
52;2021-03-14;624;72;277662;129447;7.3;3.4
52;2021-03-15;8834;1915;286496;131362;7.5;3.5
52;2021-03-16;7573;2621;294069;133983;7.7;3.5
52;2021-03-17;6457;2385;300526;136368;7.9;3.6
52;2021-03-18;8301;2516;308827;138884;8.1;3.7
52;2021-03-19;11886;2135;320713;141019;8.4;3.7
52;2021-03-20;7085;763;327798;141782;8.6;3.7
52;2021-03-21;1689;48;329487;141830;8.7;3.7
52;2021-03-22;9013;2011;338500;143841;8.9;3.8
52;2021-03-23;13179;2601;351679;146442;9.3;3.9
52;2021-03-24;13256;2044;364935;148486;9.6;3.9
52;2021-03-25;18193;2818;383128;151304;10.1;4.0
52;2021-03-26;18927;2382;402055;153686;10.6;4.0
52;2021-03-27;7553;653;409608;154339;10.8;4.1
52;2021-03-28;2193;67;411801;154406;10.8;4.1
52;2021-03-29;10966;2724;422767;157130;11.1;4.1
52;2021-03-30;15674;3608;438441;160738;11.5;4.2
52;2021-03-31;13687;3288;452128;164026;11.9;4.3
52;2021-04-01;18869;3699;470997;167725;12.4;4.4
52;2021-04-02;17081;3516;488078;171241;12.8;4.5
52;2021-04-03;5515;1194;493593;172435;13.0;4.5
52;2021-04-04;1324;51;494917;172486;13.0;4.5
52;2021-04-05;1781;538;496698;173024;13.1;4.6
52;2021-04-06;11783;5258;508481;178282;13.4;4.7
52;2021-04-07;15186;5701;523667;183983;13.8;4.8
52;2021-04-08;21214;6393;544881;190376;14.3;5.0
52;2021-04-09;26624;5311;571505;195687;15.0;5.1
52;2021-04-10;10115;2364;581620;198051;15.3;5.2
52;2021-04-11;2567;434;584187;198485;15.4;5.2
52;2021-04-12;16329;6585;600516;205070;15.8;5.4
52;2021-04-13;20728;8173;621244;213243;16.3;5.6
52;2021-04-14;17652;6924;638896;220167;16.8;5.8
52;2021-04-15;21149;8033;660045;228200;17.4;6.0
52;2021-04-16;22588;7478;682633;235678;18.0;6.2
52;2021-04-17;9971;3033;692604;238711;18.2;6.3
52;2021-04-18;3036;1307;695640;240018;18.3;6.3
52;2021-04-19;14171;7819;709811;247837;18.7;6.5
52;2021-04-20;18260;9393;728071;257230;19.2;6.8
52;2021-04-21;15976;9163;744047;266393;19.6;7.0
52;2021-04-22;19409;10164;763456;276557;20.1;7.3
52;2021-04-23;20508;9975;783964;286532;20.6;7.5
52;2021-04-24;10011;4980;793975;291512;20.9;7.7
52;2021-04-25;3980;1951;797955;293463;21.0;7.7
52;2021-04-26;16819;9905;814774;303368;21.4;8.0
52;2021-04-27;21063;12561;835837;315929;22.0;8.3
52;2021-04-28;22758;10663;858595;326592;22.6;8.6
52;2021-04-29;25000;12678;883595;339270;23.2;8.9
52;2021-04-30;25633;12487;909228;351757;23.9;9.3
52;2021-05-01;8614;2477;917842;354234;24.1;9.3
52;2021-05-02;4298;1271;922140;355505;24.3;9.4
52;2021-05-03;19059;10624;941199;366129;24.8;9.6
52;2021-05-04;20064;14389;961263;380518;25.3;10.0
52;2021-05-05;20854;12768;982117;393286;25.8;10.3
52;2021-05-06;22467;13838;1004584;407124;26.4;10.7
52;2021-05-07;20688;18025;1025272;425149;27.0;11.2
52;2021-05-08;11224;2085;1036496;427234;27.3;11.2
52;2021-05-09;5396;2227;1041892;429461;27.4;11.3
52;2021-05-10;20773;17286;1062665;446747;28.0;11.8
52;2021-05-11;24845;19551;1087510;466298;28.6;12.3
52;2021-05-12;24780;17107;1112290;483405;29.3;12.7
52;2021-05-13;18575;2741;1130865;486146;29.7;12.8
52;2021-05-14;22744;12426;1153609;498572;30.3;13.1
52;2021-05-15;15648;5213;1169257;503785;30.8;13.3
52;2021-05-16;10287;1160;1179544;504945;31.0;13.3
52;2021-05-17;21121;14672;1200665;519617;31.6;13.7
52;2021-05-18;24781;14994;1225446;534611;32.2;14.1
52;2021-05-19;26768;11444;1252214;546055;32.9;14.4
52;2021-05-20;29280;12002;1281494;558057;33.7;14.7
52;2021-05-21;27326;13839;1308820;571896;34.4;15.0
52;2021-05-22;15411;4708;1324231;576604;34.8;15.2
52;2021-05-23;4471;1142;1328702;577746;34.9;15.2
52;2021-05-24;15998;2757;1344700;580503;35.4;15.3
52;2021-05-25;24421;14531;1369121;595034;36.0;15.7
52;2021-05-26;25147;12656;1394268;607690;36.7;16.0
52;2021-05-27;29065;14818;1423333;622508;37.4;16.4
52;2021-05-28;27907;17860;1451240;640368;38.2;16.8
52;2021-05-29;18326;7771;1469566;648139;38.7;17.0
52;2021-05-30;4228;1718;1473794;649857;38.8;17.1
52;2021-05-31;24407;15874;1498201;665731;39.4;17.5
52;2021-06-01;28803;17809;1527004;683540;40.2;18.0
52;2021-06-02;27426;15214;1554430;698754;40.9;18.4
52;2021-06-03;31714;16278;1586144;715032;41.7;18.8
52;2021-06-04;29207;20729;1615351;735761;42.5;19.4
52;2021-06-05;14537;11802;1629888;747563;42.9;19.7
52;2021-06-06;4776;3531;1634664;751094;43.0;19.8
52;2021-06-07;21695;20875;1656359;771969;43.6;20.3
52;2021-06-08;26425;22032;1682784;794001;44.3;20.9
52;2021-06-09;25643;18614;1708427;812615;44.9;21.4
52;2021-06-10;28708;17588;1737135;830203;45.7;21.8
52;2021-06-11;26957;24313;1764092;854516;46.4;22.5
52;2021-06-12;14590;11845;1778682;866361;46.8;22.8
52;2021-06-13;4379;4517;1783061;870878;46.9;22.9
52;2021-06-14;17597;25392;1800658;896270;47.4;23.6
52;2021-06-15;23684;25325;1824342;921595;48.0;24.2
52;2021-06-16;23274;22468;1847616;944063;48.6;24.8
52;2021-06-17;25908;23080;1873524;967143;49.3;25.4
52;2021-06-18;23231;28715;1896755;995858;49.9;26.2
52;2021-06-19;12435;14243;1909190;1010101;50.2;26.6
52;2021-06-20;3013;4418;1912203;1014519;50.3;26.7
52;2021-06-21;14810;28879;1927013;1043398;50.7;27.4
52;2021-06-22;17373;31772;1944386;1075170;51.1;28.3
52;2021-06-23;18401;26990;1962787;1102160;51.6;29.0
52;2021-06-24;20972;24066;1983759;1126226;52.2;29.6
52;2021-06-25;16551;31253;2000310;1157479;52.6;30.4
52;2021-06-26;8430;18078;2008740;1175557;52.8;30.9
52;2021-06-27;1334;7441;2010074;1182998;52.9;31.1
52;2021-06-28;10364;31068;2020438;1214066;53.1;31.9
53;2020-12-27;0;0;0;0;0.0;0.0
53;2020-12-28;0;0;0;0;0.0;0.0
53;2020-12-29;0;0;0;0;0.0;0.0
53;2020-12-30;0;0;0;0;0.0;0.0
53;2020-12-31;0;0;0;0;0.0;0.0
53;2021-01-01;3;0;3;0;0.0;0.0
53;2021-01-02;4;0;7;0;0.0;0.0
53;2021-01-03;0;0;7;0;0.0;0.0
53;2021-01-04;43;0;50;0;0.0;0.0
53;2021-01-05;200;0;250;0;0.0;0.0
53;2021-01-06;331;1;581;1;0.0;0.0
53;2021-01-07;835;1;1416;2;0.0;0.0
53;2021-01-08;1213;0;2629;2;0.1;0.0
53;2021-01-09;34;0;2663;2;0.1;0.0
53;2021-01-10;4;0;2667;2;0.1;0.0
53;2021-01-11;1661;3;4328;5;0.1;0.0
53;2021-01-12;3380;1;7708;6;0.2;0.0
53;2021-01-13;3355;5;11063;11;0.3;0.0
53;2021-01-14;3813;30;14876;41;0.4;0.0
53;2021-01-15;3297;17;18173;58;0.5;0.0
53;2021-01-16;684;4;18857;62;0.6;0.0
53;2021-01-17;180;1;19037;63;0.6;0.0
53;2021-01-18;3361;7;22398;70;0.7;0.0
53;2021-01-19;8177;6;30575;76;0.9;0.0
53;2021-01-20;7060;4;37635;80;1.1;0.0
53;2021-01-21;11481;7;49116;87;1.5;0.0
53;2021-01-22;7812;13;56928;100;1.7;0.0
53;2021-01-23;1492;2;58420;102;1.7;0.0
53;2021-01-24;255;1;58675;103;1.8;0.0
53;2021-01-25;3056;35;61731;138;1.8;0.0
53;2021-01-26;4112;233;65843;371;2.0;0.0
53;2021-01-27;7238;326;73081;697;2.2;0.0
53;2021-01-28;7134;643;80215;1340;2.4;0.0
53;2021-01-29;4230;730;84445;2070;2.5;0.1
53;2021-01-30;844;43;85289;2113;2.6;0.1
53;2021-01-31;79;3;85368;2116;2.6;0.1
53;2021-02-01;2211;1027;87579;3143;2.6;0.1
53;2021-02-02;3438;2017;91017;5160;2.7;0.2
53;2021-02-03;3175;2184;94192;7344;2.8;0.2
53;2021-02-04;7096;2270;101288;9614;3.0;0.3
53;2021-02-05;5586;2136;106874;11750;3.2;0.4
53;2021-02-06;1201;277;108075;12027;3.2;0.4
53;2021-02-07;214;132;108289;12159;3.2;0.4
53;2021-02-08;1651;1532;109940;13691;3.3;0.4
53;2021-02-09;3977;5259;113917;18950;3.4;0.6
53;2021-02-10;3791;4650;117708;23600;3.5;0.7
53;2021-02-11;5733;8795;123441;32395;3.7;1.0
53;2021-02-12;5662;5255;129103;37650;3.9;1.1
53;2021-02-13;1232;852;130335;38502;3.9;1.2
53;2021-02-14;25;348;130360;38850;3.9;1.2
53;2021-02-15;2325;3586;132685;42436;4.0;1.3
53;2021-02-16;4052;3545;136737;45981;4.1;1.4
53;2021-02-17;4074;5375;140811;51356;4.2;1.5
53;2021-02-18;5949;5747;146760;57103;4.4;1.7
53;2021-02-19;5355;4863;152115;61966;4.6;1.9
53;2021-02-20;1189;893;153304;62859;4.6;1.9
53;2021-02-21;166;218;153470;63077;4.6;1.9
53;2021-02-22;2318;2835;155788;65912;4.7;2.0
53;2021-02-23;3947;3675;159735;69587;4.8;2.1
53;2021-02-24;4470;3786;164205;73373;4.9;2.2
53;2021-02-25;7947;7146;172152;80519;5.2;2.4
53;2021-02-26;8677;4415;180829;84934;5.4;2.5
53;2021-02-27;3448;1106;184277;86040;5.5;2.6
53;2021-02-28;228;194;184505;86234;5.5;2.6
53;2021-03-01;3479;2269;187984;88503;5.6;2.6
53;2021-03-02;5617;4464;193601;92967;5.8;2.8
53;2021-03-03;6444;3795;200045;96762;6.0;2.9
53;2021-03-04;9285;4928;209330;101690;6.3;3.0
53;2021-03-05;11912;5221;221242;106911;6.6;3.2
53;2021-03-06;5635;1022;226877;107933;6.8;3.2
53;2021-03-07;913;146;227790;108079;6.8;3.2
53;2021-03-08;5163;2215;232953;110294;7.0;3.3
53;2021-03-09;9663;2938;242616;113232;7.3;3.4
53;2021-03-10;9276;3378;251892;116610;7.5;3.5
53;2021-03-11;14302;4054;266194;120664;8.0;3.6
53;2021-03-12;18600;3267;284794;123931;8.5;3.7
53;2021-03-13;8810;950;293604;124881;8.8;3.7
53;2021-03-14;812;50;294416;124931;8.8;3.7
53;2021-03-15;6892;2035;301308;126966;9.0;3.8
53;2021-03-16;6984;3409;308292;130375;9.2;3.9
53;2021-03-17;8226;2829;316518;133204;9.5;4.0
53;2021-03-18;8716;4657;325234;137861;9.7;4.1
53;2021-03-19;12991;3649;338225;141510;10.1;4.2
53;2021-03-20;7129;818;345354;142328;10.3;4.3
53;2021-03-21;383;32;345737;142360;10.4;4.3
53;2021-03-22;7346;2165;353083;144525;10.6;4.3
53;2021-03-23;12991;3666;366074;148191;11.0;4.4
53;2021-03-24;14401;3240;380475;151431;11.4;4.5
53;2021-03-25;18282;3372;398757;154803;11.9;4.6
53;2021-03-26;20313;3205;419070;158008;12.5;4.7
53;2021-03-27;7404;1014;426474;159022;12.8;4.8
53;2021-03-28;528;86;427002;159108;12.8;4.8
53;2021-03-29;9798;3166;436800;162274;13.1;4.9
53;2021-03-30;15307;4599;452107;166873;13.5;5.0
53;2021-03-31;14144;4268;466251;171141;14.0;5.1
53;2021-04-01;18191;4274;484442;175415;14.5;5.3
53;2021-04-02;17890;4354;502332;179769;15.0;5.4
53;2021-04-03;6432;1427;508764;181196;15.2;5.4
53;2021-04-04;413;33;509177;181229;15.2;5.4
53;2021-04-05;1231;336;510408;181565;15.3;5.4
53;2021-04-06;12523;5677;522931;187242;15.7;5.6
53;2021-04-07;15012;5335;537943;192577;16.1;5.8
53;2021-04-08;20672;6102;558615;198679;16.7;5.9
53;2021-04-09;26644;5575;585259;204254;17.5;6.1
53;2021-04-10;10333;1724;595592;205978;17.8;6.2
53;2021-04-11;816;213;596408;206191;17.9;6.2
53;2021-04-12;15827;4912;612235;211103;18.3;6.3
53;2021-04-13;22691;7259;634926;218362;19.0;6.5
53;2021-04-14;19342;7929;654268;226291;19.6;6.8
53;2021-04-15;25345;8065;679613;234356;20.3;7.0
53;2021-04-16;26171;7545;705784;241901;21.1;7.2
53;2021-04-17;10392;3581;716176;245482;21.4;7.3
53;2021-04-18;1033;149;717209;245631;21.5;7.4
53;2021-04-19;15399;6535;732608;252166;21.9;7.5
53;2021-04-20;16919;9515;749527;261681;22.4;7.8
53;2021-04-21;16742;9442;766269;271123;22.9;8.1
53;2021-04-22;21745;10184;788014;281307;23.6;8.4
53;2021-04-23;21649;10086;809663;291393;24.2;8.7
53;2021-04-24;9984;4169;819647;295562;24.5;8.8
53;2021-04-25;905;334;820552;295896;24.6;8.9
53;2021-04-26;18220;8480;838772;304376;25.1;9.1
53;2021-04-27;19853;12065;858625;316441;25.7;9.5
53;2021-04-28;19941;10815;878566;327256;26.3;9.8
53;2021-04-29;23544;12281;902110;339537;27.0;10.2
53;2021-04-30;23897;12444;926007;351981;27.7;10.5
53;2021-05-01;5123;1635;931130;353616;27.9;10.6
53;2021-05-02;2793;521;933923;354137;28.0;10.6
53;2021-05-03;15710;9380;949633;363517;28.4;10.9
53;2021-05-04;15688;15794;965321;379311;28.9;11.4
53;2021-05-05;14937;14693;980258;394004;29.3;11.8
53;2021-05-06;19254;17847;999512;411851;29.9;12.3
53;2021-05-07;18638;18222;1018150;430073;30.5;12.9
53;2021-05-08;5485;1120;1023635;431193;30.6;12.9
53;2021-05-09;3511;860;1027146;432053;30.7;12.9
53;2021-05-10;16678;15223;1043824;447276;31.2;13.4
53;2021-05-11;18664;18739;1062488;466015;31.8;14.0
53;2021-05-12;21190;15643;1083678;481658;32.4;14.4
53;2021-05-13;9024;3956;1092702;485614;32.7;14.5
53;2021-05-14;21712;13741;1114414;499355;33.4;14.9
53;2021-05-15;13425;5340;1127839;504695;33.8;15.1
53;2021-05-16;3222;877;1131061;505572;33.9;15.1
53;2021-05-17;18181;11182;1149242;516754;34.4;15.5
53;2021-05-18;20961;12409;1170203;529163;35.0;15.8
53;2021-05-19;21572;10639;1191775;539802;35.7;16.2
53;2021-05-20;23828;14724;1215603;554526;36.4;16.6
53;2021-05-21;22829;15237;1238432;569763;37.1;17.1
53;2021-05-22;13145;5841;1251577;575604;37.5;17.2
53;2021-05-23;2977;310;1254554;575914;37.6;17.2
53;2021-05-24;13941;2501;1268495;578415;38.0;17.3
53;2021-05-25;19930;12824;1288425;591239;38.6;17.7
53;2021-05-26;19257;13794;1307682;605033;39.1;18.1
53;2021-05-27;22043;17417;1329725;622450;39.8;18.6
53;2021-05-28;21751;20408;1351476;642858;40.5;19.2
53;2021-05-29;12137;7337;1363613;650195;40.8;19.5
53;2021-05-30;2307;472;1365920;650667;40.9;19.5
53;2021-05-31;20676;14093;1386596;664760;41.5;19.9
53;2021-06-01;22920;16485;1409516;681245;42.2;20.4
53;2021-06-02;21764;14233;1431280;695478;42.8;20.8
53;2021-06-03;25031;16857;1456311;712335;43.6;21.3
53;2021-06-04;23063;22570;1479374;734905;44.3;22.0
53;2021-06-05;17303;9004;1496677;743909;44.8;22.3
53;2021-06-06;4997;1325;1501674;745234;45.0;22.3
53;2021-06-07;18373;17792;1520047;763026;45.5;22.8
53;2021-06-08;23342;18044;1543389;781070;46.2;23.4
53;2021-06-09;23605;15873;1566994;796943;46.9;23.9
53;2021-06-10;26777;16871;1593771;813814;47.7;24.4
53;2021-06-11;26182;21430;1619953;835244;48.5;25.0
53;2021-06-12;18597;7510;1638550;842754;49.1;25.2
53;2021-06-13;7794;3119;1646344;845873;49.3;25.3
53;2021-06-14;16024;19800;1662368;865673;49.8;25.9
53;2021-06-15;20047;20951;1682415;886624;50.4;26.5
53;2021-06-16;21167;18533;1703582;905157;51.0;27.1
53;2021-06-17;21877;20093;1725459;925250;51.7;27.7
53;2021-06-18;22219;25646;1747678;950896;52.3;28.5
53;2021-06-19;12829;9607;1760507;960503;52.7;28.8
53;2021-06-20;5452;2679;1765959;963182;52.9;28.8
53;2021-06-21;14582;22350;1780541;985532;53.3;29.5
53;2021-06-22;16965;24912;1797506;1010444;53.8;30.2
53;2021-06-23;16658;23517;1814164;1033961;54.3;31.0
53;2021-06-24;19012;21830;1833176;1055791;54.9;31.6
53;2021-06-25;15457;29029;1848633;1084820;55.3;32.5
53;2021-06-26;7112;13958;1855745;1098778;55.6;32.9
53;2021-06-27;3878;3305;1859623;1102083;55.7;33.0
53;2021-06-28;9588;24187;1869211;1126270;56.0;33.7
75;2020-12-27;1;0;1;0;0.0;0.0
75;2020-12-28;2;0;3;0;0.0;0.0
75;2020-12-29;3;0;6;0;0.0;0.0
75;2020-12-30;2;0;8;0;0.0;0.0
75;2020-12-31;0;0;8;0;0.0;0.0
75;2021-01-01;4;0;12;0;0.0;0.0
75;2021-01-02;2;0;14;0;0.0;0.0
75;2021-01-03;0;0;14;0;0.0;0.0
75;2021-01-04;90;0;104;0;0.0;0.0
75;2021-01-05;124;0;228;0;0.0;0.0
75;2021-01-06;736;1;964;1;0.0;0.0
75;2021-01-07;4923;2;5887;3;0.1;0.0
75;2021-01-08;5468;5;11355;8;0.2;0.0
75;2021-01-09;845;1;12200;9;0.2;0.0
75;2021-01-10;479;0;12679;9;0.2;0.0
75;2021-01-11;3585;1;16264;10;0.3;0.0
75;2021-01-12;5949;6;22213;16;0.4;0.0
75;2021-01-13;6551;15;28764;31;0.5;0.0
75;2021-01-14;8123;63;36887;94;0.6;0.0
75;2021-01-15;7629;32;44516;126;0.7;0.0
75;2021-01-16;1607;14;46123;140;0.8;0.0
75;2021-01-17;425;6;46548;146;0.8;0.0
75;2021-01-18;6888;31;53436;177;0.9;0.0
75;2021-01-19;14049;14;67485;191;1.1;0.0
75;2021-01-20;15535;26;83020;217;1.4;0.0
75;2021-01-21;16965;21;99985;238;1.7;0.0
75;2021-01-22;12971;23;112956;261;1.9;0.0
75;2021-01-23;4421;3;117377;264;2.0;0.0
75;2021-01-24;700;1;118077;265;2.0;0.0
75;2021-01-25;8871;219;126948;484;2.1;0.0
75;2021-01-26;11722;454;138670;938;2.3;0.0
75;2021-01-27;12279;770;150949;1708;2.5;0.0
75;2021-01-28;12940;2659;163889;4367;2.7;0.1
75;2021-01-29;10000;2986;173889;7353;2.9;0.1
75;2021-01-30;3379;516;177268;7869;3.0;0.1
75;2021-01-31;646;420;177914;8289;3.0;0.1
75;2021-02-01;5716;2640;183630;10929;3.1;0.2
75;2021-02-02;9612;4357;193242;15286;3.2;0.3
75;2021-02-03;9596;4374;202838;19660;3.4;0.3
75;2021-02-04;10762;5683;213600;25343;3.6;0.4
75;2021-02-05;7489;5638;221089;30981;3.7;0.5
75;2021-02-06;2378;1106;223467;32087;3.7;0.5
75;2021-02-07;673;252;224140;32339;3.7;0.5
75;2021-02-08;5136;3653;229276;35992;3.8;0.6
75;2021-02-09;7315;8082;236591;44074;3.9;0.7
75;2021-02-10;7542;8742;244133;52816;4.1;0.9
75;2021-02-11;8858;10273;252991;63089;4.2;1.1
75;2021-02-12;7406;8837;260397;71926;4.3;1.2
75;2021-02-13;1953;1761;262350;73687;4.4;1.2
75;2021-02-14;274;364;262624;74051;4.4;1.2
75;2021-02-15;3189;7840;265813;81891;4.4;1.4
75;2021-02-16;4626;10534;270439;92425;4.5;1.5
75;2021-02-17;4761;11305;275200;103730;4.6;1.7
75;2021-02-18;5453;12847;280653;116577;4.7;1.9
75;2021-02-19;5419;9638;286072;126215;4.8;2.1
75;2021-02-20;989;2633;287061;128848;4.8;2.1
75;2021-02-21;187;667;287248;129515;4.8;2.2
75;2021-02-22;3649;8518;290897;138033;4.8;2.3
75;2021-02-23;5354;10957;296251;148990;4.9;2.5
75;2021-02-24;6130;10292;302381;159282;5.0;2.7
75;2021-02-25;10045;11724;312426;171006;5.2;2.9
75;2021-02-26;12267;8875;324693;179881;5.4;3.0
75;2021-02-27;5784;2491;330477;182372;5.5;3.0
75;2021-02-28;312;694;330789;183066;5.5;3.1
75;2021-03-01;5091;7018;335880;190084;5.6;3.2
75;2021-03-02;9350;8177;345230;198261;5.8;3.3
75;2021-03-03;10822;7776;356052;206037;5.9;3.4
75;2021-03-04;16736;8180;372788;214217;6.2;3.6
75;2021-03-05;20803;7484;393591;221701;6.6;3.7
75;2021-03-06;13409;2239;407000;223940;6.8;3.7
75;2021-03-07;3721;468;410721;224408;6.8;3.7
75;2021-03-08;9994;5392;420715;229800;7.0;3.8
75;2021-03-09;16855;6494;437570;236294;7.3;3.9
75;2021-03-10;18256;6320;455826;242614;7.6;4.0
75;2021-03-11;26436;6693;482262;249307;8.0;4.2
75;2021-03-12;31304;5279;513566;254586;8.6;4.2
75;2021-03-13;17860;1206;531426;255792;8.9;4.3
75;2021-03-14;1713;251;533139;256043;8.9;4.3
75;2021-03-15;14077;3428;547216;259471;9.1;4.3
75;2021-03-16;13686;3713;560902;263184;9.3;4.4
75;2021-03-17;14751;3884;575653;267068;9.6;4.5
75;2021-03-18;16380;4691;592033;271759;9.9;4.5
75;2021-03-19;22436;4298;614469;276057;10.2;4.6
75;2021-03-20;14031;823;628500;276880;10.5;4.6
75;2021-03-21;2473;107;630973;276987;10.5;4.6
75;2021-03-22;16795;3466;647768;280453;10.8;4.7
75;2021-03-23;25276;3898;673044;284351;11.2;4.7
75;2021-03-24;27150;4318;700194;288669;11.7;4.8
75;2021-03-25;35658;4650;735852;293319;12.3;4.9
75;2021-03-26;38624;4194;774476;297513;12.9;5.0
75;2021-03-27;15715;1286;790191;298799;13.2;5.0
75;2021-03-28;2726;395;792917;299194;13.2;5.0
75;2021-03-29;22839;4156;815756;303350;13.6;5.1
75;2021-03-30;31652;5987;847408;309337;14.1;5.2
75;2021-03-31;29752;5957;877160;315294;14.6;5.3
75;2021-04-01;35020;6963;912180;322257;15.2;5.4
75;2021-04-02;32354;6880;944534;329137;15.7;5.5
75;2021-04-03;12843;2641;957377;331778;16.0;5.5
75;2021-04-04;2137;341;959514;332119;16.0;5.5
75;2021-04-05;6369;604;965883;332723;16.1;5.5
75;2021-04-06;26385;10842;992268;343565;16.5;5.7
75;2021-04-07;32371;11031;1024639;354596;17.1;5.9
75;2021-04-08;39603;12382;1064242;366978;17.7;6.1
75;2021-04-09;49256;11004;1113498;377982;18.6;6.3
75;2021-04-10;24455;4983;1137953;382965;19.0;6.4
75;2021-04-11;4969;721;1142922;383686;19.0;6.4
75;2021-04-12;27380;11862;1170302;395548;19.5;6.6
75;2021-04-13;35725;14359;1206027;409907;20.1;6.8
75;2021-04-14;35440;14510;1241467;424417;20.7;7.1
75;2021-04-15;37688;15091;1279155;439508;21.3;7.3
75;2021-04-16;37148;15139;1316303;454647;21.9;7.6
75;2021-04-17;19575;7389;1335878;462036;22.3;7.7
75;2021-04-18;4073;2057;1339951;464093;22.3;7.7
75;2021-04-19;20894;14967;1360845;479060;22.7;8.0
75;2021-04-20;28487;19129;1389332;498189;23.2;8.3
75;2021-04-21;27837;18102;1417169;516291;23.6;8.6
75;2021-04-22;30374;19701;1447543;535992;24.1;8.9
75;2021-04-23;29072;20269;1476615;556261;24.6;9.3
75;2021-04-24;17012;9149;1493627;565410;24.9;9.4
75;2021-04-25;4597;1500;1498224;566910;25.0;9.4
75;2021-04-26;22315;19309;1520539;586219;25.3;9.8
75;2021-04-27;29189;24332;1549728;610551;25.8;10.2
75;2021-04-28;31140;24034;1580868;634585;26.3;10.6
75;2021-04-29;37267;26657;1618135;661242;27.0;11.0
75;2021-04-30;37752;25894;1655887;687136;27.6;11.5
75;2021-05-01;15680;5757;1671567;692893;27.9;11.5
75;2021-05-02;7258;2598;1678825;695491;28.0;11.6
75;2021-05-03;27256;21189;1706081;716680;28.4;11.9
75;2021-05-04;30356;29307;1736437;745987;28.9;12.4
75;2021-05-05;31500;31014;1767937;777001;29.5;13.0
75;2021-05-06;35951;32416;1803888;809417;30.1;13.5
75;2021-05-07;37431;34380;1841319;843797;30.7;14.1
75;2021-05-08;17708;8097;1859027;851894;31.0;14.2
75;2021-05-09;7313;4155;1866340;856049;31.1;14.3
75;2021-05-10;25221;29030;1891561;885079;31.5;14.8
75;2021-05-11;35596;32985;1927157;918064;32.1;15.3
75;2021-05-12;35617;30167;1962774;948231;32.7;15.8
75;2021-05-13;22699;7552;1985473;955783;33.1;15.9
75;2021-05-14;33899;20886;2019372;976669;33.7;16.3
75;2021-05-15;22950;11116;2042322;987785;34.0;16.5
75;2021-05-16;7415;2064;2049737;989849;34.2;16.5
75;2021-05-17;33913;19254;2083650;1009103;34.7;16.8
75;2021-05-18;42759;19965;2126409;1029068;35.4;17.2
75;2021-05-19;42701;17639;2169110;1046707;36.2;17.4
75;2021-05-20;45920;20378;2215030;1067085;36.9;17.8
75;2021-05-21;42844;21399;2257874;1088484;37.6;18.1
75;2021-05-22;23249;9811;2281123;1098295;38.0;18.3
75;2021-05-23;7808;1422;2288931;1099717;38.1;18.3
75;2021-05-24;18844;4076;2307775;1103793;38.5;18.4
75;2021-05-25;36822;20970;2344597;1124763;39.1;18.7
75;2021-05-26;38296;21496;2382893;1146259;39.7;19.1
75;2021-05-27;42914;27101;2425807;1173360;40.4;19.6
75;2021-05-28;38851;32301;2464658;1205661;41.1;20.1
75;2021-05-29;19646;18104;2484304;1223765;41.4;20.4
75;2021-05-30;5774;2289;2490078;1226054;41.5;20.4
75;2021-05-31;31626;23134;2521704;1249188;42.0;20.8
75;2021-06-01;40990;29630;2562694;1278818;42.7;21.3
75;2021-06-02;41347;28247;2604041;1307065;43.4;21.8
75;2021-06-03;47595;31223;2651636;1338288;44.2;22.3
75;2021-06-04;44378;36978;2696014;1375266;44.9;22.9
75;2021-06-05;24404;18538;2720418;1393804;45.3;23.2
75;2021-06-06;8733;4322;2729151;1398126;45.5;23.3
75;2021-06-07;31383;31544;2760534;1429670;46.0;23.8
75;2021-06-08;38415;35959;2798949;1465629;46.6;24.4
75;2021-06-09;39308;32940;2838257;1498569;47.3;25.0
75;2021-06-10;42919;31823;2881176;1530392;48.0;25.5
75;2021-06-11;40249;40326;2921425;1570718;48.7;26.2
75;2021-06-12;23191;21535;2944616;1592253;49.1;26.5
75;2021-06-13;8100;5658;2952716;1597911;49.2;26.6
75;2021-06-14;23957;37944;2976673;1635855;49.6;27.3
75;2021-06-15;33127;41690;3009800;1677545;50.2;28.0
75;2021-06-16;34630;37296;3044430;1714841;50.7;28.6
75;2021-06-17;36065;38580;3080495;1753421;51.3;29.2
75;2021-06-18;34675;45309;3115170;1798730;51.9;30.0
75;2021-06-19;20139;23251;3135309;1821981;52.3;30.4
75;2021-06-20;6211;5731;3141520;1827712;52.4;30.5
75;2021-06-21;21403;37336;3162923;1865048;52.7;31.1
75;2021-06-22;25204;43597;3188127;1908645;53.1;31.8
75;2021-06-23;26144;40801;3214271;1949446;53.6;32.5
75;2021-06-24;27792;35598;3242063;1985044;54.0;33.1
75;2021-06-25;23927;48612;3265990;2033656;54.4;33.9
75;2021-06-26;13584;26786;3279574;2060442;54.7;34.3
75;2021-06-27;4553;8571;3284127;2069013;54.7;34.5
75;2021-06-28;14681;44567;3298808;2113580;55.0;35.2
76;2020-12-27;0;0;0;0;0.0;0.0
76;2020-12-28;4;0;4;0;0.0;0.0
76;2020-12-29;0;0;4;0;0.0;0.0
76;2020-12-30;0;0;4;0;0.0;0.0
76;2020-12-31;1;0;5;0;0.0;0.0
76;2021-01-01;3;0;8;0;0.0;0.0
76;2021-01-02;2;0;10;0;0.0;0.0
76;2021-01-03;2;0;12;0;0.0;0.0
76;2021-01-04;59;1;71;1;0.0;0.0
76;2021-01-05;473;1;544;2;0.0;0.0
76;2021-01-06;784;2;1328;4;0.0;0.0
76;2021-01-07;2538;3;3866;7;0.1;0.0
76;2021-01-08;3214;2;7080;9;0.1;0.0
76;2021-01-09;1539;1;8619;10;0.1;0.0
76;2021-01-10;517;0;9136;10;0.2;0.0
76;2021-01-11;3525;9;12661;19;0.2;0.0
76;2021-01-12;5745;10;18406;29;0.3;0.0
76;2021-01-13;6475;14;24881;43;0.4;0.0
76;2021-01-14;8998;86;33879;129;0.6;0.0
76;2021-01-15;7253;34;41132;163;0.7;0.0
76;2021-01-16;1954;21;43086;184;0.7;0.0
76;2021-01-17;710;3;43796;187;0.7;0.0
76;2021-01-18;7703;21;51499;208;0.9;0.0
76;2021-01-19;11211;31;62710;239;1.1;0.0
76;2021-01-20;13724;25;76434;264;1.3;0.0
76;2021-01-21;16716;21;93150;285;1.6;0.0
76;2021-01-22;11926;34;105076;319;1.8;0.0
76;2021-01-23;3897;9;108973;328;1.8;0.0
76;2021-01-24;771;12;109744;340;1.9;0.0
76;2021-01-25;7829;98;117573;438;2.0;0.0
76;2021-01-26;10345;283;127918;721;2.2;0.0
76;2021-01-27;10849;482;138767;1203;2.3;0.0
76;2021-01-28;10137;1696;148904;2899;2.5;0.0
76;2021-01-29;8087;1990;156991;4889;2.6;0.1
76;2021-01-30;3185;772;160176;5661;2.7;0.1
76;2021-01-31;521;267;160697;5928;2.7;0.1
76;2021-02-01;5856;2605;166553;8533;2.8;0.1
76;2021-02-02;10059;4001;176612;12534;3.0;0.2
76;2021-02-03;9520;4071;186132;16605;3.1;0.3
76;2021-02-04;10101;5960;196233;22565;3.3;0.4
76;2021-02-05;7774;5027;204007;27592;3.4;0.5
76;2021-02-06;2695;1051;206702;28643;3.5;0.5
76;2021-02-07;542;498;207244;29141;3.5;0.5
76;2021-02-08;4840;4530;212084;33671;3.6;0.6
76;2021-02-09;6326;6822;218410;40493;3.7;0.7
76;2021-02-10;7180;9241;225590;49734;3.8;0.8
76;2021-02-11;9142;10739;234732;60473;4.0;1.0
76;2021-02-12;8047;7691;242779;68164;4.1;1.2
76;2021-02-13;2646;2272;245425;70436;4.1;1.2
76;2021-02-14;358;994;245783;71430;4.1;1.2
76;2021-02-15;3380;6470;249163;77900;4.2;1.3
76;2021-02-16;4242;8697;253405;86597;4.3;1.5
76;2021-02-17;4375;9659;257780;96256;4.4;1.6
76;2021-02-18;5871;9991;263651;106247;4.4;1.8
76;2021-02-19;4841;8131;268492;114378;4.5;1.9
76;2021-02-20;1530;3041;270022;117419;4.6;2.0
76;2021-02-21;265;595;270287;118014;4.6;2.0
76;2021-02-22;3279;7666;273566;125680;4.6;2.1
76;2021-02-23;4919;10245;278485;135925;4.7;2.3
76;2021-02-24;4645;10429;283130;146354;4.8;2.5
76;2021-02-25;8314;9917;291444;156271;4.9;2.6
76;2021-02-26;9636;8405;301080;164676;5.1;2.8
76;2021-02-27;3732;3098;304812;167774;5.1;2.8
76;2021-02-28;432;453;305244;168227;5.2;2.8
76;2021-03-01;5305;6148;310549;174375;5.2;2.9
76;2021-03-02;8214;7571;318763;181946;5.4;3.1
76;2021-03-03;9250;7501;328013;189447;5.5;3.2
76;2021-03-04;14319;7898;342332;197345;5.8;3.3
76;2021-03-05;16870;7123;359202;204468;6.1;3.5
76;2021-03-06;15886;2166;375088;206634;6.3;3.5
76;2021-03-07;11377;469;386465;207103;6.5;3.5
76;2021-03-08;9978;5532;396443;212635;6.7;3.6
76;2021-03-09;16228;6479;412671;219114;7.0;3.7
76;2021-03-10;16413;6503;429084;225617;7.2;3.8
76;2021-03-11;22597;6406;451681;232023;7.6;3.9
76;2021-03-12;26423;5272;478104;237295;8.1;4.0
76;2021-03-13;14924;2165;493028;239460;8.3;4.0
76;2021-03-14;2323;355;495351;239815;8.4;4.0
76;2021-03-15;13516;3302;508867;243117;8.6;4.1
76;2021-03-16;11758;4529;520625;247646;8.8;4.2
76;2021-03-17;12839;3973;533464;251619;9.0;4.2
76;2021-03-18;13701;4989;547165;256608;9.2;4.3
76;2021-03-19;18653;4012;565818;260620;9.5;4.4
76;2021-03-20;10662;1132;576480;261752;9.7;4.4
76;2021-03-21;3195;224;579675;261976;9.8;4.4
76;2021-03-22;14678;3588;594353;265564;10.0;4.5
76;2021-03-23;22242;4327;616595;269891;10.4;4.6
76;2021-03-24;23605;4203;640200;274094;10.8;4.6
76;2021-03-25;32014;4615;672214;278709;11.3;4.7
76;2021-03-26;30841;4083;703055;282792;11.9;4.8
76;2021-03-27;16240;1416;719295;284208;12.1;4.8
76;2021-03-28;4868;194;724163;284402;12.2;4.8
76;2021-03-29;22296;4894;746459;289296;12.6;4.9
76;2021-03-30;29709;5731;776168;295027;13.1;5.0
76;2021-03-31;26885;5600;803053;300627;13.6;5.1
76;2021-04-01;34449;5908;837502;306535;14.1;5.2
76;2021-04-02;29339;5781;866841;312316;14.6;5.3
76;2021-04-03;12151;2853;878992;315169;14.8;5.3
76;2021-04-04;4352;660;883344;315829;14.9;5.3
76;2021-04-05;4288;675;887632;316504;15.0;5.3
76;2021-04-06;22837;9747;910469;326251;15.4;5.5
76;2021-04-07;25260;9875;935729;336126;15.8;5.7
76;2021-04-08;33100;10248;968829;346374;16.4;5.8
76;2021-04-09;38884;9637;1007713;356011;17.0;6.0
76;2021-04-10;22694;5161;1030407;361172;17.4;6.1
76;2021-04-11;8859;1433;1039266;362605;17.5;6.1
76;2021-04-12;26025;10525;1065291;373130;18.0;6.3
76;2021-04-13;35758;12861;1101049;385991;18.6;6.5
76;2021-04-14;32853;13257;1133902;399248;19.1;6.7
76;2021-04-15;37438;13854;1171340;413102;19.8;7.0
76;2021-04-16;34414;13156;1205754;426258;20.4;7.2
76;2021-04-17;21384;6665;1227138;432923;20.7;7.3
76;2021-04-18;7709;2690;1234847;435613;20.8;7.4
76;2021-04-19;22044;12920;1256891;448533;21.2;7.6
76;2021-04-20;27960;16747;1284851;465280;21.7;7.9
76;2021-04-21;27017;16936;1311868;482216;22.1;8.1
76;2021-04-22;30342;17950;1342210;500166;22.7;8.4
76;2021-04-23;28685;16411;1370895;516577;23.1;8.7
76;2021-04-24;18483;10413;1389378;526990;23.4;8.9
76;2021-04-25;6909;4198;1396287;531188;23.6;9.0
76;2021-04-26;19930;18400;1416217;549588;23.9;9.3
76;2021-04-27;26717;21407;1442934;570995;24.4;9.6
76;2021-04-28;25884;20977;1468818;591972;24.8;10.0
76;2021-04-29;29715;23208;1498533;615180;25.3;10.4
76;2021-04-30;30765;20148;1529298;635328;25.8;10.7
76;2021-05-01;17416;7029;1546714;642357;26.1;10.8
76;2021-05-02;9481;4786;1556195;647143;26.3;10.9
76;2021-05-03;26516;16779;1582711;663922;26.7;11.2
76;2021-05-04;29990;25833;1612701;689755;27.2;11.6
76;2021-05-05;28171;26411;1640872;716166;27.7;12.1
76;2021-05-06;31009;30875;1671881;747041;28.2;12.6
76;2021-05-07;31611;30793;1703492;777834;28.8;13.1
76;2021-05-08;17341;10563;1720833;788397;29.0;13.3
76;2021-05-09;9709;8680;1730542;797077;29.2;13.5
76;2021-05-10;24074;28055;1754616;825132;29.6;13.9
76;2021-05-11;31633;33076;1786249;858208;30.1;14.5
76;2021-05-12;33311;29409;1819560;887617;30.7;15.0
76;2021-05-13;25941;9734;1845501;897351;31.1;15.1
76;2021-05-14;34535;21331;1880036;918682;31.7;15.5
76;2021-05-15;24481;12198;1904517;930880;32.1;15.7
76;2021-05-16;15450;3796;1919967;934676;32.4;15.8
76;2021-05-17;27832;19260;1947799;953936;32.9;16.1
76;2021-05-18;35168;19493;1982967;973429;33.5;16.4
76;2021-05-19;36739;16828;2019706;990257;34.1;16.7
76;2021-05-20;40871;18649;2060577;1008906;34.8;17.0
76;2021-05-21;37644;19955;2098221;1028861;35.4;17.4
76;2021-05-22;26919;9258;2125140;1038119;35.9;17.5
76;2021-05-23;13269;1806;2138409;1039925;36.1;17.6
76;2021-05-24;15373;4111;2153782;1044036;36.4;17.6
76;2021-05-25;31520;20754;2185302;1064790;36.9;18.0
76;2021-05-26;33304;19202;2218606;1083992;37.4;18.3
76;2021-05-27;36238;24414;2254844;1108406;38.1;18.7
76;2021-05-28;32390;28269;2287234;1136675;38.6;19.2
76;2021-05-29;19502;16751;2306736;1153426;38.9;19.5
76;2021-05-30;6174;6312;2312910;1159738;39.0;19.6
76;2021-05-31;25707;22883;2338617;1182621;39.5;20.0
76;2021-06-01;31123;29833;2369740;1212454;40.0;20.5
76;2021-06-02;30694;28074;2400434;1240528;40.5;20.9
76;2021-06-03;34133;33108;2434567;1273636;41.1;21.5
76;2021-06-04;35012;34245;2469579;1307881;41.7;22.1
76;2021-06-05;25964;19723;2495543;1327604;42.1;22.4
76;2021-06-06;14072;6465;2509615;1334069;42.4;22.5
76;2021-06-07;25701;27664;2535316;1361733;42.8;23.0
76;2021-06-08;32345;31575;2567661;1393308;43.3;23.5
76;2021-06-09;32226;29079;2599887;1422387;43.9;24.0
76;2021-06-10;31887;29458;2631774;1451845;44.4;24.5
76;2021-06-11;33498;36120;2665272;1487965;45.0;25.1
76;2021-06-12;23172;21897;2688444;1509862;45.4;25.5
76;2021-06-13;12022;7134;2700466;1516996;45.6;25.6
76;2021-06-14;21523;33611;2721989;1550607;45.9;26.2
76;2021-06-15;28694;39695;2750683;1590302;46.4;26.8
76;2021-06-16;26973;36343;2777656;1626645;46.9;27.5
76;2021-06-17;26753;34160;2804409;1660805;47.3;28.0
76;2021-06-18;27361;41112;2831770;1701917;47.8;28.7
76;2021-06-19;20783;23115;2852553;1725032;48.1;29.1
76;2021-06-20;8907;10337;2861460;1735369;48.3;29.3
76;2021-06-21;15023;35201;2876483;1770570;48.5;29.9
76;2021-06-22;18175;40453;2894658;1811023;48.9;30.6
76;2021-06-23;18909;37950;2913567;1848973;49.2;31.2
76;2021-06-24;17396;35326;2930963;1884299;49.5;31.8
76;2021-06-25;18189;44755;2949152;1929054;49.8;32.6
76;2021-06-26;12196;28861;2961348;1957915;50.0;33.0
76;2021-06-27;5707;14598;2967055;1972513;50.1;33.3
76;2021-06-28;12478;38096;2979533;2010609;50.3;33.9
84;2020-12-27;1;0;1;0;0.0;0.0
84;2020-12-28;7;0;8;0;0.0;0.0
84;2020-12-29;5;0;13;0;0.0;0.0
84;2020-12-30;6;0;19;0;0.0;0.0
84;2020-12-31;15;0;34;0;0.0;0.0
84;2021-01-01;10;0;44;0;0.0;0.0
84;2021-01-02;2;1;46;1;0.0;0.0
84;2021-01-03;0;0;46;1;0.0;0.0
84;2021-01-04;174;0;220;1;0.0;0.0
84;2021-01-05;468;1;688;2;0.0;0.0
84;2021-01-06;1135;1;1823;3;0.0;0.0
84;2021-01-07;2887;3;4710;6;0.1;0.0
84;2021-01-08;3079;3;7789;9;0.1;0.0
84;2021-01-09;513;1;8302;10;0.1;0.0
84;2021-01-10;161;0;8463;10;0.1;0.0
84;2021-01-11;4295;9;12758;19;0.2;0.0
84;2021-01-12;6363;17;19121;36;0.2;0.0
84;2021-01-13;6843;15;25964;51;0.3;0.0
84;2021-01-14;9071;57;35035;108;0.4;0.0
84;2021-01-15;7764;33;42799;141;0.5;0.0
84;2021-01-16;2953;7;45752;148;0.6;0.0
84;2021-01-17;920;2;46672;150;0.6;0.0
84;2021-01-18;8965;35;55637;185;0.7;0.0
84;2021-01-19;15048;84;70685;269;0.9;0.0
84;2021-01-20;15493;37;86178;306;1.1;0.0
84;2021-01-21;14582;51;100760;357;1.3;0.0
84;2021-01-22;12414;43;113174;400;1.4;0.0
84;2021-01-23;4762;3;117936;403;1.5;0.0
84;2021-01-24;810;1;118746;404;1.5;0.0
84;2021-01-25;8766;152;127512;556;1.6;0.0
84;2021-01-26;11898;321;139410;877;1.7;0.0
84;2021-01-27;12080;620;151490;1497;1.9;0.0
84;2021-01-28;13830;1541;165320;3038;2.1;0.0
84;2021-01-29;10792;1312;176112;4350;2.2;0.1
84;2021-01-30;4141;147;180253;4497;2.2;0.1
84;2021-01-31;499;1;180752;4498;2.3;0.1
84;2021-02-01;6533;1887;187285;6385;2.3;0.1
84;2021-02-02;10592;3518;197877;9903;2.5;0.1
84;2021-02-03;11529;3932;209406;13835;2.6;0.2
84;2021-02-04;12557;5554;221963;19389;2.8;0.2
84;2021-02-05;8613;4701;230576;24090;2.9;0.3
84;2021-02-06;2653;960;233229;25050;2.9;0.3
84;2021-02-07;451;441;233680;25491;2.9;0.3
84;2021-02-08;6223;4971;239903;30462;3.0;0.4
84;2021-02-09;9339;8276;249242;38738;3.1;0.5
84;2021-02-10;9677;8627;258919;47365;3.2;0.6
84;2021-02-11;10696;9927;269615;57292;3.4;0.7
84;2021-02-12;9720;7952;279335;65244;3.5;0.8
84;2021-02-13;3497;2353;282832;67597;3.5;0.8
84;2021-02-14;623;458;283455;68055;3.5;0.8
84;2021-02-15;4873;8375;288328;76430;3.6;1.0
84;2021-02-16;6100;10789;294428;87219;3.7;1.1
84;2021-02-17;6067;11584;300495;98803;3.7;1.2
84;2021-02-18;7103;11777;307598;110580;3.8;1.4
84;2021-02-19;6646;9367;314244;119947;3.9;1.5
84;2021-02-20;1837;3273;316081;123220;3.9;1.5
84;2021-02-21;180;504;316261;123724;3.9;1.5
84;2021-02-22;4292;8863;320553;132587;4.0;1.7
84;2021-02-23;7281;11441;327834;144028;4.1;1.8
84;2021-02-24;7794;12038;335628;156066;4.2;1.9
84;2021-02-25;12729;13830;348357;169896;4.3;2.1
84;2021-02-26;14874;10369;363231;180265;4.5;2.2
84;2021-02-27;5561;2927;368792;183192;4.6;2.3
84;2021-02-28;500;515;369292;183707;4.6;2.3
84;2021-03-01;9289;6431;378581;190138;4.7;2.4
84;2021-03-02;14961;8833;393542;198971;4.9;2.5
84;2021-03-03;14801;8694;408343;207665;5.1;2.6
84;2021-03-04;21027;8484;429370;216149;5.3;2.7
84;2021-03-05;25778;7756;455148;223905;5.7;2.8
84;2021-03-06;19494;2408;474642;226313;5.9;2.8
84;2021-03-07;8415;481;483057;226794;6.0;2.8
84;2021-03-08;12215;6829;495272;233623;6.2;2.9
84;2021-03-09;20681;7722;515953;241345;6.4;3.0
84;2021-03-10;20232;7562;536185;248907;6.7;3.1
84;2021-03-11;29461;8193;565646;257100;7.0;3.2
84;2021-03-12;36180;7739;601826;264839;7.5;3.3
84;2021-03-13;21429;1895;623255;266734;7.8;3.3
84;2021-03-14;4685;483;627940;267217;7.8;3.3
84;2021-03-15;18869;4815;646809;272032;8.1;3.4
84;2021-03-16;17052;6121;663861;278153;8.3;3.5
84;2021-03-17;17578;6481;681439;284634;8.5;3.5
84;2021-03-18;21503;6972;702942;291606;8.8;3.6
84;2021-03-19;28977;5529;731919;297135;9.1;3.7
84;2021-03-20;14538;1417;746457;298552;9.3;3.7
84;2021-03-21;3239;278;749696;298830;9.3;3.7
84;2021-03-22;19736;5150;769432;303980;9.6;3.8
84;2021-03-23;30788;5985;800220;309965;10.0;3.9
84;2021-03-24;29959;5906;830179;315871;10.3;3.9
84;2021-03-25;41551;6532;871730;322403;10.9;4.0
84;2021-03-26;42973;6808;914703;329211;11.4;4.1
84;2021-03-27;18216;2942;932919;332153;11.6;4.1
84;2021-03-28;6507;603;939426;332756;11.7;4.1
84;2021-03-29;22946;7956;962372;340712;12.0;4.2
84;2021-03-30;34956;10249;997328;350961;12.4;4.4
84;2021-03-31;29583;11072;1026911;362033;12.8;4.5
84;2021-04-01;37265;11495;1064176;373528;13.2;4.7
84;2021-04-02;34880;11411;1099056;384939;13.7;4.8
84;2021-04-03;14795;6240;1113851;391179;13.9;4.9
84;2021-04-04;9929;2006;1123780;393185;14.0;4.9
84;2021-04-05;13533;1680;1137313;394865;14.2;4.9
84;2021-04-06;26288;13264;1163601;408129;14.5;5.1
84;2021-04-07;29489;14717;1193090;422846;14.9;5.3
84;2021-04-08;39673;15517;1232763;438363;15.3;5.5
84;2021-04-09;49433;15144;1282196;453507;16.0;5.6
84;2021-04-10;20459;8163;1302655;461670;16.2;5.7
84;2021-04-11;7228;2704;1309883;464374;16.3;5.8
84;2021-04-12;27297;15613;1337180;479987;16.6;6.0
84;2021-04-13;36125;19427;1373305;499414;17.1;6.2
84;2021-04-14;34621;18317;1407926;517731;17.5;6.4
84;2021-04-15;40111;19748;1448037;537479;18.0;6.7
84;2021-04-16;38205;20150;1486242;557629;18.5;6.9
84;2021-04-17;20467;9049;1506709;566678;18.8;7.1
84;2021-04-18;6840;2714;1513549;569392;18.8;7.1
84;2021-04-19;26224;18623;1539773;588015;19.2;7.3
84;2021-04-20;31197;22551;1570970;610566;19.6;7.6
84;2021-04-21;28029;21515;1598999;632081;19.9;7.9
84;2021-04-22;32237;22671;1631236;654752;20.3;8.2
84;2021-04-23;32685;23152;1663921;677904;20.7;8.4
84;2021-04-24;17855;11919;1681776;689823;20.9;8.6
84;2021-04-25;7131;4294;1688907;694117;21.0;8.6
84;2021-04-26;23711;20066;1712618;714183;21.3;8.9
84;2021-04-27;31752;25303;1744370;739486;21.7;9.2
84;2021-04-28;32474;24873;1776844;764359;22.1;9.5
84;2021-04-29;39634;26594;1816478;790953;22.6;9.8
84;2021-04-30;38133;27902;1854611;818855;23.1;10.2
84;2021-05-01;17158;5393;1871769;824248;23.3;10.3
84;2021-05-02;7975;8584;1879744;832832;23.4;10.4
84;2021-05-03;30355;27525;1910099;860357;23.8;10.7
84;2021-05-04;37138;33794;1947237;894151;24.2;11.1
84;2021-05-05;40229;30206;1987466;924357;24.7;11.5
84;2021-05-06;46590;32688;2034056;957045;25.3;11.9
84;2021-05-07;46985;36841;2081041;993886;25.9;12.4
84;2021-05-08;22352;7669;2103393;1001555;26.2;12.5
84;2021-05-09;15913;8915;2119306;1010470;26.4;12.6
84;2021-05-10;36083;32033;2155389;1042503;26.8;13.0
84;2021-05-11;52626;36318;2208015;1078821;27.5;13.4
84;2021-05-12;56905;31920;2264920;1110741;28.2;13.8
84;2021-05-13;47409;10538;2312329;1121279;28.8;14.0
84;2021-05-14;57473;25036;2369802;1146315;29.5;14.3
84;2021-05-15;44231;13654;2414033;1159969;30.1;14.4
84;2021-05-16;30605;5148;2444638;1165117;30.4;14.5
84;2021-05-17;48446;24992;2493084;1190109;31.0;14.8
84;2021-05-18;59141;27411;2552225;1217520;31.8;15.2
84;2021-05-19;58399;23576;2610624;1241096;32.5;15.5
84;2021-05-20;61677;27055;2672301;1268151;33.3;15.8
84;2021-05-21;60915;29405;2733216;1297556;34.0;16.2
84;2021-05-22;40420;12919;2773636;1310475;34.5;16.3
84;2021-05-23;21369;3983;2795005;1314458;34.8;16.4
84;2021-05-24;39901;8556;2834906;1323014;35.3;16.5
84;2021-05-25;50240;31697;2885146;1354711;35.9;16.9
84;2021-05-26;49728;28946;2934874;1383657;36.5;17.2
84;2021-05-27;55660;31851;2990534;1415508;37.2;17.6
84;2021-05-28;54769;40521;3045303;1456029;37.9;18.1
84;2021-05-29;37602;22383;3082905;1478412;38.4;18.4
84;2021-05-30;16113;7265;3099018;1485677;38.6;18.5
84;2021-05-31;44281;29432;3143299;1515109;39.1;18.9
84;2021-06-01;48291;36664;3191590;1551773;39.7;19.3
84;2021-06-02;47709;31246;3239299;1583019;40.3;19.7
84;2021-06-03;56021;36590;3295320;1619609;41.0;20.2
84;2021-06-04;54578;42399;3349898;1662008;41.7;20.7
84;2021-06-05;38047;21686;3387945;1683694;42.2;21.0
84;2021-06-06;15900;6291;3403845;1689985;42.4;21.0
84;2021-06-07;41300;35173;3445145;1725158;42.9;21.5
84;2021-06-08;44978;37925;3490123;1763083;43.5;21.9
84;2021-06-09;40506;33945;3530629;1797028;44.0;22.4
84;2021-06-10;41145;33856;3571774;1830884;44.5;22.8
84;2021-06-11;43241;46357;3615015;1877241;45.0;23.4
84;2021-06-12;28116;22943;3643131;1900184;45.4;23.7
84;2021-06-13;8601;7134;3651732;1907318;45.5;23.7
84;2021-06-14;25512;44547;3677244;1951865;45.8;24.3
84;2021-06-15;31566;49293;3708810;2001158;46.2;24.9
84;2021-06-16;33280;45436;3742090;2046594;46.6;25.5
84;2021-06-17;30475;46947;3772565;2093541;47.0;26.1
84;2021-06-18;34850;59937;3807415;2153478;47.4;26.8
84;2021-06-19;22741;35731;3830156;2189209;47.7;27.3
84;2021-06-20;8666;14415;3838822;2203624;47.8;27.4
84;2021-06-21;19915;56153;3858737;2259777;48.0;28.1
84;2021-06-22;20962;62736;3879699;2322513;48.3;28.9
84;2021-06-23;22224;57602;3901923;2380115;48.6;29.6
84;2021-06-24;23089;55074;3925012;2435189;48.9;30.3
84;2021-06-25;23426;70283;3948438;2505472;49.2;31.2
84;2021-06-26;13961;46196;3962399;2551668;49.3;31.8
84;2021-06-27;6845;23494;3969244;2575162;49.4;32.1
84;2021-06-28;15413;64678;3984657;2639840;49.6;32.9
93;2020-12-27;1;0;1;0;0.0;0.0
93;2020-12-28;2;0;3;0;0.0;0.0
93;2020-12-29;1;0;4;0;0.0;0.0
93;2020-12-30;3;0;7;0;0.0;0.0
93;2020-12-31;19;0;26;0;0.0;0.0
93;2021-01-01;13;0;39;0;0.0;0.0
93;2021-01-02;2;0;41;0;0.0;0.0
93;2021-01-03;2;0;43;0;0.0;0.0
93;2021-01-04;133;1;176;1;0.0;0.0
93;2021-01-05;251;1;427;2;0.0;0.0
93;2021-01-06;410;0;837;2;0.0;0.0
93;2021-01-07;1245;2;2082;4;0.0;0.0
93;2021-01-08;1563;2;3645;6;0.1;0.0
93;2021-01-09;541;1;4186;7;0.1;0.0
93;2021-01-10;74;0;4260;7;0.1;0.0
93;2021-01-11;2412;1;6672;8;0.1;0.0
93;2021-01-12;5092;7;11764;15;0.2;0.0
93;2021-01-13;4464;16;16228;31;0.3;0.0
93;2021-01-14;5580;51;21808;82;0.4;0.0
93;2021-01-15;4933;15;26741;97;0.5;0.0
93;2021-01-16;1679;5;28420;102;0.6;0.0
93;2021-01-17;300;1;28720;103;0.6;0.0
93;2021-01-18;7158;30;35878;133;0.7;0.0
93;2021-01-19;13529;36;49407;169;1.0;0.0
93;2021-01-20;12256;36;61663;205;1.2;0.0
93;2021-01-21;12309;49;73972;254;1.5;0.0
93;2021-01-22;10203;28;84175;282;1.7;0.0
93;2021-01-23;3327;6;87502;288;1.7;0.0
93;2021-01-24;537;4;88039;292;1.7;0.0
93;2021-01-25;7253;41;95292;333;1.9;0.0
93;2021-01-26;10068;138;105360;471;2.1;0.0
93;2021-01-27;9692;291;115052;762;2.3;0.0
93;2021-01-28;13668;833;128720;1595;2.5;0.0
93;2021-01-29;9847;982;138567;2577;2.7;0.1
93;2021-01-30;2240;159;140807;2736;2.8;0.1
93;2021-01-31;304;5;141111;2741;2.8;0.1
93;2021-02-01;5162;1518;146273;4259;2.9;0.1
93;2021-02-02;6646;2381;152919;6640;3.0;0.1
93;2021-02-03;5024;1822;157943;8462;3.1;0.2
93;2021-02-04;5534;3161;163477;11623;3.2;0.2
93;2021-02-05;6107;4129;169584;15752;3.4;0.3
93;2021-02-06;1246;973;170830;16725;3.4;0.3
93;2021-02-07;280;81;171110;16806;3.4;0.3
93;2021-02-08;4302;3748;175412;20554;3.5;0.4
93;2021-02-09;5890;7104;181302;27658;3.6;0.5
93;2021-02-10;5959;5887;187261;33545;3.7;0.7
93;2021-02-11;6601;6722;193862;40267;3.8;0.8
93;2021-02-12;5722;6477;199584;46744;3.9;0.9
93;2021-02-13;1128;1450;200712;48194;4.0;1.0
93;2021-02-14;73;384;200785;48578;4.0;1.0
93;2021-02-15;2414;5639;203199;54217;4.0;1.1
93;2021-02-16;3191;7710;206390;61927;4.1;1.2
93;2021-02-17;3604;8530;209994;70457;4.2;1.4
93;2021-02-18;6007;11425;216001;81882;4.3;1.6
93;2021-02-19;5642;8677;221643;90559;4.4;1.8
93;2021-02-20;879;1801;222522;92360;4.4;1.8
93;2021-02-21;70;417;222592;92777;4.4;1.8
93;2021-02-22;3029;6999;225621;99776;4.5;2.0
93;2021-02-23;3965;7246;229586;107022;4.5;2.1
93;2021-02-24;4749;6801;234335;113823;4.6;2.3
93;2021-02-25;8253;6669;242588;120492;4.8;2.4
93;2021-02-26;8278;6186;250866;126678;5.0;2.5
93;2021-02-27;3291;1490;254157;128168;5.0;2.5
93;2021-02-28;304;238;254461;128406;5.0;2.5
93;2021-03-01;5652;4492;260113;132898;5.1;2.6
93;2021-03-02;7220;5934;267333;138832;5.3;2.7
93;2021-03-03;8987;6559;276320;145391;5.5;2.9
93;2021-03-04;12067;6466;288387;151857;5.7;3.0
93;2021-03-05;12202;6103;300589;157960;5.9;3.1
93;2021-03-06;22877;1319;323466;159279;6.4;3.2
93;2021-03-07;17993;616;341459;159895;6.8;3.2
93;2021-03-08;10246;5280;351705;165175;7.0;3.3
93;2021-03-09;13959;5573;365664;170748;7.2;3.4
93;2021-03-10;14493;5285;380157;176033;7.5;3.5
93;2021-03-11;20394;6168;400551;182201;7.9;3.6
93;2021-03-12;21917;5319;422468;187520;8.4;3.7
93;2021-03-13;24599;1233;447067;188753;8.8;3.7
93;2021-03-14;6472;264;453539;189017;9.0;3.7
93;2021-03-15;15944;3110;469483;192127;9.3;3.8
93;2021-03-16;12720;3647;482203;195774;9.5;3.9
93;2021-03-17;15998;4648;498201;200422;9.9;4.0
93;2021-03-18;17035;4901;515236;205323;10.2;4.1
93;2021-03-19;21026;4705;536262;210028;10.6;4.2
93;2021-03-20;10991;1326;547253;211354;10.8;4.2
93;2021-03-21;3258;130;550511;211484;10.9;4.2
93;2021-03-22;17101;3559;567612;215043;11.2;4.3
93;2021-03-23;22659;3883;590271;218926;11.7;4.3
93;2021-03-24;21978;6638;612249;225564;12.1;4.5
93;2021-03-25;29022;6522;641271;232086;12.7;4.6
93;2021-03-26;29919;5038;671190;237124;13.3;4.7
93;2021-03-27;12454;1637;683644;238761;13.5;4.7
93;2021-03-28;3576;100;687220;238861;13.6;4.7
93;2021-03-29;18529;5335;705749;244196;14.0;4.8
93;2021-03-30;28508;6693;734257;250889;14.5;5.0
93;2021-03-31;28784;6644;763041;257533;15.1;5.1
93;2021-04-01;30747;7500;793788;265033;15.7;5.2
93;2021-04-02;26933;8497;820721;273530;16.2;5.4
93;2021-04-03;9767;4981;830488;278511;16.4;5.5
93;2021-04-04;2121;1252;832609;279763;16.5;5.5
93;2021-04-05;6060;1564;838669;281327;16.6;5.6
93;2021-04-06;23420;10028;862089;291355;17.1;5.8
93;2021-04-07;26076;11677;888165;303032;17.6;6.0
93;2021-04-08;28857;14984;917022;318016;18.1;6.3
93;2021-04-09;33613;14630;950635;332646;18.8;6.6
93;2021-04-10;14822;8174;965457;340820;19.1;6.7
93;2021-04-11;3634;2963;969091;343783;19.2;6.8
93;2021-04-12;20603;12213;989694;355996;19.6;7.0
93;2021-04-13;25590;15238;1015284;371234;20.1;7.3
93;2021-04-14;25184;15256;1040468;386490;20.6;7.6
93;2021-04-15;26996;15665;1067464;402155;21.1;8.0
93;2021-04-16;27903;16455;1095367;418610;21.7;8.3
93;2021-04-17;12832;7738;1108199;426348;21.9;8.4
93;2021-04-18;5253;2961;1113452;429309;22.0;8.5
93;2021-04-19;19088;15966;1132540;445275;22.4;8.8
93;2021-04-20;21344;18749;1153884;464024;22.8;9.2
93;2021-04-21;23907;18329;1177791;482353;23.3;9.5
93;2021-04-22;25846;19266;1203637;501619;23.8;9.9
93;2021-04-23;25386;18184;1229023;519803;24.3;10.3
93;2021-04-24;11543;8698;1240566;528501;24.5;10.5
93;2021-04-25;3208;2140;1243774;530641;24.6;10.5
93;2021-04-26;16460;15869;1260234;546510;24.9;10.8
93;2021-04-27;19452;20169;1279686;566679;25.3;11.2
93;2021-04-28;21500;20108;1301186;586787;25.7;11.6
93;2021-04-29;27897;21782;1329083;608569;26.3;12.0
93;2021-04-30;27291;20614;1356374;629183;26.8;12.4
93;2021-05-01;11714;5299;1368088;634482;27.1;12.5
93;2021-05-02;4062;1884;1372150;636366;27.1;12.6
93;2021-05-03;20467;18184;1392617;654550;27.5;12.9
93;2021-05-04;20786;22734;1413403;677284;28.0;13.4
93;2021-05-05;19493;21514;1432896;698798;28.3;13.8
93;2021-05-06;24791;21650;1457687;720448;28.8;14.3
93;2021-05-07;22412;25008;1480099;745456;29.3;14.7
93;2021-05-08;13534;6891;1493633;752347;29.5;14.9
93;2021-05-09;3465;2320;1497098;754667;29.6;14.9
93;2021-05-10;18661;22590;1515759;777257;30.0;15.4
93;2021-05-11;25368;25651;1541127;802908;30.5;15.9
93;2021-05-12;32507;22543;1573634;825451;31.1;16.3
93;2021-05-13;28047;7895;1601681;833346;31.7;16.5
93;2021-05-14;35397;16437;1637078;849783;32.4;16.8
93;2021-05-15;29674;10273;1666752;860056;33.0;17.0
93;2021-05-16;12784;2535;1679536;862591;33.2;17.1
93;2021-05-17;25789;17491;1705325;880082;33.7;17.4
93;2021-05-18;30308;16759;1735633;896841;34.3;17.7
93;2021-05-19;30109;15187;1765742;912028;34.9;18.0
93;2021-05-20;32787;16716;1798529;928744;35.6;18.4
93;2021-05-21;33687;17872;1832216;946616;36.2;18.7
93;2021-05-22;18574;7678;1850790;954294;36.6;18.9
93;2021-05-23;5916;2022;1856706;956316;36.7;18.9
93;2021-05-24;17583;4990;1874289;961306;37.1;19.0
93;2021-05-25;23538;20454;1897827;981760;37.5;19.4
93;2021-05-26;24558;21906;1922385;1003666;38.0;19.9
93;2021-05-27;26390;23312;1948775;1026978;38.5;20.3
93;2021-05-28;22800;26628;1971575;1053606;39.0;20.8
93;2021-05-29;13140;14363;1984715;1067969;39.3;21.1
93;2021-05-30;2588;3181;1987303;1071150;39.3;21.2
93;2021-05-31;20825;21303;2008128;1092453;39.7;21.6
93;2021-06-01;24369;26164;2032497;1118617;40.2;22.1
93;2021-06-02;22170;26102;2054667;1144719;40.6;22.6
93;2021-06-03;27574;27281;2082241;1172000;41.2;23.2
93;2021-06-04;27935;28338;2110176;1200338;41.7;23.7
93;2021-06-05;16271;14241;2126447;1214579;42.1;24.0
93;2021-06-06;4886;2795;2131333;1217374;42.2;24.1
93;2021-06-07;17622;24399;2148955;1241773;42.5;24.6
93;2021-06-08;20981;24097;2169936;1265870;42.9;25.0
93;2021-06-09;20631;25748;2190567;1291618;43.3;25.5
93;2021-06-10;21575;24682;2212142;1316300;43.8;26.0
93;2021-06-11;19676;30790;2231818;1347090;44.1;26.6
93;2021-06-12;12889;15304;2244707;1362394;44.4;26.9
93;2021-06-13;2548;3320;2247255;1365714;44.5;27.0
93;2021-06-14;13004;29362;2260259;1395076;44.7;27.6
93;2021-06-15;16406;30976;2276665;1426052;45.0;28.2
93;2021-06-16;16964;25625;2293629;1451677;45.4;28.7
93;2021-06-17;17076;28139;2310705;1479816;45.7;29.3
93;2021-06-18;16219;27985;2326924;1507801;46.0;29.8
93;2021-06-19;9667;15318;2336591;1523119;46.2;30.1
93;2021-06-20;2389;3700;2338980;1526819;46.3;30.2
93;2021-06-21;9861;30426;2348841;1557245;46.5;30.8
93;2021-06-22;11488;34427;2360329;1591672;46.7;31.5
93;2021-06-23;11376;32240;2371705;1623912;46.9;32.1
93;2021-06-24;12062;34055;2383767;1657967;47.2;32.8
93;2021-06-25;10928;37801;2394695;1695768;47.4;33.5
93;2021-06-26;6469;21652;2401164;1717420;47.5;34.0
93;2021-06-27;1974;5781;2403138;1723201;47.5;34.1
93;2021-06-28;7651;32532;2410789;1755733;47.7;34.7
94;2020-12-27;0;0;0;0;0.0;0.0
94;2020-12-28;0;0;0;0;0.0;0.0
94;2020-12-29;0;0;0;0;0.0;0.0
94;2020-12-30;0;0;0;0;0.0;0.0
94;2020-12-31;0;0;0;0;0.0;0.0
94;2021-01-01;0;0;0;0;0.0;0.0
94;2021-01-02;0;0;0;0;0.0;0.0
94;2021-01-03;0;0;0;0;0.0;0.0
94;2021-01-04;2;0;2;0;0.0;0.0
94;2021-01-05;0;0;2;0;0.0;0.0
94;2021-01-06;53;1;55;1;0.0;0.0
94;2021-01-07;333;1;388;2;0.1;0.0
94;2021-01-08;310;0;698;2;0.2;0.0
94;2021-01-09;78;0;776;2;0.2;0.0
94;2021-01-10;34;0;810;2;0.2;0.0
94;2021-01-11;152;2;962;4;0.3;0.0
94;2021-01-12;209;1;1171;5;0.3;0.0
94;2021-01-13;203;0;1374;5;0.4;0.0
94;2021-01-14;264;1;1638;6;0.5;0.0
94;2021-01-15;404;0;2042;6;0.6;0.0
94;2021-01-16;200;1;2242;7;0.7;0.0
94;2021-01-17;91;1;2333;8;0.7;0.0
94;2021-01-18;471;2;2804;10;0.8;0.0
94;2021-01-19;982;0;3786;10;1.1;0.0
94;2021-01-20;808;0;4594;10;1.3;0.0
94;2021-01-21;808;1;5402;11;1.6;0.0
94;2021-01-22;726;0;6128;11;1.8;0.0
94;2021-01-23;243;0;6371;11;1.8;0.0
94;2021-01-24;147;0;6518;11;1.9;0.0
94;2021-01-25;422;2;6940;13;2.0;0.0
94;2021-01-26;790;7;7730;20;2.2;0.0
94;2021-01-27;663;55;8393;75;2.4;0.0
94;2021-01-28;699;230;9092;305;2.6;0.1
94;2021-01-29;626;229;9718;534;2.8;0.2
94;2021-01-30;204;74;9922;608;2.9;0.2
94;2021-01-31;150;12;10072;620;2.9;0.2
94;2021-02-01;458;147;10530;767;3.1;0.2
94;2021-02-02;643;196;11173;963;3.2;0.3
94;2021-02-03;783;167;11956;1130;3.5;0.3
94;2021-02-04;714;298;12670;1428;3.7;0.4
94;2021-02-05;659;201;13329;1629;3.9;0.5
94;2021-02-06;207;75;13536;1704;3.9;0.5
94;2021-02-07;126;58;13662;1762;4.0;0.5
94;2021-02-08;322;366;13984;2128;4.1;0.6
94;2021-02-09;713;616;14697;2744;4.3;0.8
94;2021-02-10;643;430;15340;3174;4.5;0.9
94;2021-02-11;678;497;16018;3671;4.6;1.1
94;2021-02-12;641;428;16659;4099;4.8;1.2
94;2021-02-13;301;72;16960;4171;4.9;1.2
94;2021-02-14;195;78;17155;4249;5.0;1.2
94;2021-02-15;380;310;17535;4559;5.1;1.3
94;2021-02-16;634;604;18169;5163;5.3;1.5
94;2021-02-17;592;482;18761;5645;5.4;1.6
94;2021-02-18;550;545;19311;6190;5.6;1.8
94;2021-02-19;309;610;19620;6800;5.7;2.0
94;2021-02-20;275;200;19895;7000;5.8;2.0
94;2021-02-21;84;84;19979;7084;5.8;2.1
94;2021-02-22;211;406;20190;7490;5.9;2.2
94;2021-02-23;352;648;20542;8138;6.0;2.4
94;2021-02-24;298;609;20840;8747;6.0;2.5
94;2021-02-25;348;608;21188;9355;6.1;2.7
94;2021-02-26;420;555;21608;9910;6.3;2.9
94;2021-02-27;368;152;21976;10062;6.4;2.9
94;2021-02-28;70;123;22046;10185;6.4;3.0
94;2021-03-01;361;413;22407;10598;6.5;3.1
94;2021-03-02;549;655;22956;11253;6.7;3.3
94;2021-03-03;531;692;23487;11945;6.8;3.5
94;2021-03-04;950;635;24437;12580;7.1;3.6
94;2021-03-05;1584;675;26021;13255;7.5;3.8
94;2021-03-06;1843;164;27864;13419;8.1;3.9
94;2021-03-07;1381;100;29245;13519;8.5;3.9
94;2021-03-08;1228;324;30473;13843;8.8;4.0
94;2021-03-09;1313;656;31786;14499;9.2;4.2
94;2021-03-10;1259;578;33045;15077;9.6;4.4
94;2021-03-11;1307;635;34352;15712;10.0;4.6
94;2021-03-12;1517;541;35869;16253;10.4;4.7
94;2021-03-13;1118;303;36987;16556;10.7;4.8
94;2021-03-14;537;185;37524;16741;10.9;4.9
94;2021-03-15;886;400;38410;17141;11.1;5.0
94;2021-03-16;1065;641;39475;17782;11.5;5.2
94;2021-03-17;1225;530;40700;18312;11.8;5.3
94;2021-03-18;995;530;41695;18842;12.1;5.5
94;2021-03-19;1285;342;42980;19184;12.5;5.6
94;2021-03-20;1732;289;44712;19473;13.0;5.6
94;2021-03-21;1126;83;45838;19556;13.3;5.7
94;2021-03-22;889;188;46727;19744;13.6;5.7
94;2021-03-23;1302;319;48029;20063;13.9;5.8
94;2021-03-24;1687;306;49716;20369;14.4;5.9
94;2021-03-25;1753;296;51469;20665;14.9;6.0
94;2021-03-26;2031;345;53500;21010;15.5;6.1
94;2021-03-27;2271;228;55771;21238;16.2;6.2
94;2021-03-28;1070;217;56841;21455;16.5;6.2
94;2021-03-29;1024;312;57865;21767;16.8;6.3
94;2021-03-30;1352;556;59217;22323;17.2;6.5
94;2021-03-31;1428;488;60645;22811;17.6;6.6
94;2021-04-01;1639;679;62284;23490;18.1;6.8
94;2021-04-02;1863;1191;64147;24681;18.6;7.2
94;2021-04-03;1891;1128;66038;25809;19.2;7.5
94;2021-04-04;770;843;66808;26652;19.4;7.7
94;2021-04-05;629;806;67437;27458;19.6;8.0
94;2021-04-06;1580;913;69017;28371;20.0;8.2
94;2021-04-07;2008;849;71025;29220;20.6;8.5
94;2021-04-08;2174;756;73199;29976;21.2;8.7
94;2021-04-09;2099;948;75298;30924;21.8;9.0
94;2021-04-10;2402;625;77700;31549;22.5;9.2
94;2021-04-11;1173;315;78873;31864;22.9;9.2
94;2021-04-12;1517;896;80390;32760;23.3;9.5
94;2021-04-13;1384;1007;81774;33767;23.7;9.8
94;2021-04-14;2088;1075;83862;34842;24.3;10.1
94;2021-04-15;1922;1027;85784;35869;24.9;10.4
94;2021-04-16;1777;1038;87561;36907;25.4;10.7
94;2021-04-17;1750;1373;89311;38280;25.9;11.1
94;2021-04-18;1233;1280;90544;39560;26.3;11.5
94;2021-04-19;1089;772;91633;40332;26.6;11.7
94;2021-04-20;1249;1192;92882;41524;26.9;12.0
94;2021-04-21;1781;1333;94663;42857;27.5;12.4
94;2021-04-22;1832;1374;96495;44231;28.0;12.8
94;2021-04-23;1646;1403;98141;45634;28.5;13.2
94;2021-04-24;2031;1743;100172;47377;29.1;13.7
94;2021-04-25;1260;776;101432;48153;29.4;14.0
94;2021-04-26;1015;1145;102447;49298;29.7;14.3
94;2021-04-27;1308;1217;103755;50515;30.1;14.7
94;2021-04-28;2587;1273;106342;51788;30.9;15.0
94;2021-04-29;1968;1223;108310;53011;31.4;15.4
94;2021-04-30;2261;1878;110571;54889;32.1;15.9
94;2021-05-01;1423;1687;111994;56576;32.5;16.4
94;2021-05-02;1005;947;112999;57523;32.8;16.7
94;2021-05-03;1599;1066;114598;58589;33.2;17.0
94;2021-05-04;1557;1684;116155;60273;33.7;17.5
94;2021-05-05;1807;2357;117962;62630;34.2;18.2
94;2021-05-06;2187;1812;120149;64442;34.9;18.7
94;2021-05-07;2212;1817;122361;66259;35.5;19.2
94;2021-05-08;873;1353;123234;67612;35.8;19.6
94;2021-05-09;1174;1318;124408;68930;36.1;20.0
94;2021-05-10;1372;1537;125780;70467;36.5;20.4
94;2021-05-11;1579;1572;127359;72039;37.0;20.9
94;2021-05-12;1767;1376;129126;73415;37.5;21.3
94;2021-05-13;1940;514;131066;73929;38.0;21.4
94;2021-05-14;1512;1258;132578;75187;38.5;21.8
94;2021-05-15;1479;997;134057;76184;38.9;22.1
94;2021-05-16;1031;671;135088;76855;39.2;22.3
94;2021-05-17;1581;966;136669;77821;39.7;22.6
94;2021-05-18;1578;856;138247;78677;40.1;22.8
94;2021-05-19;1540;896;139787;79573;40.6;23.1
94;2021-05-20;1347;892;141134;80465;40.9;23.3
94;2021-05-21;1215;980;142349;81445;41.3;23.6
94;2021-05-22;1001;696;143350;82141;41.6;23.8
94;2021-05-23;683;328;144033;82469;41.8;23.9
94;2021-05-24;162;146;144195;82615;41.8;24.0
94;2021-05-25;951;856;145146;83471;42.1;24.2
94;2021-05-26;946;1953;146092;85424;42.4;24.8
94;2021-05-27;829;2244;146921;87668;42.6;25.4
94;2021-05-28;825;1822;147746;89490;42.9;26.0
94;2021-05-29;639;1252;148385;90742;43.1;26.3
94;2021-05-30;224;549;148609;91291;43.1;26.5
94;2021-05-31;551;1241;149160;92532;43.3;26.8
94;2021-06-01;731;1770;149891;94302;43.5;27.4
94;2021-06-02;609;1927;150500;96229;43.7;27.9
94;2021-06-03;780;1647;151280;97876;43.9;28.4
94;2021-06-04;604;2344;151884;100220;44.1;29.1
94;2021-06-05;553;1935;152437;102155;44.2;29.6
94;2021-06-06;214;1040;152651;103195;44.3;29.9
94;2021-06-07;436;1608;153087;104803;44.4;30.4
94;2021-06-08;690;1869;153777;106672;44.6;30.9
94;2021-06-09;795;2491;154572;109163;44.8;31.7
94;2021-06-10;669;1792;155241;110955;45.0;32.2
94;2021-06-11;689;2295;155930;113250;45.2;32.9
94;2021-06-12;352;1207;156282;114457;45.3;33.2
94;2021-06-13;202;854;156484;115311;45.4;33.5
94;2021-06-14;421;2037;156905;117348;45.5;34.0
94;2021-06-15;547;1724;157452;119072;45.7;34.5
94;2021-06-16;573;1711;158025;120783;45.8;35.0
94;2021-06-17;612;1637;158637;122420;46.0;35.5
94;2021-06-18;575;1877;159212;124297;46.2;36.1
94;2021-06-19;342;1014;159554;125311;46.3;36.4
94;2021-06-20;188;888;159742;126199;46.3;36.6
94;2021-06-21;435;1756;160177;127955;46.5;37.1
94;2021-06-22;536;1953;160713;129908;46.6;37.7
94;2021-06-23;401;1439;161114;131347;46.7;38.1
94;2021-06-24;463;1124;161577;132471;46.9;38.4
94;2021-06-25;359;1545;161936;134016;47.0;38.9
94;2021-06-26;298;1422;162234;135438;47.1;39.3
94;2021-06-27;199;1005;162433;136443;47.1;39.6
94;2021-06-28;504;1649;162937;138092;47.3;40.1
