fra;clage_vacsi;jour;n_dose1;n_complet;n_cum_dose1;n_cum_complet;couv_dose1;couv_complet
FR;04;2020-12-27;2;0;2;0;0.0;0.0
FR;04;2020-12-28;2;0;4;0;0.0;0.0
FR;04;2020-12-29;1;0;5;0;0.0;0.0
FR;04;2020-12-30;0;0;5;0;0.0;0.0
FR;04;2020-12-31;1;0;6;0;0.0;0.0
FR;04;2021-01-01;0;0;6;0;0.0;0.0
FR;04;2021-01-02;0;0;6;0;0.0;0.0
FR;04;2021-01-03;0;0;6;0;0.0;0.0
FR;04;2021-01-04;0;0;6;0;0.0;0.0
FR;04;2021-01-05;0;0;6;0;0.0;0.0
FR;04;2021-01-06;0;0;6;0;0.0;0.0
FR;04;2021-01-07;0;0;6;0;0.0;0.0
FR;04;2021-01-08;0;0;6;0;0.0;0.0
FR;04;2021-01-09;0;0;6;0;0.0;0.0
FR;04;2021-01-10;0;0;6;0;0.0;0.0
FR;04;2021-01-11;3;0;9;0;0.0;0.0
FR;04;2021-01-12;2;0;11;0;0.0;0.0
FR;04;2021-01-13;0;0;11;0;0.0;0.0
FR;04;2021-01-14;7;0;18;0;0.0;0.0
FR;04;2021-01-15;5;0;23;0;0.0;0.0
FR;04;2021-01-16;5;0;28;0;0.0;0.0
FR;04;2021-01-17;1;0;29;0;0.0;0.0
FR;04;2021-01-18;4;0;33;0;0.0;0.0
FR;04;2021-01-19;4;0;37;0;0.0;0.0
FR;04;2021-01-20;5;0;42;0;0.0;0.0
FR;04;2021-01-21;2;0;44;0;0.0;0.0
FR;04;2021-01-22;5;0;49;0;0.0;0.0
FR;04;2021-01-23;1;0;50;0;0.0;0.0
FR;04;2021-01-24;0;0;50;0;0.0;0.0
FR;04;2021-01-25;3;0;53;0;0.0;0.0
FR;04;2021-01-26;4;0;57;0;0.0;0.0
FR;04;2021-01-27;5;0;62;0;0.0;0.0
FR;04;2021-01-28;1;0;63;0;0.0;0.0
FR;04;2021-01-29;6;0;69;0;0.0;0.0
FR;04;2021-01-30;0;0;69;0;0.0;0.0
FR;04;2021-01-31;1;0;70;0;0.0;0.0
FR;04;2021-02-01;3;0;73;0;0.0;0.0
FR;04;2021-02-02;6;0;79;0;0.0;0.0
FR;04;2021-02-03;2;0;81;0;0.0;0.0
FR;04;2021-02-04;1;1;82;1;0.0;0.0
FR;04;2021-02-05;4;0;86;1;0.0;0.0
FR;04;2021-02-06;5;0;91;1;0.0;0.0
FR;04;2021-02-07;0;0;91;1;0.0;0.0
FR;04;2021-02-08;1;1;92;2;0.0;0.0
FR;04;2021-02-09;2;0;94;2;0.0;0.0
FR;04;2021-02-10;2;0;96;2;0.0;0.0
FR;04;2021-02-11;5;0;101;2;0.0;0.0
FR;04;2021-02-12;2;1;103;3;0.0;0.0
FR;04;2021-02-13;1;0;104;3;0.0;0.0
FR;04;2021-02-14;0;0;104;3;0.0;0.0
FR;04;2021-02-15;3;1;107;4;0.0;0.0
FR;04;2021-02-16;5;0;112;4;0.0;0.0
FR;04;2021-02-17;4;0;116;4;0.0;0.0
FR;04;2021-02-18;8;1;124;5;0.0;0.0
FR;04;2021-02-19;2;2;126;7;0.0;0.0
FR;04;2021-02-20;1;0;127;7;0.0;0.0
FR;04;2021-02-21;1;0;128;7;0.0;0.0
FR;04;2021-02-22;1;0;129;7;0.0;0.0
FR;04;2021-02-23;4;0;133;7;0.0;0.0
FR;04;2021-02-24;8;0;141;7;0.0;0.0
FR;04;2021-02-25;6;0;147;7;0.0;0.0
FR;04;2021-02-26;8;0;155;7;0.0;0.0
FR;04;2021-02-27;3;0;158;7;0.0;0.0
FR;04;2021-02-28;2;1;160;8;0.0;0.0
FR;04;2021-03-01;7;2;167;10;0.0;0.0
FR;04;2021-03-02;9;1;176;11;0.0;0.0
FR;04;2021-03-03;5;1;181;12;0.0;0.0
FR;04;2021-03-04;6;0;187;12;0.0;0.0
FR;04;2021-03-05;9;3;196;15;0.0;0.0
FR;04;2021-03-06;15;1;211;16;0.0;0.0
FR;04;2021-03-07;8;0;219;16;0.0;0.0
FR;04;2021-03-08;7;3;226;19;0.0;0.0
FR;04;2021-03-09;10;0;236;19;0.0;0.0
FR;04;2021-03-10;11;0;247;19;0.0;0.0
FR;04;2021-03-11;7;2;254;21;0.0;0.0
FR;04;2021-03-12;8;1;262;22;0.0;0.0
FR;04;2021-03-13;7;0;269;22;0.0;0.0
FR;04;2021-03-14;4;0;273;22;0.0;0.0
FR;04;2021-03-15;10;0;283;22;0.0;0.0
FR;04;2021-03-16;5;0;288;22;0.0;0.0
FR;04;2021-03-17;6;1;294;23;0.0;0.0
FR;04;2021-03-18;14;3;308;26;0.0;0.0
FR;04;2021-03-19;9;1;317;27;0.0;0.0
FR;04;2021-03-20;14;0;331;27;0.0;0.0
FR;04;2021-03-21;7;0;338;27;0.0;0.0
FR;04;2021-03-22;9;1;347;28;0.0;0.0
FR;04;2021-03-23;6;0;353;28;0.0;0.0
FR;04;2021-03-24;11;3;364;31;0.0;0.0
FR;04;2021-03-25;21;0;385;31;0.0;0.0
FR;04;2021-03-26;7;2;392;33;0.0;0.0
FR;04;2021-03-27;9;0;401;33;0.0;0.0
FR;04;2021-03-28;3;0;404;33;0.0;0.0
FR;04;2021-03-29;9;1;413;34;0.0;0.0
FR;04;2021-03-30;19;1;432;35;0.0;0.0
FR;04;2021-03-31;10;2;442;37;0.0;0.0
FR;04;2021-04-01;21;0;463;37;0.0;0.0
FR;04;2021-04-02;11;3;474;40;0.0;0.0
FR;04;2021-04-03;6;1;480;41;0.0;0.0
FR;04;2021-04-04;3;0;483;41;0.0;0.0
FR;04;2021-04-05;4;0;487;41;0.0;0.0
FR;04;2021-04-06;13;1;500;42;0.0;0.0
FR;04;2021-04-07;13;4;513;46;0.0;0.0
FR;04;2021-04-08;14;0;527;46;0.0;0.0
FR;04;2021-04-09;22;2;549;48;0.0;0.0
FR;04;2021-04-10;8;1;557;49;0.0;0.0
FR;04;2021-04-11;7;0;564;49;0.0;0.0
FR;04;2021-04-12;15;0;579;49;0.0;0.0
FR;04;2021-04-13;16;2;595;51;0.0;0.0
FR;04;2021-04-14;9;4;604;55;0.0;0.0
FR;04;2021-04-15;21;0;625;55;0.0;0.0
FR;04;2021-04-16;18;4;643;59;0.0;0.0
FR;04;2021-04-17;11;4;654;63;0.0;0.0
FR;04;2021-04-18;2;0;656;63;0.0;0.0
FR;04;2021-04-19;14;2;670;65;0.0;0.0
FR;04;2021-04-20;17;2;687;67;0.0;0.0
FR;04;2021-04-21;15;1;702;68;0.0;0.0
FR;04;2021-04-22;22;4;724;72;0.0;0.0
FR;04;2021-04-23;34;14;758;86;0.0;0.0
FR;04;2021-04-24;13;0;771;86;0.0;0.0
FR;04;2021-04-25;3;1;774;87;0.0;0.0
FR;04;2021-04-26;19;5;793;92;0.0;0.0
FR;04;2021-04-27;15;2;808;94;0.0;0.0
FR;04;2021-04-28;18;5;826;99;0.0;0.0
FR;04;2021-04-29;21;4;847;103;0.0;0.0
FR;04;2021-04-30;13;2;860;105;0.0;0.0
FR;04;2021-05-01;17;1;877;106;0.0;0.0
FR;04;2021-05-02;5;0;882;106;0.0;0.0
FR;04;2021-05-03;14;1;896;107;0.0;0.0
FR;04;2021-05-04;19;8;915;115;0.0;0.0
FR;04;2021-05-05;32;6;947;121;0.0;0.0
FR;04;2021-05-06;24;11;971;132;0.0;0.0
FR;04;2021-05-07;23;6;994;138;0.0;0.0
FR;04;2021-05-08;44;1;1038;139;0.0;0.0
FR;04;2021-05-09;8;1;1046;140;0.0;0.0
FR;04;2021-05-10;24;6;1070;146;0.0;0.0
FR;04;2021-05-11;29;8;1099;154;0.0;0.0
FR;04;2021-05-12;37;8;1136;162;0.0;0.0
FR;04;2021-05-13;49;4;1185;166;0.0;0.0
FR;04;2021-05-14;58;10;1243;176;0.0;0.0
FR;04;2021-05-15;38;1;1281;177;0.0;0.0
FR;04;2021-05-16;22;1;1303;178;0.0;0.0
FR;04;2021-05-17;27;5;1330;183;0.0;0.0
FR;04;2021-05-18;62;8;1392;191;0.0;0.0
FR;04;2021-05-19;43;5;1435;196;0.0;0.0
FR;04;2021-05-20;56;5;1491;201;0.0;0.0
FR;04;2021-05-21;55;10;1546;211;0.0;0.0
FR;04;2021-05-22;34;2;1580;213;0.0;0.0
FR;04;2021-05-23;15;1;1595;214;0.0;0.0
FR;04;2021-05-24;35;4;1630;218;0.0;0.0
FR;04;2021-05-25;46;7;1676;225;0.0;0.0
FR;04;2021-05-26;39;5;1715;230;0.0;0.0
FR;04;2021-05-27;55;9;1770;239;0.0;0.0
FR;04;2021-05-28;50;10;1820;249;0.0;0.0
FR;04;2021-05-29;31;4;1851;253;0.1;0.0
FR;04;2021-05-30;13;1;1864;254;0.1;0.0
FR;04;2021-05-31;50;10;1914;264;0.1;0.0
FR;04;2021-06-01;46;13;1960;277;0.1;0.0
FR;04;2021-06-02;31;8;1991;285;0.1;0.0
FR;04;2021-06-03;44;12;2035;297;0.1;0.0
FR;04;2021-06-04;50;8;2085;305;0.1;0.0
FR;04;2021-06-05;33;9;2118;314;0.1;0.0
FR;04;2021-06-06;18;3;2136;317;0.1;0.0
FR;04;2021-06-07;42;10;2178;327;0.1;0.0
FR;04;2021-06-08;43;9;2221;336;0.1;0.0
FR;04;2021-06-09;32;12;2253;348;0.1;0.0
FR;04;2021-06-10;44;8;2297;356;0.1;0.0
FR;04;2021-06-11;33;10;2330;366;0.1;0.0
FR;04;2021-06-12;21;8;2351;374;0.1;0.0
FR;04;2021-06-13;13;2;2364;376;0.1;0.0
FR;04;2021-06-14;37;11;2401;387;0.1;0.0
FR;04;2021-06-15;24;16;2425;403;0.1;0.0
FR;04;2021-06-16;39;15;2464;418;0.1;0.0
FR;04;2021-06-17;42;16;2506;434;0.1;0.0
FR;04;2021-06-18;26;20;2532;454;0.1;0.0
FR;04;2021-06-19;18;11;2550;465;0.1;0.0
FR;04;2021-06-20;16;3;2566;468;0.1;0.0
FR;04;2021-06-21;31;13;2597;481;0.1;0.0
FR;04;2021-06-22;34;15;2631;496;0.1;0.0
FR;04;2021-06-23;29;24;2660;520;0.1;0.0
FR;04;2021-06-24;30;22;2690;542;0.1;0.0
FR;04;2021-06-25;27;26;2717;568;0.1;0.0
FR;04;2021-06-26;26;12;2743;580;0.1;0.0
FR;04;2021-06-27;12;9;2755;589;0.1;0.0
FR;04;2021-06-28;23;26;2778;615;0.1;0.0
FR;04;2021-06-29;38;30;2816;645;0.1;0.0
FR;04;2021-06-30;35;11;2851;656;0.1;0.0
FR;04;2021-07-01;35;36;2886;692;0.1;0.0
FR;04;2021-07-02;30;22;2916;714;0.1;0.0
FR;04;2021-07-03;18;14;2934;728;0.1;0.0
FR;04;2021-07-04;7;5;2941;733;0.1;0.0
FR;04;2021-07-05;21;23;2962;756;0.1;0.0
FR;04;2021-07-06;19;22;2981;778;0.1;0.0
FR;04;2021-07-07;26;27;3007;805;0.1;0.0
FR;04;2021-07-08;31;26;3038;831;0.1;0.0
FR;04;2021-07-09;28;19;3066;850;0.1;0.0
FR;04;2021-07-10;16;13;3082;863;0.1;0.0
FR;04;2021-07-11;11;9;3093;872;0.1;0.0
FR;04;2021-07-12;26;19;3119;891;0.1;0.0
FR;04;2021-07-13;37;30;3156;921;0.1;0.0
FR;04;2021-07-14;18;11;3174;932;0.1;0.0
FR;04;2021-07-15;43;25;3217;957;0.1;0.0
FR;04;2021-07-16;45;32;3262;989;0.1;0.0
FR;04;2021-07-17;41;27;3303;1016;0.1;0.0
FR;04;2021-07-18;9;13;3312;1029;0.1;0.0
FR;04;2021-07-19;33;27;3345;1056;0.1;0.0
FR;04;2021-07-20;44;43;3389;1099;0.1;0.0
FR;04;2021-07-21;29;35;3418;1134;0.1;0.0
FR;04;2021-07-22;40;35;3458;1169;0.1;0.0
FR;04;2021-07-23;48;25;3506;1194;0.1;0.0
FR;04;2021-07-24;27;29;3533;1223;0.1;0.0
FR;04;2021-07-25;5;7;3538;1230;0.1;0.0
FR;04;2021-07-26;29;31;3567;1261;0.1;0.0
FR;04;2021-07-27;32;35;3599;1296;0.1;0.0
FR;04;2021-07-28;29;37;3628;1333;0.1;0.0
FR;04;2021-07-29;33;26;3661;1359;0.1;0.0
FR;04;2021-07-30;30;23;3691;1382;0.1;0.0
FR;04;2021-07-31;22;15;3713;1397;0.1;0.0
FR;04;2021-08-01;6;1;3719;1398;0.1;0.0
FR;04;2021-08-02;21;26;3740;1424;0.1;0.0
FR;04;2021-08-03;25;23;3765;1447;0.1;0.0
FR;04;2021-08-04;27;17;3792;1464;0.1;0.0
FR;04;2021-08-05;20;23;3812;1487;0.1;0.0
FR;04;2021-08-06;24;17;3836;1504;0.1;0.0
FR;04;2021-08-07;8;10;3844;1514;0.1;0.0
FR;04;2021-08-08;6;7;3850;1521;0.1;0.0
FR;04;2021-08-09;14;27;3864;1548;0.1;0.0
FR;04;2021-08-10;28;21;3892;1569;0.1;0.0
FR;04;2021-08-11;19;16;3911;1585;0.1;0.0
FR;04;2021-08-12;21;33;3932;1618;0.1;0.0
FR;04;2021-08-13;25;13;3957;1631;0.1;0.0
FR;04;2021-08-14;13;17;3970;1648;0.1;0.0
FR;04;2021-08-15;0;3;3970;1651;0.1;0.0
FR;04;2021-08-16;15;29;3985;1680;0.1;0.0
FR;04;2021-08-17;17;23;4002;1703;0.1;0.0
FR;04;2021-08-18;30;15;4032;1718;0.1;0.0
FR;04;2021-08-19;16;17;4048;1735;0.1;0.0
FR;04;2021-08-20;19;26;4067;1761;0.1;0.0
FR;04;2021-08-21;8;9;4075;1770;0.1;0.0
FR;04;2021-08-22;3;7;4078;1777;0.1;0.0
FR;04;2021-08-23;11;15;4089;1792;0.1;0.0
FR;11;2020-12-27;0;0;0;0;0.0;0.0
FR;11;2020-12-28;0;0;0;0;0.0;0.0
FR;11;2020-12-29;0;0;0;0;0.0;0.0
FR;11;2020-12-30;0;0;0;0;0.0;0.0
FR;11;2020-12-31;0;0;0;0;0.0;0.0
FR;11;2021-01-01;0;0;0;0;0.0;0.0
FR;11;2021-01-02;0;0;0;0;0.0;0.0
FR;11;2021-01-03;0;0;0;0;0.0;0.0
FR;11;2021-01-04;0;0;0;0;0.0;0.0
FR;11;2021-01-05;0;0;0;0;0.0;0.0
FR;11;2021-01-06;0;0;0;0;0.0;0.0
FR;11;2021-01-07;0;0;0;0;0.0;0.0
FR;11;2021-01-08;1;0;1;0;0.0;0.0
FR;11;2021-01-09;0;0;1;0;0.0;0.0
FR;11;2021-01-10;0;0;1;0;0.0;0.0
FR;11;2021-01-11;0;0;1;0;0.0;0.0
FR;11;2021-01-12;0;0;1;0;0.0;0.0
FR;11;2021-01-13;1;0;2;0;0.0;0.0
FR;11;2021-01-14;0;0;2;0;0.0;0.0
FR;11;2021-01-15;0;0;2;0;0.0;0.0
FR;11;2021-01-16;1;0;3;0;0.0;0.0
FR;11;2021-01-17;0;0;3;0;0.0;0.0
FR;11;2021-01-18;1;0;4;0;0.0;0.0
FR;11;2021-01-19;0;0;4;0;0.0;0.0
FR;11;2021-01-20;0;0;4;0;0.0;0.0
FR;11;2021-01-21;2;0;6;0;0.0;0.0
FR;11;2021-01-22;3;0;9;0;0.0;0.0
FR;11;2021-01-23;0;0;9;0;0.0;0.0
FR;11;2021-01-24;0;0;9;0;0.0;0.0
FR;11;2021-01-25;0;0;9;0;0.0;0.0
FR;11;2021-01-26;2;0;11;0;0.0;0.0
FR;11;2021-01-27;0;0;11;0;0.0;0.0
FR;11;2021-01-28;0;0;11;0;0.0;0.0
FR;11;2021-01-29;3;0;14;0;0.0;0.0
FR;11;2021-01-30;0;0;14;0;0.0;0.0
FR;11;2021-01-31;0;0;14;0;0.0;0.0
FR;11;2021-02-01;0;0;14;0;0.0;0.0
FR;11;2021-02-02;0;0;14;0;0.0;0.0
FR;11;2021-02-03;0;0;14;0;0.0;0.0
FR;11;2021-02-04;1;0;15;0;0.0;0.0
FR;11;2021-02-05;0;0;15;0;0.0;0.0
FR;11;2021-02-06;1;0;16;0;0.0;0.0
FR;11;2021-02-07;0;0;16;0;0.0;0.0
FR;11;2021-02-08;0;0;16;0;0.0;0.0
FR;11;2021-02-09;1;0;17;0;0.0;0.0
FR;11;2021-02-10;1;0;18;0;0.0;0.0
FR;11;2021-02-11;1;0;19;0;0.0;0.0
FR;11;2021-02-12;1;0;20;0;0.0;0.0
FR;11;2021-02-13;0;1;20;1;0.0;0.0
FR;11;2021-02-14;0;0;20;1;0.0;0.0
FR;11;2021-02-15;2;0;22;1;0.0;0.0
FR;11;2021-02-16;0;0;22;1;0.0;0.0
FR;11;2021-02-17;0;0;22;1;0.0;0.0
FR;11;2021-02-18;0;1;22;2;0.0;0.0
FR;11;2021-02-19;3;0;25;2;0.0;0.0
FR;11;2021-02-20;1;0;26;2;0.0;0.0
FR;11;2021-02-21;0;0;26;2;0.0;0.0
FR;11;2021-02-22;1;0;27;2;0.0;0.0
FR;11;2021-02-23;0;0;27;2;0.0;0.0
FR;11;2021-02-24;0;0;27;2;0.0;0.0
FR;11;2021-02-25;1;0;28;2;0.0;0.0
FR;11;2021-02-26;2;0;30;2;0.0;0.0
FR;11;2021-02-27;2;0;32;2;0.0;0.0
FR;11;2021-02-28;0;0;32;2;0.0;0.0
FR;11;2021-03-01;0;0;32;2;0.0;0.0
FR;11;2021-03-02;2;1;34;3;0.0;0.0
FR;11;2021-03-03;3;0;37;3;0.0;0.0
FR;11;2021-03-04;1;0;38;3;0.0;0.0
FR;11;2021-03-05;3;0;41;3;0.0;0.0
FR;11;2021-03-06;1;0;42;3;0.0;0.0
FR;11;2021-03-07;0;0;42;3;0.0;0.0
FR;11;2021-03-08;1;0;43;3;0.0;0.0
FR;11;2021-03-09;2;0;45;3;0.0;0.0
FR;11;2021-03-10;1;1;46;4;0.0;0.0
FR;11;2021-03-11;6;0;52;4;0.0;0.0
FR;11;2021-03-12;5;0;57;4;0.0;0.0
FR;11;2021-03-13;3;1;60;5;0.0;0.0
FR;11;2021-03-14;1;0;61;5;0.0;0.0
FR;11;2021-03-15;1;0;62;5;0.0;0.0
FR;11;2021-03-16;1;0;63;5;0.0;0.0
FR;11;2021-03-17;0;0;63;5;0.0;0.0
FR;11;2021-03-18;0;0;63;5;0.0;0.0
FR;11;2021-03-19;2;1;65;6;0.0;0.0
FR;11;2021-03-20;0;0;65;6;0.0;0.0
FR;11;2021-03-21;1;0;66;6;0.0;0.0
FR;11;2021-03-22;1;0;67;6;0.0;0.0
FR;11;2021-03-23;1;0;68;6;0.0;0.0
FR;11;2021-03-24;2;1;70;7;0.0;0.0
FR;11;2021-03-25;2;0;72;7;0.0;0.0
FR;11;2021-03-26;4;1;76;8;0.0;0.0
FR;11;2021-03-27;2;0;78;8;0.0;0.0
FR;11;2021-03-28;0;0;78;8;0.0;0.0
FR;11;2021-03-29;1;0;79;8;0.0;0.0
FR;11;2021-03-30;2;1;81;9;0.0;0.0
FR;11;2021-03-31;4;0;85;9;0.0;0.0
FR;11;2021-04-01;2;0;87;9;0.0;0.0
FR;11;2021-04-02;5;2;92;11;0.0;0.0
FR;11;2021-04-03;2;0;94;11;0.0;0.0
FR;11;2021-04-04;1;0;95;11;0.0;0.0
FR;11;2021-04-05;1;1;96;12;0.0;0.0
FR;11;2021-04-06;0;0;96;12;0.0;0.0
FR;11;2021-04-07;3;0;99;12;0.0;0.0
FR;11;2021-04-08;4;0;103;12;0.0;0.0
FR;11;2021-04-09;3;2;106;14;0.0;0.0
FR;11;2021-04-10;4;2;110;16;0.0;0.0
FR;11;2021-04-11;1;0;111;16;0.0;0.0
FR;11;2021-04-12;2;0;113;16;0.0;0.0
FR;11;2021-04-13;3;0;116;16;0.0;0.0
FR;11;2021-04-14;3;0;119;16;0.0;0.0
FR;11;2021-04-15;1;1;120;17;0.0;0.0
FR;11;2021-04-16;2;2;122;19;0.0;0.0
FR;11;2021-04-17;4;2;126;21;0.0;0.0
FR;11;2021-04-18;0;0;126;21;0.0;0.0
FR;11;2021-04-19;2;0;128;21;0.0;0.0
FR;11;2021-04-20;4;0;132;21;0.0;0.0
FR;11;2021-04-21;7;0;139;21;0.0;0.0
FR;11;2021-04-22;5;0;144;21;0.0;0.0
FR;11;2021-04-23;3;0;147;21;0.0;0.0
FR;11;2021-04-24;3;2;150;23;0.0;0.0
FR;11;2021-04-25;1;1;151;24;0.0;0.0
FR;11;2021-04-26;3;0;154;24;0.0;0.0
FR;11;2021-04-27;3;0;157;24;0.0;0.0
FR;11;2021-04-28;3;0;160;24;0.0;0.0
FR;11;2021-04-29;1;1;161;25;0.0;0.0
FR;11;2021-04-30;3;0;164;25;0.0;0.0
FR;11;2021-05-01;5;0;169;25;0.0;0.0
FR;11;2021-05-02;0;0;169;25;0.0;0.0
FR;11;2021-05-03;4;1;173;26;0.0;0.0
FR;11;2021-05-04;6;0;179;26;0.0;0.0
FR;11;2021-05-05;7;1;186;27;0.0;0.0
FR;11;2021-05-06;3;1;189;28;0.0;0.0
FR;11;2021-05-07;13;2;202;30;0.0;0.0
FR;11;2021-05-08;7;4;209;34;0.0;0.0
FR;11;2021-05-09;0;0;209;34;0.0;0.0
FR;11;2021-05-10;8;0;217;34;0.0;0.0
FR;11;2021-05-11;11;2;228;36;0.0;0.0
FR;11;2021-05-12;15;1;243;37;0.0;0.0
FR;11;2021-05-13;7;1;250;38;0.0;0.0
FR;11;2021-05-14;3;0;253;38;0.0;0.0
FR;11;2021-05-15;7;1;260;39;0.0;0.0
FR;11;2021-05-16;2;0;262;39;0.0;0.0
FR;11;2021-05-17;9;0;271;39;0.0;0.0
FR;11;2021-05-18;13;2;284;41;0.0;0.0
FR;11;2021-05-19;6;1;290;42;0.0;0.0
FR;11;2021-05-20;8;1;298;43;0.0;0.0
FR;11;2021-05-21;15;2;313;45;0.0;0.0
FR;11;2021-05-22;13;0;326;45;0.0;0.0
FR;11;2021-05-23;4;0;330;45;0.0;0.0
FR;11;2021-05-24;8;0;338;45;0.0;0.0
FR;11;2021-05-25;18;0;356;45;0.0;0.0
FR;11;2021-05-26;12;1;368;46;0.0;0.0
FR;11;2021-05-27;18;2;386;48;0.0;0.0
FR;11;2021-05-28;10;1;396;49;0.0;0.0
FR;11;2021-05-29;4;0;400;49;0.0;0.0
FR;11;2021-05-30;2;0;402;49;0.0;0.0
FR;11;2021-05-31;14;3;416;52;0.0;0.0
FR;11;2021-06-01;23;4;439;56;0.0;0.0
FR;11;2021-06-02;15;0;454;56;0.0;0.0
FR;11;2021-06-03;22;1;476;57;0.0;0.0
FR;11;2021-06-04;23;1;499;58;0.0;0.0
FR;11;2021-06-05;8;2;507;60;0.0;0.0
FR;11;2021-06-06;2;0;509;60;0.0;0.0
FR;11;2021-06-07;15;2;524;62;0.0;0.0
FR;11;2021-06-08;16;4;540;66;0.0;0.0
FR;11;2021-06-09;23;3;563;69;0.0;0.0
FR;11;2021-06-10;20;1;583;70;0.0;0.0
FR;11;2021-06-11;18;1;601;71;0.0;0.0
FR;11;2021-06-12;27;0;628;71;0.0;0.0
FR;11;2021-06-13;7;0;635;71;0.0;0.0
FR;11;2021-06-14;22;2;657;73;0.0;0.0
FR;11;2021-06-15;86;6;743;79;0.0;0.0
FR;11;2021-06-16;211;18;954;97;0.1;0.0
FR;11;2021-06-17;113;16;1067;113;0.1;0.0
FR;11;2021-06-18;117;14;1184;127;0.1;0.0
FR;11;2021-06-19;151;11;1335;138;0.1;0.0
FR;11;2021-06-20;36;6;1371;144;0.1;0.0
FR;11;2021-06-21;75;6;1446;150;0.1;0.0
FR;11;2021-06-22;68;4;1514;154;0.1;0.0
FR;11;2021-06-23;120;16;1634;170;0.1;0.0
FR;11;2021-06-24;96;13;1730;183;0.1;0.0
FR;11;2021-06-25;75;7;1805;190;0.1;0.0
FR;11;2021-06-26;71;12;1876;202;0.1;0.0
FR;11;2021-06-27;26;6;1902;208;0.1;0.0
FR;11;2021-06-28;80;5;1982;213;0.1;0.0
FR;11;2021-06-29;94;10;2076;223;0.1;0.0
FR;11;2021-06-30;108;4;2184;227;0.1;0.0
FR;11;2021-07-01;103;9;2287;236;0.1;0.0
FR;11;2021-07-02;113;19;2400;255;0.1;0.0
FR;11;2021-07-03;56;17;2456;272;0.1;0.0
FR;11;2021-07-04;18;2;2474;274;0.1;0.0
FR;11;2021-07-05;79;12;2553;286;0.2;0.0
FR;11;2021-07-06;79;16;2632;302;0.2;0.0
FR;11;2021-07-07;119;40;2751;342;0.2;0.0
FR;11;2021-07-08;95;34;2846;376;0.2;0.0
FR;11;2021-07-09;99;54;2945;430;0.2;0.0
FR;11;2021-07-10;73;49;3018;479;0.2;0.0
FR;11;2021-07-11;24;14;3042;493;0.2;0.0
FR;11;2021-07-12;71;43;3113;536;0.2;0.0
FR;11;2021-07-13;136;65;3249;601;0.2;0.0
FR;11;2021-07-14;106;48;3355;649;0.2;0.0
FR;11;2021-07-15;180;93;3535;742;0.2;0.0
FR;11;2021-07-16;171;85;3706;827;0.2;0.0
FR;11;2021-07-17;125;66;3831;893;0.2;0.1
FR;11;2021-07-18;45;28;3876;921;0.2;0.1
FR;11;2021-07-19;131;84;4007;1005;0.2;0.1
FR;11;2021-07-20;166;102;4173;1107;0.2;0.1
FR;11;2021-07-21;204;135;4377;1242;0.3;0.1
FR;11;2021-07-22;165;92;4542;1334;0.3;0.1
FR;11;2021-07-23;175;111;4717;1445;0.3;0.1
FR;11;2021-07-24;137;80;4854;1525;0.3;0.1
FR;11;2021-07-25;63;38;4917;1563;0.3;0.1
FR;11;2021-07-26;142;106;5059;1669;0.3;0.1
FR;11;2021-07-27;172;109;5231;1778;0.3;0.1
FR;11;2021-07-28;181;140;5412;1918;0.3;0.1
FR;11;2021-07-29;234;116;5646;2034;0.3;0.1
FR;11;2021-07-30;238;118;5884;2152;0.4;0.1
FR;11;2021-07-31;169;103;6053;2255;0.4;0.1
FR;11;2021-08-01;79;29;6132;2284;0.4;0.1
FR;11;2021-08-02;184;121;6316;2405;0.4;0.1
FR;11;2021-08-03;251;101;6567;2506;0.4;0.1
FR;11;2021-08-04;219;108;6786;2614;0.4;0.2
FR;11;2021-08-05;215;116;7001;2730;0.4;0.2
FR;11;2021-08-06;218;125;7219;2855;0.4;0.2
FR;11;2021-08-07;155;87;7374;2942;0.4;0.2
FR;11;2021-08-08;43;23;7417;2965;0.4;0.2
FR;11;2021-08-09;176;139;7593;3104;0.5;0.2
FR;11;2021-08-10;203;116;7796;3220;0.5;0.2
FR;11;2021-08-11;179;125;7975;3345;0.5;0.2
FR;11;2021-08-12;167;127;8142;3472;0.5;0.2
FR;11;2021-08-13;171;110;8313;3582;0.5;0.2
FR;11;2021-08-14;120;96;8433;3678;0.5;0.2
FR;11;2021-08-15;17;20;8450;3698;0.5;0.2
FR;11;2021-08-16;132;151;8582;3849;0.5;0.2
FR;11;2021-08-17;159;140;8741;3989;0.5;0.2
FR;11;2021-08-18;138;163;8879;4152;0.5;0.2
FR;11;2021-08-19;142;125;9021;4277;0.5;0.3
FR;11;2021-08-20;144;189;9165;4466;0.5;0.3
FR;11;2021-08-21;105;133;9270;4599;0.6;0.3
FR;11;2021-08-22;34;50;9304;4649;0.6;0.3
FR;11;2021-08-23;119;210;9423;4859;0.6;0.3
FR;17;2020-12-27;1;0;1;0;0.0;0.0
FR;17;2020-12-28;2;0;3;0;0.0;0.0
FR;17;2020-12-29;0;0;3;0;0.0;0.0
FR;17;2020-12-30;0;0;3;0;0.0;0.0
FR;17;2020-12-31;0;0;3;0;0.0;0.0
FR;17;2021-01-01;0;0;3;0;0.0;0.0
FR;17;2021-01-02;1;0;4;0;0.0;0.0
FR;17;2021-01-03;2;0;6;0;0.0;0.0
FR;17;2021-01-04;1;0;7;0;0.0;0.0
FR;17;2021-01-05;1;0;8;0;0.0;0.0
FR;17;2021-01-06;2;0;10;0;0.0;0.0
FR;17;2021-01-07;2;0;12;0;0.0;0.0
FR;17;2021-01-08;6;1;18;1;0.0;0.0
FR;17;2021-01-09;3;0;21;1;0.0;0.0
FR;17;2021-01-10;3;0;24;1;0.0;0.0
FR;17;2021-01-11;1;0;25;1;0.0;0.0
FR;17;2021-01-12;2;0;27;1;0.0;0.0
FR;17;2021-01-13;9;0;36;1;0.0;0.0
FR;17;2021-01-14;10;0;46;1;0.0;0.0
FR;17;2021-01-15;15;0;61;1;0.0;0.0
FR;17;2021-01-16;5;0;66;1;0.0;0.0
FR;17;2021-01-17;5;0;71;1;0.0;0.0
FR;17;2021-01-18;8;0;79;1;0.0;0.0
FR;17;2021-01-19;13;0;92;1;0.0;0.0
FR;17;2021-01-20;8;0;100;1;0.0;0.0
FR;17;2021-01-21;26;0;126;1;0.0;0.0
FR;17;2021-01-22;9;0;135;1;0.0;0.0
FR;17;2021-01-23;10;0;145;1;0.0;0.0
FR;17;2021-01-24;5;0;150;1;0.0;0.0
FR;17;2021-01-25;17;0;167;1;0.0;0.0
FR;17;2021-01-26;22;0;189;1;0.0;0.0
FR;17;2021-01-27;24;0;213;1;0.0;0.0
FR;17;2021-01-28;16;1;229;2;0.0;0.0
FR;17;2021-01-29;21;1;250;3;0.0;0.0
FR;17;2021-01-30;11;2;261;5;0.0;0.0
FR;17;2021-01-31;3;1;264;6;0.0;0.0
FR;17;2021-02-01;14;1;278;7;0.0;0.0
FR;17;2021-02-02;17;2;295;9;0.0;0.0
FR;17;2021-02-03;21;2;316;11;0.0;0.0
FR;17;2021-02-04;12;6;328;17;0.0;0.0
FR;17;2021-02-05;9;2;337;19;0.0;0.0
FR;17;2021-02-06;6;1;343;20;0.0;0.0
FR;17;2021-02-07;4;2;347;22;0.0;0.0
FR;17;2021-02-08;13;6;360;28;0.0;0.0
FR;17;2021-02-09;13;2;373;30;0.0;0.0
FR;17;2021-02-10;25;5;398;35;0.0;0.0
FR;17;2021-02-11;19;6;417;41;0.0;0.0
FR;17;2021-02-12;21;2;438;43;0.0;0.0
FR;17;2021-02-13;8;5;446;48;0.0;0.0
FR;17;2021-02-14;5;0;451;48;0.0;0.0
FR;17;2021-02-15;9;6;460;54;0.0;0.0
FR;17;2021-02-16;19;10;479;64;0.0;0.0
FR;17;2021-02-17;11;5;490;69;0.0;0.0
FR;17;2021-02-18;11;7;501;76;0.0;0.0
FR;17;2021-02-19;23;11;524;87;0.0;0.0
FR;17;2021-02-20;8;8;532;95;0.0;0.0
FR;17;2021-02-21;9;0;541;95;0.0;0.0
FR;17;2021-02-22;6;6;547;101;0.0;0.0
FR;17;2021-02-23;25;11;572;112;0.0;0.0
FR;17;2021-02-24;18;7;590;119;0.0;0.0
FR;17;2021-02-25;26;14;616;133;0.0;0.0
FR;17;2021-02-26;36;13;652;146;0.0;0.0
FR;17;2021-02-27;19;8;671;154;0.0;0.0
FR;17;2021-02-28;12;1;683;155;0.0;0.0
FR;17;2021-03-01;21;10;704;165;0.0;0.0
FR;17;2021-03-02;27;11;731;176;0.0;0.0
FR;17;2021-03-03;29;24;760;200;0.0;0.0
FR;17;2021-03-04;38;13;798;213;0.0;0.0
FR;17;2021-03-05;43;6;841;219;0.0;0.0
FR;17;2021-03-06;55;4;896;223;0.0;0.0
FR;17;2021-03-07;38;0;934;223;0.0;0.0
FR;17;2021-03-08;26;7;960;230;0.0;0.0
FR;17;2021-03-09;45;7;1005;237;0.0;0.0
FR;17;2021-03-10;52;14;1057;251;0.0;0.0
FR;17;2021-03-11;47;9;1104;260;0.0;0.0
FR;17;2021-03-12;77;9;1181;269;0.0;0.0
FR;17;2021-03-13;59;9;1240;278;0.0;0.0
FR;17;2021-03-14;32;2;1272;280;0.0;0.0
FR;17;2021-03-15;40;8;1312;288;0.0;0.0
FR;17;2021-03-16;27;10;1339;298;0.0;0.0
FR;17;2021-03-17;55;11;1394;309;0.0;0.0
FR;17;2021-03-18;35;12;1429;321;0.0;0.0
FR;17;2021-03-19;39;9;1468;330;0.0;0.0
FR;17;2021-03-20;49;2;1517;332;0.0;0.0
FR;17;2021-03-21;9;0;1526;332;0.0;0.0
FR;17;2021-03-22;45;7;1571;339;0.0;0.0
FR;17;2021-03-23;65;13;1636;352;0.0;0.0
FR;17;2021-03-24;51;8;1687;360;0.0;0.0
FR;17;2021-03-25;61;14;1748;374;0.0;0.0
FR;17;2021-03-26;63;10;1811;384;0.0;0.0
FR;17;2021-03-27;58;4;1869;388;0.0;0.0
FR;17;2021-03-28;20;0;1889;388;0.0;0.0
FR;17;2021-03-29;32;6;1921;394;0.0;0.0
FR;17;2021-03-30;56;14;1977;408;0.0;0.0
FR;17;2021-03-31;78;12;2055;420;0.0;0.0
FR;17;2021-04-01;73;8;2128;428;0.0;0.0
FR;17;2021-04-02;71;24;2199;452;0.0;0.0
FR;17;2021-04-03;50;12;2249;464;0.0;0.0
FR;17;2021-04-04;24;5;2273;469;0.0;0.0
FR;17;2021-04-05;25;4;2298;473;0.0;0.0
FR;17;2021-04-06;69;36;2367;509;0.0;0.0
FR;17;2021-04-07;88;27;2455;536;0.0;0.0
FR;17;2021-04-08;93;19;2548;555;0.1;0.0
FR;17;2021-04-09;110;23;2658;578;0.1;0.0
FR;17;2021-04-10;73;20;2731;598;0.1;0.0
FR;17;2021-04-11;26;15;2757;613;0.1;0.0
FR;17;2021-04-12;60;26;2817;639;0.1;0.0
FR;17;2021-04-13;72;27;2889;666;0.1;0.0
FR;17;2021-04-14;84;25;2973;691;0.1;0.0
FR;17;2021-04-15;90;23;3063;714;0.1;0.0
FR;17;2021-04-16;96;24;3159;738;0.1;0.0
FR;17;2021-04-17;63;35;3222;773;0.1;0.0
FR;17;2021-04-18;31;5;3253;778;0.1;0.0
FR;17;2021-04-19;64;18;3317;796;0.1;0.0
FR;17;2021-04-20;65;40;3382;836;0.1;0.0
FR;17;2021-04-21;75;42;3457;878;0.1;0.0
FR;17;2021-04-22;94;29;3551;907;0.1;0.0
FR;17;2021-04-23;97;46;3648;953;0.1;0.0
FR;17;2021-04-24;52;26;3700;979;0.1;0.0
FR;17;2021-04-25;39;7;3739;986;0.1;0.0
FR;17;2021-04-26;69;19;3808;1005;0.1;0.0
FR;17;2021-04-27;66;30;3874;1035;0.1;0.0
FR;17;2021-04-28;96;41;3970;1076;0.1;0.0
FR;17;2021-04-29;109;39;4079;1115;0.1;0.0
FR;17;2021-04-30;140;50;4219;1165;0.1;0.0
FR;17;2021-05-01;81;13;4300;1178;0.1;0.0
FR;17;2021-05-02;52;16;4352;1194;0.1;0.0
FR;17;2021-05-03;93;25;4445;1219;0.1;0.0
FR;17;2021-05-04;118;52;4563;1271;0.1;0.0
FR;17;2021-05-05;148;62;4711;1333;0.1;0.0
FR;17;2021-05-06;176;75;4887;1408;0.1;0.0
FR;17;2021-05-07;240;76;5127;1484;0.1;0.0
FR;17;2021-05-08;359;38;5486;1522;0.1;0.0
FR;17;2021-05-09;215;23;5701;1545;0.1;0.0
FR;17;2021-05-10;311;36;6012;1581;0.1;0.0
FR;17;2021-05-11;452;60;6464;1641;0.1;0.0
FR;17;2021-05-12;667;91;7131;1732;0.1;0.0
FR;17;2021-05-13;769;53;7900;1785;0.2;0.0
FR;17;2021-05-14;868;68;8768;1853;0.2;0.0
FR;17;2021-05-15;974;72;9742;1925;0.2;0.0
FR;17;2021-05-16;586;46;10328;1971;0.2;0.0
FR;17;2021-05-17;578;57;10906;2028;0.2;0.0
FR;17;2021-05-18;739;49;11645;2077;0.2;0.0
FR;17;2021-05-19;1165;116;12810;2193;0.3;0.0
FR;17;2021-05-20;1043;94;13853;2287;0.3;0.0
FR;17;2021-05-21;1180;110;15033;2397;0.3;0.0
FR;17;2021-05-22;1326;96;16359;2493;0.3;0.0
FR;17;2021-05-23;619;50;16978;2543;0.3;0.1
FR;17;2021-05-24;1031;77;18009;2620;0.4;0.1
FR;17;2021-05-25;1094;128;19103;2748;0.4;0.1
FR;17;2021-05-26;1720;161;20823;2909;0.4;0.1
FR;17;2021-05-27;1356;138;22179;3047;0.4;0.1
FR;17;2021-05-28;1495;174;23674;3221;0.5;0.1
FR;17;2021-05-29;1739;167;25413;3388;0.5;0.1
FR;17;2021-05-30;651;47;26064;3435;0.5;0.1
FR;17;2021-05-31;1232;120;27296;3555;0.5;0.1
FR;17;2021-06-01;1632;158;28928;3713;0.6;0.1
FR;17;2021-06-02;2524;209;31452;3922;0.6;0.1
FR;17;2021-06-03;2120;217;33572;4139;0.7;0.1
FR;17;2021-06-04;2539;260;36111;4399;0.7;0.1
FR;17;2021-06-05;2638;282;38749;4681;0.8;0.1
FR;17;2021-06-06;1399;143;40148;4824;0.8;0.1
FR;17;2021-06-07;2600;219;42748;5043;0.9;0.1
FR;17;2021-06-08;3266;326;46014;5369;0.9;0.1
FR;17;2021-06-09;5284;523;51298;5892;1.0;0.1
FR;17;2021-06-10;4330;428;55628;6320;1.1;0.1
FR;17;2021-06-11;4672;534;60300;6854;1.2;0.1
FR;17;2021-06-12;5494;574;65794;7428;1.3;0.1
FR;17;2021-06-13;2456;280;68250;7708;1.4;0.2
FR;17;2021-06-14;4225;465;72475;8173;1.5;0.2
FR;17;2021-06-15;34958;2152;107433;10325;2.2;0.2
FR;17;2021-06-16;61659;3841;169092;14166;3.4;0.3
FR;17;2021-06-17;39579;2804;208671;16970;4.2;0.3
FR;17;2021-06-18;57882;4388;266553;21358;5.3;0.4
FR;17;2021-06-19;54391;4144;320944;25502;6.4;0.5
FR;17;2021-06-20;19197;1690;340141;27192;6.8;0.5
FR;17;2021-06-21;33476;2770;373617;29962;7.5;0.6
FR;17;2021-06-22;33235;3119;406852;33081;8.1;0.7
FR;17;2021-06-23;55640;5166;462492;38247;9.3;0.8
FR;17;2021-06-24;36500;3877;498992;42124;10.0;0.8
FR;17;2021-06-25;37198;4294;536190;46418;10.7;0.9
FR;17;2021-06-26;32486;4017;568676;50435;11.4;1.0
FR;17;2021-06-27;12245;1715;580921;52150;11.6;1.0
FR;17;2021-06-28;26638;3306;607559;55456;12.2;1.1
FR;17;2021-06-29;30565;4055;638124;59511;12.8;1.2
FR;17;2021-06-30;51714;6531;689838;66042;13.8;1.3
FR;17;2021-07-01;41114;5600;730952;71642;14.6;1.4
FR;17;2021-07-02;37867;5839;768819;77481;15.4;1.6
FR;17;2021-07-03;29147;4821;797966;82302;16.0;1.6
FR;17;2021-07-04;12563;2287;810529;84589;16.2;1.7
FR;17;2021-07-05;30634;5201;841163;89790;16.8;1.8
FR;17;2021-07-06;31862;6834;873025;96624;17.5;1.9
FR;17;2021-07-07;41920;11551;914945;108175;18.3;2.2
FR;17;2021-07-08;38344;13830;953289;122005;19.1;2.4
FR;17;2021-07-09;34282;18064;987571;140069;19.8;2.8
FR;17;2021-07-10;24690;15732;1012261;155801;20.3;3.1
FR;17;2021-07-11;11058;6651;1023319;162452;20.5;3.3
FR;17;2021-07-12;27684;20057;1051003;182509;21.1;3.7
FR;17;2021-07-13;43849;23551;1094852;206060;21.9;4.1
FR;17;2021-07-14;33206;14787;1128058;220847;22.6;4.4
FR;17;2021-07-15;51194;31419;1179252;252266;23.6;5.1
FR;17;2021-07-16;50517;31401;1229769;283667;24.6;5.7
FR;17;2021-07-17;38065;22679;1267834;306346;25.4;6.1
FR;17;2021-07-18;17954;9965;1285788;316311;25.8;6.3
FR;17;2021-07-19;41646;30527;1327434;346838;26.6;6.9
FR;17;2021-07-20;51821;37392;1379255;384230;27.6;7.7
FR;17;2021-07-21;60005;52811;1439260;437041;28.8;8.8
FR;17;2021-07-22;59524;45060;1498784;482101;30.0;9.7
FR;17;2021-07-23;56043;50130;1554827;532231;31.1;10.7
FR;17;2021-07-24;39307;38064;1594134;570295;31.9;11.4
FR;17;2021-07-25;18996;14159;1613130;584454;32.3;11.7
FR;17;2021-07-26;51807;54036;1664937;638490;33.3;12.8
FR;17;2021-07-27;64949;49002;1729886;687492;34.6;13.8
FR;17;2021-07-28;70275;57129;1800161;744621;36.1;14.9
FR;17;2021-07-29;72530;46013;1872691;790634;37.5;15.8
FR;17;2021-07-30;68959;50201;1941650;840835;38.9;16.8
FR;17;2021-07-31;46906;35715;1988556;876550;39.8;17.6
FR;17;2021-08-01;20812;10774;2009368;887324;40.2;17.8
FR;17;2021-08-02;61413;51860;2070781;939184;41.5;18.8
FR;17;2021-08-03;69980;45250;2140761;984434;42.9;19.7
FR;17;2021-08-04;73189;43782;2213950;1028216;44.3;20.6
FR;17;2021-08-05;64701;38962;2278651;1067178;45.6;21.4
FR;17;2021-08-06;59805;42531;2338456;1109709;46.8;22.2
FR;17;2021-08-07;37934;29512;2376390;1139221;47.6;22.8
FR;17;2021-08-08;14441;10475;2390831;1149696;47.9;23.0
FR;17;2021-08-09;48358;47644;2439189;1197340;48.9;24.0
FR;17;2021-08-10;52828;44651;2492017;1241991;49.9;24.9
FR;17;2021-08-11;49915;44331;2541932;1286322;50.9;25.8
FR;17;2021-08-12;43623;41781;2585555;1328103;51.8;26.6
FR;17;2021-08-13;40031;40514;2625586;1368617;52.6;27.4
FR;17;2021-08-14;26036;29331;2651622;1397948;53.1;28.0
FR;17;2021-08-15;7393;7708;2659015;1405656;53.3;28.2
FR;17;2021-08-16;36694;56666;2695709;1462322;54.0;29.3
FR;17;2021-08-17;40217;52564;2735926;1514886;54.8;30.3
FR;17;2021-08-18;40983;54867;2776909;1569753;55.6;31.4
FR;17;2021-08-19;35506;49398;2812415;1619151;56.3;32.4
FR;17;2021-08-20;35404;57486;2847819;1676637;57.0;33.6
FR;17;2021-08-21;23505;41264;2871324;1717901;57.5;34.4
FR;17;2021-08-22;8389;16664;2879713;1734565;57.7;34.7
FR;17;2021-08-23;34631;74789;2914344;1809354;58.4;36.2
FR;24;2020-12-27;5;0;5;0;0.0;0.0
FR;24;2020-12-28;7;0;12;0;0.0;0.0
FR;24;2020-12-29;1;0;13;0;0.0;0.0
FR;24;2020-12-30;3;0;16;0;0.0;0.0
FR;24;2020-12-31;5;0;21;0;0.0;0.0
FR;24;2021-01-01;6;0;27;0;0.0;0.0
FR;24;2021-01-02;5;1;32;1;0.0;0.0
FR;24;2021-01-03;5;0;37;1;0.0;0.0
FR;24;2021-01-04;19;0;56;1;0.0;0.0
FR;24;2021-01-05;23;1;79;2;0.0;0.0
FR;24;2021-01-06;44;1;123;3;0.0;0.0
FR;24;2021-01-07;185;0;308;3;0.0;0.0
FR;24;2021-01-08;221;1;529;4;0.0;0.0
FR;24;2021-01-09;43;2;572;6;0.0;0.0
FR;24;2021-01-10;38;0;610;6;0.0;0.0
FR;24;2021-01-11;261;2;871;8;0.0;0.0
FR;24;2021-01-12;413;6;1284;14;0.0;0.0
FR;24;2021-01-13;487;6;1771;20;0.0;0.0
FR;24;2021-01-14;654;12;2425;32;0.0;0.0
FR;24;2021-01-15;617;5;3042;37;0.1;0.0
FR;24;2021-01-16;122;4;3164;41;0.1;0.0
FR;24;2021-01-17;101;1;3265;42;0.1;0.0
FR;24;2021-01-18;528;6;3793;48;0.1;0.0
FR;24;2021-01-19;633;11;4426;59;0.1;0.0
FR;24;2021-01-20;672;3;5098;62;0.1;0.0
FR;24;2021-01-21;785;9;5883;71;0.1;0.0
FR;24;2021-01-22;622;7;6505;78;0.1;0.0
FR;24;2021-01-23;128;0;6633;78;0.1;0.0
FR;24;2021-01-24;34;0;6667;78;0.1;0.0
FR;24;2021-01-25;307;8;6974;86;0.1;0.0
FR;24;2021-01-26;387;19;7361;105;0.1;0.0
FR;24;2021-01-27;471;18;7832;123;0.1;0.0
FR;24;2021-01-28;619;56;8451;179;0.2;0.0
FR;24;2021-01-29;483;88;8934;267;0.2;0.0
FR;24;2021-01-30;98;17;9032;284;0.2;0.0
FR;24;2021-01-31;39;14;9071;298;0.2;0.0
FR;24;2021-02-01;187;134;9258;432;0.2;0.0
FR;24;2021-02-02;227;183;9485;615;0.2;0.0
FR;24;2021-02-03;234;185;9719;800;0.2;0.0
FR;24;2021-02-04;396;322;10115;1122;0.2;0.0
FR;24;2021-02-05;361;342;10476;1464;0.2;0.0
FR;24;2021-02-06;100;72;10576;1536;0.2;0.0
FR;24;2021-02-07;187;35;10763;1571;0.2;0.0
FR;24;2021-02-08;406;366;11169;1937;0.2;0.0
FR;24;2021-02-09;781;478;11950;2415;0.2;0.0
FR;24;2021-02-10;1126;635;13076;3050;0.2;0.1
FR;24;2021-02-11;1623;764;14699;3814;0.3;0.1
FR;24;2021-02-12;1643;610;16342;4424;0.3;0.1
FR;24;2021-02-13;297;99;16639;4523;0.3;0.1
FR;24;2021-02-14;73;34;16712;4557;0.3;0.1
FR;24;2021-02-15;1090;420;17802;4977;0.3;0.1
FR;24;2021-02-16;1587;641;19389;5618;0.4;0.1
FR;24;2021-02-17;1524;551;20913;6169;0.4;0.1
FR;24;2021-02-18;1983;696;22896;6865;0.4;0.1
FR;24;2021-02-19;1889;621;24785;7486;0.5;0.1
FR;24;2021-02-20;343;99;25128;7585;0.5;0.1
FR;24;2021-02-21;52;17;25180;7602;0.5;0.1
FR;24;2021-02-22;1194;333;26374;7935;0.5;0.1
FR;24;2021-02-23;1615;442;27989;8377;0.5;0.2
FR;24;2021-02-24;1697;390;29686;8767;0.5;0.2
FR;24;2021-02-25;2332;568;32018;9335;0.6;0.2
FR;24;2021-02-26;2247;487;34265;9822;0.6;0.2
FR;24;2021-02-27;546;98;34811;9920;0.6;0.2
FR;24;2021-02-28;101;18;34912;9938;0.6;0.2
FR;24;2021-03-01;1325;308;36237;10246;0.7;0.2
FR;24;2021-03-02;1697;385;37934;10631;0.7;0.2
FR;24;2021-03-03;1851;457;39785;11088;0.7;0.2
FR;24;2021-03-04;2276;617;42061;11705;0.8;0.2
FR;24;2021-03-05;3409;695;45470;12400;0.8;0.2
FR;24;2021-03-06;1753;211;47223;12611;0.9;0.2
FR;24;2021-03-07;1020;118;48243;12729;0.9;0.2
FR;24;2021-03-08;2038;354;50281;13083;0.9;0.2
FR;24;2021-03-09;2722;478;53003;13561;1.0;0.3
FR;24;2021-03-10;2530;524;55533;14085;1.0;0.3
FR;24;2021-03-11;3047;700;58580;14785;1.1;0.3
FR;24;2021-03-12;3962;655;62542;15440;1.2;0.3
FR;24;2021-03-13;1540;165;64082;15605;1.2;0.3
FR;24;2021-03-14;577;65;64659;15670;1.2;0.3
FR;24;2021-03-15;1894;359;66553;16029;1.2;0.3
FR;24;2021-03-16;886;349;67439;16378;1.2;0.3
FR;24;2021-03-17;1155;357;68594;16735;1.3;0.3
FR;24;2021-03-18;1384;500;69978;17235;1.3;0.3
FR;24;2021-03-19;1947;445;71925;17680;1.3;0.3
FR;24;2021-03-20;877;118;72802;17798;1.3;0.3
FR;24;2021-03-21;674;93;73476;17891;1.4;0.3
FR;24;2021-03-22;1577;370;75053;18261;1.4;0.3
FR;24;2021-03-23;1899;477;76952;18738;1.4;0.3
FR;24;2021-03-24;2280;456;79232;19194;1.5;0.4
FR;24;2021-03-25;2663;602;81895;19796;1.5;0.4
FR;24;2021-03-26;3287;632;85182;20428;1.6;0.4
FR;24;2021-03-27;1949;276;87131;20704;1.6;0.4
FR;24;2021-03-28;1047;121;88178;20825;1.6;0.4
FR;24;2021-03-29;2561;482;90739;21307;1.7;0.4
FR;24;2021-03-30;3770;697;94509;22004;1.7;0.4
FR;24;2021-03-31;4302;713;98811;22717;1.8;0.4
FR;24;2021-04-01;5570;994;104381;23711;1.9;0.4
FR;24;2021-04-02;4617;877;108998;24588;2.0;0.5
FR;24;2021-04-03;1803;393;110801;24981;2.0;0.5
FR;24;2021-04-04;990;158;111791;25139;2.1;0.5
FR;24;2021-04-05;1182;173;112973;25312;2.1;0.5
FR;24;2021-04-06;3687;734;116660;26046;2.2;0.5
FR;24;2021-04-07;4926;1027;121586;27073;2.2;0.5
FR;24;2021-04-08;6574;1356;128160;28429;2.4;0.5
FR;24;2021-04-09;5956;1303;134116;29732;2.5;0.5
FR;24;2021-04-10;2707;640;136823;30372;2.5;0.6
FR;24;2021-04-11;1304;341;138127;30713;2.5;0.6
FR;24;2021-04-12;3564;1052;141691;31765;2.6;0.6
FR;24;2021-04-13;4941;1312;146632;33077;2.7;0.6
FR;24;2021-04-14;5132;1514;151764;34591;2.8;0.6
FR;24;2021-04-15;5398;1772;157162;36363;2.9;0.7
FR;24;2021-04-16;4977;1829;162139;38192;3.0;0.7
FR;24;2021-04-17;2209;857;164348;39049;3.0;0.7
FR;24;2021-04-18;765;461;165113;39510;3.0;0.7
FR;24;2021-04-19;3063;1623;168176;41133;3.1;0.8
FR;24;2021-04-20;3261;2216;171437;43349;3.2;0.8
FR;24;2021-04-21;3563;2601;175000;45950;3.2;0.8
FR;24;2021-04-22;4192;3272;179192;49222;3.3;0.9
FR;24;2021-04-23;4603;3688;183795;52910;3.4;1.0
FR;24;2021-04-24;2463;1722;186258;54632;3.4;1.0
FR;24;2021-04-25;1257;830;187515;55462;3.5;1.0
FR;24;2021-04-26;3223;2264;190738;57726;3.5;1.1
FR;24;2021-04-27;4071;3281;194809;61007;3.6;1.1
FR;24;2021-04-28;4603;3877;199412;64884;3.7;1.2
FR;24;2021-04-29;5660;4598;205072;69482;3.8;1.3
FR;24;2021-04-30;6418;4770;211490;74252;3.9;1.4
FR;24;2021-05-01;4116;1169;215606;75421;4.0;1.4
FR;24;2021-05-02;2861;939;218467;76360;4.0;1.4
FR;24;2021-05-03;6560;4246;225027;80606;4.1;1.5
FR;24;2021-05-04;7829;4864;232856;85470;4.3;1.6
FR;24;2021-05-05;9076;5065;241932;90535;4.5;1.7
FR;24;2021-05-06;11193;6548;253125;97083;4.7;1.8
FR;24;2021-05-07;12416;6566;265541;103649;4.9;1.9
FR;24;2021-05-08;10763;2685;276304;106334;5.1;2.0
FR;24;2021-05-09;7016;1993;283320;108327;5.2;2.0
FR;24;2021-05-10;11431;5093;294751;113420;5.4;2.1
FR;24;2021-05-11;15987;5915;310738;119335;5.7;2.2
FR;24;2021-05-12;23643;6439;334381;125774;6.2;2.3
FR;24;2021-05-13;28202;3302;362583;129076;6.7;2.4
FR;24;2021-05-14;33383;5819;395966;134895;7.3;2.5
FR;24;2021-05-15;34766;4253;430732;139148;7.9;2.6
FR;24;2021-05-16;22220;2125;452952;141273;8.4;2.6
FR;24;2021-05-17;30223;5473;483175;146746;8.9;2.7
FR;24;2021-05-18;39041;6400;522216;153146;9.6;2.8
FR;24;2021-05-19;41164;7386;563380;160532;10.4;3.0
FR;24;2021-05-20;46997;7849;610377;168381;11.3;3.1
FR;24;2021-05-21;48435;7600;658812;175981;12.1;3.2
FR;24;2021-05-22;45398;4765;704210;180746;13.0;3.3
FR;24;2021-05-23;24367;2495;728577;183241;13.4;3.4
FR;24;2021-05-24;35083;3786;763660;187027;14.1;3.4
FR;24;2021-05-25;45768;8062;809428;195089;14.9;3.6
FR;24;2021-05-26;47390;7700;856818;202789;15.8;3.7
FR;24;2021-05-27;53047;8816;909865;211605;16.8;3.9
FR;24;2021-05-28;49793;9231;959658;220836;17.7;4.1
FR;24;2021-05-29;44671;6174;1004329;227010;18.5;4.2
FR;24;2021-05-30;18698;2374;1023027;229384;18.9;4.2
FR;24;2021-05-31;52672;8520;1075699;237904;19.8;4.4
FR;24;2021-06-01;61050;10471;1136749;248375;21.0;4.6
FR;24;2021-06-02;62814;10001;1199563;258376;22.1;4.8
FR;24;2021-06-03;68598;10890;1268161;269266;23.4;5.0
FR;24;2021-06-04;66214;11073;1334375;280339;24.6;5.2
FR;24;2021-06-05;55690;8049;1390065;288388;25.6;5.3
FR;24;2021-06-06;27268;3765;1417333;292153;26.1;5.4
FR;24;2021-06-07;58176;10185;1475509;302338;27.2;5.6
FR;24;2021-06-08;63995;11288;1539504;313626;28.4;5.8
FR;24;2021-06-09;63485;11789;1602989;325415;29.6;6.0
FR;24;2021-06-10;65646;14516;1668635;339931;30.8;6.3
FR;24;2021-06-11;61183;13403;1729818;353334;31.9;6.5
FR;24;2021-06-12;54341;11926;1784159;365260;32.9;6.7
FR;24;2021-06-13;21124;5520;1805283;370780;33.3;6.8
FR;24;2021-06-14;42816;13811;1848099;384591;34.1;7.1
FR;24;2021-06-15;45462;14981;1893561;399572;34.9;7.4
FR;24;2021-06-16;41129;15545;1934690;415117;35.7;7.7
FR;24;2021-06-17;46576;18257;1981266;433374;36.5;8.0
FR;24;2021-06-18;44548;21892;2025814;455266;37.3;8.4
FR;24;2021-06-19;34465;19479;2060279;474745;38.0;8.8
FR;24;2021-06-20;11775;9357;2072054;484102;38.2;8.9
FR;24;2021-06-21;31570;24072;2103624;508174;38.8;9.4
FR;24;2021-06-22;35493;29864;2139117;538038;39.4;9.9
FR;24;2021-06-23;33843;32031;2172960;570069;40.1;10.5
FR;24;2021-06-24;38325;36482;2211285;606551;40.8;11.2
FR;24;2021-06-25;33648;42159;2244933;648710;41.4;12.0
FR;24;2021-06-26;23989;40071;2268922;688781;41.8;12.7
FR;24;2021-06-27;9734;21013;2278656;709794;42.0;13.1
FR;24;2021-06-28;26771;43737;2305427;753531;42.5;13.9
FR;24;2021-06-29;29747;48853;2335174;802384;43.1;14.8
FR;24;2021-06-30;28188;49210;2363362;851594;43.6;15.7
FR;24;2021-07-01;33408;52131;2396770;903725;44.2;16.7
FR;24;2021-07-02;31821;55402;2428591;959127;44.8;17.7
FR;24;2021-07-03;20610;49653;2449201;1008780;45.2;18.6
FR;24;2021-07-04;9082;23440;2458283;1032220;45.3;19.0
FR;24;2021-07-05;25628;52955;2483911;1085175;45.8;20.0
FR;24;2021-07-06;28700;55958;2512611;1141133;46.3;21.0
FR;24;2021-07-07;28799;54035;2541410;1195168;46.9;22.0
FR;24;2021-07-08;32502;55098;2573912;1250266;47.5;23.1
FR;24;2021-07-09;30900;63267;2604812;1313533;48.0;24.2
FR;24;2021-07-10;22130;54841;2626942;1368374;48.4;25.2
FR;24;2021-07-11;9905;21770;2636847;1390144;48.6;25.6
FR;24;2021-07-12;25299;74300;2662146;1464444;49.1;27.0
FR;24;2021-07-13;44234;82335;2706380;1546779;49.9;28.5
FR;24;2021-07-14;31023;33757;2737403;1580536;50.5;29.1
FR;24;2021-07-15;54152;84881;2791555;1665417;51.5;30.7
FR;24;2021-07-16;59400;81777;2850955;1747194;52.6;32.2
FR;24;2021-07-17;45416;65942;2896371;1813136;53.4;33.4
FR;24;2021-07-18;21243;26511;2917614;1839647;53.8;33.9
FR;24;2021-07-19;48333;75158;2965947;1914805;54.7;35.3
FR;24;2021-07-20;63288;78242;3029235;1993047;55.8;36.7
FR;24;2021-07-21;64739;69599;3093974;2062646;57.0;38.0
FR;24;2021-07-22;73417;68493;3167391;2131139;58.4;39.3
FR;24;2021-07-23;70998;71198;3238389;2202337;59.7;40.6
FR;24;2021-07-24;49701;56053;3288090;2258390;60.6;41.6
FR;24;2021-07-25;22857;18669;3310947;2277059;61.0;42.0
FR;24;2021-07-26;58605;58798;3369552;2335857;62.1;43.1
FR;24;2021-07-27;77279;57417;3446831;2393274;63.5;44.1
FR;24;2021-07-28;73833;51488;3520664;2444762;64.9;45.1
FR;24;2021-07-29;79622;50343;3600286;2495105;66.4;46.0
FR;24;2021-07-30;70828;52390;3671114;2547495;67.7;47.0
FR;24;2021-07-31;47176;38050;3718290;2585545;68.6;47.7
FR;24;2021-08-01;19364;11928;3737654;2597473;68.9;47.9
FR;24;2021-08-02;50624;42679;3788278;2640152;69.8;48.7
FR;24;2021-08-03;59236;43970;3847514;2684122;70.9;49.5
FR;24;2021-08-04;55128;38031;3902642;2722153;72.0;50.2
FR;24;2021-08-05;53075;41935;3955717;2764088;72.9;51.0
FR;24;2021-08-06;49697;48235;4005414;2812323;73.8;51.8
FR;24;2021-08-07;31376;35433;4036790;2847756;74.4;52.5
FR;24;2021-08-08;11796;13894;4048586;2861650;74.6;52.8
FR;24;2021-08-09;36885;48562;4085471;2910212;75.3;53.7
FR;24;2021-08-10;42795;52213;4128266;2962425;76.1;54.6
FR;24;2021-08-11;38146;48502;4166412;3010927;76.8;55.5
FR;24;2021-08-12;36915;52092;4203327;3063019;77.5;56.5
FR;24;2021-08-13;34204;51791;4237531;3114810;78.1;57.4
FR;24;2021-08-14;20443;39412;4257974;3154222;78.5;58.2
FR;24;2021-08-15;5893;11111;4263867;3165333;78.6;58.4
FR;24;2021-08-16;24981;58105;4288848;3223438;79.1;59.4
FR;24;2021-08-17;28323;62240;4317171;3285678;79.6;60.6
FR;24;2021-08-18;25579;58158;4342750;3343836;80.1;61.6
FR;24;2021-08-19;24748;58805;4367498;3402641;80.5;62.7
FR;24;2021-08-20;22988;62299;4390486;3464940;80.9;63.9
FR;24;2021-08-21;14098;43192;4404584;3508132;81.2;64.7
FR;24;2021-08-22;4596;17078;4409180;3525210;81.3;65.0
FR;24;2021-08-23;18051;61041;4427231;3586251;81.6;66.1
FR;29;2020-12-27;9;0;9;0;0.0;0.0
FR;29;2020-12-28;10;0;19;0;0.0;0.0
FR;29;2020-12-29;2;0;21;0;0.0;0.0
FR;29;2020-12-30;2;0;23;0;0.0;0.0
FR;29;2020-12-31;4;0;27;0;0.0;0.0
FR;29;2021-01-01;7;1;34;1;0.0;0.0
FR;29;2021-01-02;7;1;41;2;0.0;0.0
FR;29;2021-01-03;4;0;45;2;0.0;0.0
FR;29;2021-01-04;18;0;63;2;0.0;0.0
FR;29;2021-01-05;50;0;113;2;0.0;0.0
FR;29;2021-01-06;147;1;260;3;0.0;0.0
FR;29;2021-01-07;323;3;583;6;0.0;0.0
FR;29;2021-01-08;528;8;1111;14;0.0;0.0
FR;29;2021-01-09;114;0;1225;14;0.0;0.0
FR;29;2021-01-10;92;1;1317;15;0.0;0.0
FR;29;2021-01-11;666;5;1983;20;0.1;0.0
FR;29;2021-01-12;965;16;2948;36;0.1;0.0
FR;29;2021-01-13;1234;15;4182;51;0.1;0.0
FR;29;2021-01-14;1632;21;5814;72;0.2;0.0
FR;29;2021-01-15;1336;13;7150;85;0.2;0.0
FR;29;2021-01-16;200;5;7350;90;0.2;0.0
FR;29;2021-01-17;164;2;7514;92;0.2;0.0
FR;29;2021-01-18;1058;21;8572;113;0.2;0.0
FR;29;2021-01-19;1196;14;9768;127;0.3;0.0
FR;29;2021-01-20;1224;14;10992;141;0.3;0.0
FR;29;2021-01-21;1497;18;12489;159;0.3;0.0
FR;29;2021-01-22;1185;16;13674;175;0.4;0.0
FR;29;2021-01-23;181;2;13855;177;0.4;0.0
FR;29;2021-01-24;55;0;13910;177;0.4;0.0
FR;29;2021-01-25;554;20;14464;197;0.4;0.0
FR;29;2021-01-26;684;41;15148;238;0.4;0.0
FR;29;2021-01-27;752;70;15900;308;0.4;0.0
FR;29;2021-01-28;1068;130;16968;438;0.5;0.0
FR;29;2021-01-29;813;184;17781;622;0.5;0.0
FR;29;2021-01-30;146;43;17927;665;0.5;0.0
FR;29;2021-01-31;44;26;17971;691;0.5;0.0
FR;29;2021-02-01;279;292;18250;983;0.5;0.0
FR;29;2021-02-02;421;375;18671;1358;0.5;0.0
FR;29;2021-02-03;475;463;19146;1821;0.5;0.0
FR;29;2021-02-04;644;722;19790;2543;0.5;0.1
FR;29;2021-02-05;553;748;20343;3291;0.5;0.1
FR;29;2021-02-06;154;114;20497;3405;0.6;0.1
FR;29;2021-02-07;312;80;20809;3485;0.6;0.1
FR;29;2021-02-08;621;818;21430;4303;0.6;0.1
FR;29;2021-02-09;1289;1059;22719;5362;0.6;0.1
FR;29;2021-02-10;1753;1189;24472;6551;0.7;0.2
FR;29;2021-02-11;2506;1501;26978;8052;0.7;0.2
FR;29;2021-02-12;2257;1312;29235;9364;0.8;0.3
FR;29;2021-02-13;438;170;29673;9534;0.8;0.3
FR;29;2021-02-14;147;83;29820;9617;0.8;0.3
FR;29;2021-02-15;1601;841;31421;10458;0.8;0.3
FR;29;2021-02-16;1966;1240;33387;11698;0.9;0.3
FR;29;2021-02-17;1920;1026;35307;12724;0.9;0.3
FR;29;2021-02-18;2458;1246;37765;13970;1.0;0.4
FR;29;2021-02-19;2375;1043;40140;15013;1.1;0.4
FR;29;2021-02-20;392;132;40532;15145;1.1;0.4
FR;29;2021-02-21;101;46;40633;15191;1.1;0.4
FR;29;2021-02-22;1393;579;42026;15770;1.1;0.4
FR;29;2021-02-23;1803;711;43829;16481;1.2;0.4
FR;29;2021-02-24;1842;606;45671;17087;1.2;0.5
FR;29;2021-02-25;2462;1052;48133;18139;1.3;0.5
FR;29;2021-02-26;2617;743;50750;18882;1.4;0.5
FR;29;2021-02-27;621;129;51371;19011;1.4;0.5
FR;29;2021-02-28;120;30;51491;19041;1.4;0.5
FR;29;2021-03-01;1348;402;52839;19443;1.4;0.5
FR;29;2021-03-02;1857;673;54696;20116;1.5;0.5
FR;29;2021-03-03;2044;702;56740;20818;1.5;0.6
FR;29;2021-03-04;2582;879;59322;21697;1.6;0.6
FR;29;2021-03-05;3721;906;63043;22603;1.7;0.6
FR;29;2021-03-06;1670;197;64713;22800;1.7;0.6
FR;29;2021-03-07;842;133;65555;22933;1.8;0.6
FR;29;2021-03-08;2039;519;67594;23452;1.8;0.6
FR;29;2021-03-09;2729;639;70323;24091;1.9;0.6
FR;29;2021-03-10;2648;646;72971;24737;2.0;0.7
FR;29;2021-03-11;3447;1029;76418;25766;2.1;0.7
FR;29;2021-03-12;4092;927;80510;26693;2.2;0.7
FR;29;2021-03-13;1675;202;82185;26895;2.2;0.7
FR;29;2021-03-14;597;85;82782;26980;2.2;0.7
FR;29;2021-03-15;1952;458;84734;27438;2.3;0.7
FR;29;2021-03-16;1174;561;85908;27999;2.3;0.8
FR;29;2021-03-17;1452;587;87360;28586;2.4;0.8
FR;29;2021-03-18;1707;751;89067;29337;2.4;0.8
FR;29;2021-03-19;2322;661;91389;29998;2.5;0.8
FR;29;2021-03-20;1030;160;92419;30158;2.5;0.8
FR;29;2021-03-21;762;100;93181;30258;2.5;0.8
FR;29;2021-03-22;1711;486;94892;30744;2.6;0.8
FR;29;2021-03-23;2289;689;97181;31433;2.6;0.8
FR;29;2021-03-24;2625;697;99806;32130;2.7;0.9
FR;29;2021-03-25;3477;833;103283;32963;2.8;0.9
FR;29;2021-03-26;3835;896;107118;33859;2.9;0.9
FR;29;2021-03-27;2198;339;109316;34198;2.9;0.9
FR;29;2021-03-28;990;125;110306;34323;3.0;0.9
FR;29;2021-03-29;2840;646;113146;34969;3.0;0.9
FR;29;2021-03-30;4122;905;117268;35874;3.2;1.0
FR;29;2021-03-31;4632;1028;121900;36902;3.3;1.0
FR;29;2021-04-01;6003;1253;127903;38155;3.4;1.0
FR;29;2021-04-02;5019;1120;132922;39275;3.6;1.1
FR;29;2021-04-03;1814;375;134736;39650;3.6;1.1
FR;29;2021-04-04;933;157;135669;39807;3.7;1.1
FR;29;2021-04-05;969;142;136638;39949;3.7;1.1
FR;29;2021-04-06;3629;913;140267;40862;3.8;1.1
FR;29;2021-04-07;4659;1285;144926;42147;3.9;1.1
FR;29;2021-04-08;6435;1739;151361;43886;4.1;1.2
FR;29;2021-04-09;6437;1517;157798;45403;4.2;1.2
FR;29;2021-04-10;2724;690;160522;46093;4.3;1.2
FR;29;2021-04-11;1204;358;161726;46451;4.4;1.2
FR;29;2021-04-12;3676;1175;165402;47626;4.5;1.3
FR;29;2021-04-13;4989;1668;170391;49294;4.6;1.3
FR;29;2021-04-14;4917;1652;175308;50946;4.7;1.4
FR;29;2021-04-15;5776;1981;181084;52927;4.9;1.4
FR;29;2021-04-16;4946;2044;186030;54971;5.0;1.5
FR;29;2021-04-17;2317;972;188347;55943;5.1;1.5
FR;29;2021-04-18;810;544;189157;56487;5.1;1.5
FR;29;2021-04-19;2960;1873;192117;58360;5.2;1.6
FR;29;2021-04-20;3617;2594;195734;60954;5.3;1.6
FR;29;2021-04-21;3585;2902;199319;63856;5.4;1.7
FR;29;2021-04-22;4592;4000;203911;67856;5.5;1.8
FR;29;2021-04-23;4900;4108;208811;71964;5.6;1.9
FR;29;2021-04-24;2747;1887;211558;73851;5.7;2.0
FR;29;2021-04-25;1229;769;212787;74620;5.7;2.0
FR;29;2021-04-26;3131;2549;215918;77169;5.8;2.1
FR;29;2021-04-27;4120;3707;220038;80876;5.9;2.2
FR;29;2021-04-28;4863;4149;224901;85025;6.1;2.3
FR;29;2021-04-29;6042;5141;230943;90166;6.2;2.4
FR;29;2021-04-30;6667;5368;237610;95534;6.4;2.6
FR;29;2021-05-01;4374;1290;241984;96824;6.5;2.6
FR;29;2021-05-02;2694;960;244678;97784;6.6;2.6
FR;29;2021-05-03;7197;4380;251875;102164;6.8;2.7
FR;29;2021-05-04;8442;5337;260317;107501;7.0;2.9
FR;29;2021-05-05;9985;5320;270302;112821;7.3;3.0
FR;29;2021-05-06;11559;6709;281861;119530;7.6;3.2
FR;29;2021-05-07;12040;6779;293901;126309;7.9;3.4
FR;29;2021-05-08;9563;2377;303464;128686;8.2;3.5
FR;29;2021-05-09;6020;1803;309484;130489;8.3;3.5
FR;29;2021-05-10;11014;5447;320498;135936;8.6;3.7
FR;29;2021-05-11;14968;6527;335466;142463;9.0;3.8
FR;29;2021-05-12;20729;6533;356195;148996;9.6;4.0
FR;29;2021-05-13;20327;2500;376522;151496;10.1;4.1
FR;29;2021-05-14;23213;4593;399735;156089;10.8;4.2
FR;29;2021-05-15;21966;3124;421701;159213;11.3;4.3
FR;29;2021-05-16;13626;1437;435327;160650;11.7;4.3
FR;29;2021-05-17;22063;5152;457390;165802;12.3;4.5
FR;29;2021-05-18;29173;5961;486563;171763;13.1;4.6
FR;29;2021-05-19;29727;6236;516290;177999;13.9;4.8
FR;29;2021-05-20;33618;6821;549908;184820;14.8;5.0
FR;29;2021-05-21;32843;6437;582751;191257;15.7;5.1
FR;29;2021-05-22;26583;3183;609334;194440;16.4;5.2
FR;29;2021-05-23;14437;1591;623771;196031;16.8;5.3
FR;29;2021-05-24;23171;2774;646942;198805;17.4;5.3
FR;29;2021-05-25;31307;6790;678249;205595;18.2;5.5
FR;29;2021-05-26;33697;6898;711946;212493;19.2;5.7
FR;29;2021-05-27;36487;7849;748433;220342;20.1;5.9
FR;29;2021-05-28;34069;8182;782502;228524;21.1;6.1
FR;29;2021-05-29;27001;4414;809503;232938;21.8;6.3
FR;29;2021-05-30;12018;1691;821521;234629;22.1;6.3
FR;29;2021-05-31;34166;7013;855687;241642;23.0;6.5
FR;29;2021-06-01;39896;8463;895583;250105;24.1;6.7
FR;29;2021-06-02;40409;8131;935992;258236;25.2;6.9
FR;29;2021-06-03;44914;9117;980906;267353;26.4;7.2
FR;29;2021-06-04;43977;9343;1024883;276696;27.6;7.4
FR;29;2021-06-05;32229;5764;1057112;282460;28.4;7.6
FR;29;2021-06-06;17144;2619;1074256;285079;28.9;7.7
FR;29;2021-06-07;38126;8431;1112382;293510;29.9;7.9
FR;29;2021-06-08;42112;9348;1154494;302858;31.1;8.1
FR;29;2021-06-09;40646;9716;1195140;312574;32.2;8.4
FR;29;2021-06-10;43195;11732;1238335;324306;33.3;8.7
FR;29;2021-06-11;39614;11288;1277949;335594;34.4;9.0
FR;29;2021-06-12;32263;8782;1310212;344376;35.3;9.3
FR;29;2021-06-13;14107;4404;1324319;348780;35.6;9.4
FR;29;2021-06-14;27245;12199;1351564;360979;36.4;9.7
FR;29;2021-06-15;29965;13582;1381529;374561;37.2;10.1
FR;29;2021-06-16;26795;14304;1408324;388865;37.9;10.5
FR;29;2021-06-17;29958;15546;1438282;404411;38.7;10.9
FR;29;2021-06-18;26863;17604;1465145;422015;39.4;11.4
FR;29;2021-06-19;18788;14046;1483933;436061;39.9;11.7
FR;29;2021-06-20;7052;7307;1490985;443368;40.1;11.9
FR;29;2021-06-21;18396;19299;1509381;462667;40.6;12.4
FR;29;2021-06-22;20426;22894;1529807;485561;41.2;13.1
FR;29;2021-06-23;18773;23926;1548580;509487;41.7;13.7
FR;29;2021-06-24;21618;25250;1570198;534737;42.2;14.4
FR;29;2021-06-25;18787;28587;1588985;563324;42.8;15.2
FR;29;2021-06-26;13217;24479;1602202;587803;43.1;15.8
FR;29;2021-06-27;5231;12865;1607433;600668;43.2;16.2
FR;29;2021-06-28;13750;29786;1621183;630454;43.6;17.0
FR;29;2021-06-29;15894;33133;1637077;663587;44.0;17.9
FR;29;2021-06-30;14834;32650;1651911;696237;44.4;18.7
FR;29;2021-07-01;18523;32929;1670434;729166;44.9;19.6
FR;29;2021-07-02;18410;35727;1688844;764893;45.4;20.6
FR;29;2021-07-03;11776;30030;1700620;794923;45.8;21.4
FR;29;2021-07-04;5180;14599;1705800;809522;45.9;21.8
FR;29;2021-07-05;14010;35119;1719810;844641;46.3;22.7
FR;29;2021-07-06;16332;37373;1736142;882014;46.7;23.7
FR;29;2021-07-07;16319;36547;1752461;918561;47.2;24.7
FR;29;2021-07-08;18685;36121;1771146;954682;47.7;25.7
FR;29;2021-07-09;18611;41139;1789757;995821;48.2;26.8
FR;29;2021-07-10;12880;32631;1802637;1028452;48.5;27.7
FR;29;2021-07-11;5957;13439;1808594;1041891;48.7;28.0
FR;29;2021-07-12;14701;47489;1823295;1089380;49.1;29.3
FR;29;2021-07-13;26721;53376;1850016;1142756;49.8;30.7
FR;29;2021-07-14;20065;21110;1870081;1163866;50.3;31.3
FR;29;2021-07-15;33930;53048;1904011;1216914;51.2;32.7
FR;29;2021-07-16;37317;52088;1941328;1269002;52.2;34.1
FR;29;2021-07-17;26975;37821;1968303;1306823;53.0;35.2
FR;29;2021-07-18;13339;15820;1981642;1322643;53.3;35.6
FR;29;2021-07-19;29681;49101;2011323;1371744;54.1;36.9
FR;29;2021-07-20;39192;50778;2050515;1422522;55.2;38.3
FR;29;2021-07-21;40511;44322;2091026;1466844;56.3;39.5
FR;29;2021-07-22;46446;44069;2137472;1510913;57.5;40.7
FR;29;2021-07-23;45557;45299;2183029;1556212;58.7;41.9
FR;29;2021-07-24;31577;32457;2214606;1588669;59.6;42.7
FR;29;2021-07-25;14400;10981;2229006;1599650;60.0;43.0
FR;29;2021-07-26;36888;35108;2265894;1634758;61.0;44.0
FR;29;2021-07-27;48955;35603;2314849;1670361;62.3;44.9
FR;29;2021-07-28;46941;30379;2361790;1700740;63.5;45.8
FR;29;2021-07-29;50385;30663;2412175;1731403;64.9;46.6
FR;29;2021-07-30;45812;31630;2457987;1763033;66.1;47.4
FR;29;2021-07-31;29621;21268;2487608;1784301;66.9;48.0
FR;29;2021-08-01;12245;6961;2499853;1791262;67.3;48.2
FR;29;2021-08-02;30844;23717;2530697;1814979;68.1;48.8
FR;29;2021-08-03;36361;26275;2567058;1841254;69.1;49.5
FR;29;2021-08-04;34144;22963;2601202;1864217;70.0;50.2
FR;29;2021-08-05;33390;26151;2634592;1890368;70.9;50.9
FR;29;2021-08-06;32441;31002;2667033;1921370;71.8;51.7
FR;29;2021-08-07;20529;21729;2687562;1943099;72.3;52.3
FR;29;2021-08-08;7801;8813;2695363;1951912;72.5;52.5
FR;29;2021-08-09;24112;29830;2719475;1981742;73.2;53.3
FR;29;2021-08-10;28660;32277;2748135;2014019;73.9;54.2
FR;29;2021-08-11;25572;30683;2773707;2044702;74.6;55.0
FR;29;2021-08-12;24931;33297;2798638;2077999;75.3;55.9
FR;29;2021-08-13;23612;33014;2822250;2111013;75.9;56.8
FR;29;2021-08-14;14155;24851;2836405;2135864;76.3;57.5
FR;29;2021-08-15;3890;6879;2840295;2142743;76.4;57.7
FR;29;2021-08-16;16931;37041;2857226;2179784;76.9;58.6
FR;29;2021-08-17;19633;39621;2876859;2219405;77.4;59.7
FR;29;2021-08-18;17393;36989;2894252;2256394;77.9;60.7
FR;29;2021-08-19;17404;37764;2911656;2294158;78.3;61.7
FR;29;2021-08-20;16557;40682;2928213;2334840;78.8;62.8
FR;29;2021-08-21;9486;27551;2937699;2362391;79.0;63.6
FR;29;2021-08-22;3094;10663;2940793;2373054;79.1;63.8
FR;29;2021-08-23;11957;37615;2952750;2410669;79.4;64.9
FR;39;2020-12-27;26;0;26;0;0.0;0.0
FR;39;2020-12-28;37;0;63;0;0.0;0.0
FR;39;2020-12-29;15;0;78;0;0.0;0.0
FR;39;2020-12-30;20;0;98;0;0.0;0.0
FR;39;2020-12-31;9;0;107;0;0.0;0.0
FR;39;2021-01-01;25;0;132;0;0.0;0.0
FR;39;2021-01-02;9;1;141;1;0.0;0.0
FR;39;2021-01-03;15;0;156;1;0.0;0.0
FR;39;2021-01-04;42;0;198;1;0.0;0.0
FR;39;2021-01-05;157;0;355;1;0.0;0.0
FR;39;2021-01-06;400;1;755;2;0.0;0.0
FR;39;2021-01-07;1203;8;1958;10;0.0;0.0
FR;39;2021-01-08;1827;6;3785;16;0.0;0.0
FR;39;2021-01-09;482;1;4267;17;0.1;0.0
FR;39;2021-01-10;313;1;4580;18;0.1;0.0
FR;39;2021-01-11;2243;13;6823;31;0.1;0.0
FR;39;2021-01-12;3470;28;10293;59;0.1;0.0
FR;39;2021-01-13;3569;32;13862;91;0.2;0.0
FR;39;2021-01-14;4951;65;18813;156;0.2;0.0
FR;39;2021-01-15;4457;33;23270;189;0.3;0.0
FR;39;2021-01-16;787;4;24057;193;0.3;0.0
FR;39;2021-01-17;511;8;24568;201;0.3;0.0
FR;39;2021-01-18;3131;42;27699;243;0.3;0.0
FR;39;2021-01-19;4125;41;31824;284;0.4;0.0
FR;39;2021-01-20;3988;38;35812;322;0.4;0.0
FR;39;2021-01-21;5247;51;41059;373;0.5;0.0
FR;39;2021-01-22;4054;51;45113;424;0.5;0.0
FR;39;2021-01-23;614;6;45727;430;0.6;0.0
FR;39;2021-01-24;195;2;45922;432;0.6;0.0
FR;39;2021-01-25;1655;58;47577;490;0.6;0.0
FR;39;2021-01-26;2211;102;49788;592;0.6;0.0
FR;39;2021-01-27;2337;232;52125;824;0.6;0.0
FR;39;2021-01-28;3548;499;55673;1323;0.7;0.0
FR;39;2021-01-29;2717;718;58390;2041;0.7;0.0
FR;39;2021-01-30;413;218;58803;2259;0.7;0.0
FR;39;2021-01-31;123;78;58926;2337;0.7;0.0
FR;39;2021-02-01;782;1058;59708;3395;0.7;0.0
FR;39;2021-02-02;1388;1647;61096;5042;0.7;0.1
FR;39;2021-02-03;1404;1656;62500;6698;0.8;0.1
FR;39;2021-02-04;2034;2544;64534;9242;0.8;0.1
FR;39;2021-02-05;1683;2704;66217;11946;0.8;0.1
FR;39;2021-02-06;428;435;66645;12381;0.8;0.1
FR;39;2021-02-07;571;223;67216;12604;0.8;0.2
FR;39;2021-02-08;1554;2443;68770;15047;0.8;0.2
FR;39;2021-02-09;3211;3442;71981;18489;0.9;0.2
FR;39;2021-02-10;3944;3597;75925;22086;0.9;0.3
FR;39;2021-02-11;6246;4964;82171;27050;1.0;0.3
FR;39;2021-02-12;5897;4149;88068;31199;1.1;0.4
FR;39;2021-02-13;1266;572;89334;31771;1.1;0.4
FR;39;2021-02-14;414;270;89748;32041;1.1;0.4
FR;39;2021-02-15;3474;2446;93222;34487;1.1;0.4
FR;39;2021-02-16;4492;3465;97714;37952;1.2;0.5
FR;39;2021-02-17;4043;2935;101757;40887;1.2;0.5
FR;39;2021-02-18;6081;4059;107838;44946;1.3;0.5
FR;39;2021-02-19;5925;3232;113763;48178;1.4;0.6
FR;39;2021-02-20;1173;488;114936;48666;1.4;0.6
FR;39;2021-02-21;220;124;115156;48790;1.4;0.6
FR;39;2021-02-22;3055;1725;118211;50515;1.4;0.6
FR;39;2021-02-23;3989;2015;122200;52530;1.5;0.6
FR;39;2021-02-24;3865;1824;126065;54354;1.5;0.7
FR;39;2021-02-25;5721;2690;131786;57044;1.6;0.7
FR;39;2021-02-26;6175;2102;137961;59146;1.7;0.7
FR;39;2021-02-27;1727;346;139688;59492;1.7;0.7
FR;39;2021-02-28;278;129;139966;59621;1.7;0.7
FR;39;2021-03-01;3080;1107;143046;60728;1.7;0.7
FR;39;2021-03-02;4402;1771;147448;62499;1.8;0.8
FR;39;2021-03-03;4433;1700;151881;64199;1.8;0.8
FR;39;2021-03-04;6531;2593;158412;66792;1.9;0.8
FR;39;2021-03-05;9385;2423;167797;69215;2.0;0.8
FR;39;2021-03-06;5078;544;172875;69759;2.1;0.8
FR;39;2021-03-07;2719;343;175594;70102;2.1;0.8
FR;39;2021-03-08;4818;1290;180412;71392;2.2;0.9
FR;39;2021-03-09;7091;1796;187503;73188;2.3;0.9
FR;39;2021-03-10;6286;1810;193789;74998;2.3;0.9
FR;39;2021-03-11;8908;2805;202697;77803;2.4;0.9
FR;39;2021-03-12;11790;2635;214487;80438;2.6;1.0
FR;39;2021-03-13;5343;583;219830;81021;2.7;1.0
FR;39;2021-03-14;1820;222;221650;81243;2.7;1.0
FR;39;2021-03-15;4929;1204;226579;82447;2.7;1.0
FR;39;2021-03-16;3503;1516;230082;83963;2.8;1.0
FR;39;2021-03-17;3611;1620;233693;85583;2.8;1.0
FR;39;2021-03-18;4808;2137;238501;87720;2.9;1.1
FR;39;2021-03-19;6524;1848;245025;89568;3.0;1.1
FR;39;2021-03-20;3288;443;248313;90011;3.0;1.1
FR;39;2021-03-21;2171;242;250484;90253;3.0;1.1
FR;39;2021-03-22;4651;1266;255135;91519;3.1;1.1
FR;39;2021-03-23;6385;1868;261520;93387;3.2;1.1
FR;39;2021-03-24;6521;1587;268041;94974;3.2;1.1
FR;39;2021-03-25;9286;2033;277327;97007;3.3;1.2
FR;39;2021-03-26;10933;2072;288260;99079;3.5;1.2
FR;39;2021-03-27;6090;818;294350;99897;3.5;1.2
FR;39;2021-03-28;2812;262;297162;100159;3.6;1.2
FR;39;2021-03-29;7409;1518;304571;101677;3.7;1.2
FR;39;2021-03-30;10777;2273;315348;103950;3.8;1.3
FR;39;2021-03-31;11449;2259;326797;106209;3.9;1.3
FR;39;2021-04-01;15387;3146;342184;109355;4.1;1.3
FR;39;2021-04-02;13573;2917;355757;112272;4.3;1.4
FR;39;2021-04-03;5746;1135;361503;113407;4.4;1.4
FR;39;2021-04-04;2621;410;364124;113817;4.4;1.4
FR;39;2021-04-05;2696;379;366820;114196;4.4;1.4
FR;39;2021-04-06;9559;2573;376379;116769;4.5;1.4
FR;39;2021-04-07;12487;3104;388866;119873;4.7;1.4
FR;39;2021-04-08;17194;4210;406060;124083;4.9;1.5
FR;39;2021-04-09;17272;4125;423332;128208;5.1;1.5
FR;39;2021-04-10;7560;2074;430892;130282;5.2;1.6
FR;39;2021-04-11;3079;1029;433971;131311;5.2;1.6
FR;39;2021-04-12;9857;2943;443828;134254;5.4;1.6
FR;39;2021-04-13;13266;4348;457094;138602;5.5;1.7
FR;39;2021-04-14;13229;4177;470323;142779;5.7;1.7
FR;39;2021-04-15;15172;5176;485495;147955;5.9;1.8
FR;39;2021-04-16;13155;5618;498650;153573;6.0;1.9
FR;39;2021-04-17;6271;2813;504921;156386;6.1;1.9
FR;39;2021-04-18;2363;1590;507284;157976;6.1;1.9
FR;39;2021-04-19;8162;4859;515446;162835;6.2;2.0
FR;39;2021-04-20;9739;6907;525185;169742;6.3;2.0
FR;39;2021-04-21;10621;7403;535806;177145;6.5;2.1
FR;39;2021-04-22;12261;10636;548067;187781;6.6;2.3
FR;39;2021-04-23;12963;11167;561030;198948;6.8;2.4
FR;39;2021-04-24;8010;5208;569040;204156;6.9;2.5
FR;39;2021-04-25;3620;2224;572660;206380;6.9;2.5
FR;39;2021-04-26;8955;7123;581615;213503;7.0;2.6
FR;39;2021-04-27;12196;9847;593811;223350;7.2;2.7
FR;39;2021-04-28;13707;10387;607518;233737;7.3;2.8
FR;39;2021-04-29;17753;13333;625271;247070;7.5;3.0
FR;39;2021-04-30;20301;13690;645572;260760;7.8;3.1
FR;39;2021-05-01;13950;3732;659522;264492;8.0;3.2
FR;39;2021-05-02;9504;2594;669026;267086;8.1;3.2
FR;39;2021-05-03;23109;11561;692135;278647;8.3;3.4
FR;39;2021-05-04;27695;14305;719830;292952;8.7;3.5
FR;39;2021-05-05;31641;14641;751471;307593;9.1;3.7
FR;39;2021-05-06;37893;18146;789364;325739;9.5;3.9
FR;39;2021-05-07;39450;18882;828814;344621;10.0;4.2
FR;39;2021-05-08;30802;6006;859616;350627;10.4;4.2
FR;39;2021-05-09;19064;4444;878680;355071;10.6;4.3
FR;39;2021-05-10;34838;14840;913518;369911;11.0;4.5
FR;39;2021-05-11;45315;17533;958833;387444;11.6;4.7
FR;39;2021-05-12;58288;16769;1017121;404213;12.3;4.9
FR;39;2021-05-13;54564;5986;1071685;410199;12.9;4.9
FR;39;2021-05-14;64088;11598;1135773;421797;13.7;5.1
FR;39;2021-05-15;57810;7317;1193583;429114;14.4;5.2
FR;39;2021-05-16;36593;3337;1230176;432451;14.8;5.2
FR;39;2021-05-17;57614;12400;1287790;444851;15.5;5.4
FR;39;2021-05-18;73422;14252;1361212;459103;16.4;5.5
FR;39;2021-05-19;76392;14709;1437604;473812;17.3;5.7
FR;39;2021-05-20;85068;15591;1522672;489403;18.4;5.9
FR;39;2021-05-21;84346;15555;1607018;504958;19.4;6.1
FR;39;2021-05-22;64582;7778;1671600;512736;20.2;6.2
FR;39;2021-05-23;34575;3497;1706175;516233;20.6;6.2
FR;39;2021-05-24;53489;5628;1759664;521861;21.2;6.3
FR;39;2021-05-25;75169;16360;1834833;538221;22.1;6.5
FR;39;2021-05-26;79294;16481;1914127;554702;23.1;6.7
FR;39;2021-05-27;86505;18440;2000632;573142;24.1;6.9
FR;39;2021-05-28;80320;19988;2080952;593130;25.1;7.2
FR;39;2021-05-29;58544;10385;2139496;603515;25.8;7.3
FR;39;2021-05-30;24888;3758;2164384;607273;26.1;7.3
FR;39;2021-05-31;75750;16218;2240134;623491;27.0;7.5
FR;39;2021-06-01;88554;20120;2328688;643611;28.1;7.8
FR;39;2021-06-02;89279;19609;2417967;663220;29.1;8.0
FR;39;2021-06-03;99475;22010;2517442;685230;30.3;8.3
FR;39;2021-06-04;98637;23458;2616079;708688;31.5;8.5
FR;39;2021-06-05;64979;13885;2681058;722573;32.3;8.7
FR;39;2021-06-06;32386;5896;2713444;728469;32.7;8.8
FR;39;2021-06-07;76602;20774;2790046;749243;33.6;9.0
FR;39;2021-06-08;87386;22923;2877432;772166;34.7;9.3
FR;39;2021-06-09;85588;24714;2963020;796880;35.7;9.6
FR;39;2021-06-10;88739;28009;3051759;824889;36.8;9.9
FR;39;2021-06-11;86290;30904;3138049;855793;37.8;10.3
FR;39;2021-06-12;61550;23530;3199599;879323;38.6;10.6
FR;39;2021-06-13;25663;11737;3225262;891060;38.9;10.7
FR;39;2021-06-14;53911;35536;3279173;926596;39.5;11.2
FR;39;2021-06-15;60677;39831;3339850;966427;40.3;11.7
FR;39;2021-06-16;56789;42107;3396639;1008534;40.9;12.2
FR;39;2021-06-17;61721;43598;3458360;1052132;41.7;12.7
FR;39;2021-06-18;57968;51759;3516328;1103891;42.4;13.3
FR;39;2021-06-19;36262;38778;3552590;1142669;42.8;13.8
FR;39;2021-06-20;12889;18630;3565479;1161299;43.0;14.0
FR;39;2021-06-21;35538;53747;3601017;1215046;43.4;14.6
FR;39;2021-06-22;40117;62607;3641134;1277653;43.9;15.4
FR;39;2021-06-23;37552;65143;3678686;1342796;44.3;16.2
FR;39;2021-06-24;42945;63027;3721631;1405823;44.9;16.9
FR;39;2021-06-25;39642;76174;3761273;1481997;45.3;17.9
FR;39;2021-06-26;24906;60036;3786179;1542033;45.6;18.6
FR;39;2021-06-27;10009;31300;3796188;1573333;45.8;19.0
FR;39;2021-06-28;26760;74117;3822948;1647450;46.1;19.9
FR;39;2021-06-29;30591;81874;3853539;1729324;46.5;20.8
FR;39;2021-06-30;30647;82249;3884186;1811573;46.8;21.8
FR;39;2021-07-01;37819;79437;3922005;1891010;47.3;22.8
FR;39;2021-07-02;39028;87976;3961033;1978986;47.7;23.9
FR;39;2021-07-03;23377;68897;3984410;2047883;48.0;24.7
FR;39;2021-07-04;9955;31827;3994365;2079710;48.2;25.1
FR;39;2021-07-05;28070;79667;4022435;2159377;48.5;26.0
FR;39;2021-07-06;33515;87333;4055950;2246710;48.9;27.1
FR;39;2021-07-07;34976;85585;4090926;2332295;49.3;28.1
FR;39;2021-07-08;39031;80683;4129957;2412978;49.8;29.1
FR;39;2021-07-09;40156;96790;4170113;2509768;50.3;30.3
FR;39;2021-07-10;26252;67986;4196365;2577754;50.6;31.1
FR;39;2021-07-11;11708;26395;4208073;2604149;50.7;31.4
FR;39;2021-07-12;29876;102836;4237949;2706985;51.1;32.6
FR;39;2021-07-13;54731;117615;4292680;2824600;51.7;34.1
FR;39;2021-07-14;37660;42058;4330340;2866658;52.2;34.6
FR;39;2021-07-15;67808;112666;4398148;2979324;53.0;35.9
FR;39;2021-07-16;74679;110759;4472827;3090083;53.9;37.3
FR;39;2021-07-17;51039;72542;4523866;3162625;54.5;38.1
FR;39;2021-07-18;23492;29720;4547358;3192345;54.8;38.5
FR;39;2021-07-19;56714;99456;4604072;3291801;55.5;39.7
FR;39;2021-07-20;74561;103676;4678633;3395477;56.4;40.9
FR;39;2021-07-21;79462;94020;4758095;3489497;57.4;42.1
FR;39;2021-07-22;89546;88919;4847641;3578416;58.4;43.1
FR;39;2021-07-23;89009;96487;4936650;3674903;59.5;44.3
FR;39;2021-07-24;58295;61827;4994945;3736730;60.2;45.0
FR;39;2021-07-25;25999;20954;5020944;3757684;60.5;45.3
FR;39;2021-07-26;69201;72147;5090145;3829831;61.4;46.2
FR;39;2021-07-27;92182;72907;5182327;3902738;62.5;47.0
FR;39;2021-07-28;90226;65718;5272553;3968456;63.6;47.8
FR;39;2021-07-29;95301;62296;5367854;4030752;64.7;48.6
FR;39;2021-07-30;88882;66958;5456736;4097710;65.8;49.4
FR;39;2021-07-31;55087;41633;5511823;4139343;66.4;49.9
FR;39;2021-08-01;21767;12981;5533590;4152324;66.7;50.1
FR;39;2021-08-02;58940;49029;5592530;4201353;67.4;50.6
FR;39;2021-08-03;70774;54035;5663304;4255388;68.3;51.3
FR;39;2021-08-04;68200;47687;5731504;4303075;69.1;51.9
FR;39;2021-08-05;64753;52681;5796257;4355756;69.9;52.5
FR;39;2021-08-06;65795;63606;5862052;4419362;70.7;53.3
FR;39;2021-08-07;40358;42028;5902410;4461390;71.2;53.8
FR;39;2021-08-08;14319;15921;5916729;4477311;71.3;54.0
FR;39;2021-08-09;46719;57706;5963448;4535017;71.9;54.7
FR;39;2021-08-10;55327;62867;6018775;4597884;72.6;55.4
FR;39;2021-08-11;50713;59799;6069488;4657683;73.2;56.1
FR;39;2021-08-12;49357;63520;6118845;4721203;73.8;56.9
FR;39;2021-08-13;46302;63041;6165147;4784244;74.3;57.7
FR;39;2021-08-14;27183;46011;6192330;4830255;74.6;58.2
FR;39;2021-08-15;7279;12015;6199609;4842270;74.7;58.4
FR;39;2021-08-16;32941;69553;6232550;4911823;75.1;59.2
FR;39;2021-08-17;38775;73360;6271325;4985183;75.6;60.1
FR;39;2021-08-18;35082;70467;6306407;5055650;76.0;60.9
FR;39;2021-08-19;34100;70131;6340507;5125781;76.4;61.8
FR;39;2021-08-20;32905;78420;6373412;5204201;76.8;62.7
FR;39;2021-08-21;18828;50830;6392240;5255031;77.1;63.3
FR;39;2021-08-22;5868;18991;6398108;5274022;77.1;63.6
FR;39;2021-08-23;23432;72675;6421540;5346697;77.4;64.5
FR;49;2020-12-27;30;0;30;0;0.0;0.0
FR;49;2020-12-28;35;1;65;1;0.0;0.0
FR;49;2020-12-29;10;0;75;1;0.0;0.0
FR;49;2020-12-30;16;0;91;1;0.0;0.0
FR;49;2020-12-31;12;0;103;1;0.0;0.0
FR;49;2021-01-01;18;0;121;1;0.0;0.0
FR;49;2021-01-02;20;0;141;1;0.0;0.0
FR;49;2021-01-03;17;0;158;1;0.0;0.0
FR;49;2021-01-04;117;0;275;1;0.0;0.0
FR;49;2021-01-05;360;1;635;2;0.0;0.0
FR;49;2021-01-06;883;9;1518;11;0.0;0.0
FR;49;2021-01-07;2185;11;3703;22;0.0;0.0
FR;49;2021-01-08;3409;12;7112;34;0.1;0.0
FR;49;2021-01-09;1018;4;8130;38;0.1;0.0
FR;49;2021-01-10;489;3;8619;41;0.1;0.0
FR;49;2021-01-11;4214;21;12833;62;0.1;0.0
FR;49;2021-01-12;5906;20;18739;82;0.2;0.0
FR;49;2021-01-13;6225;36;24964;118;0.3;0.0
FR;49;2021-01-14;8500;92;33464;210;0.4;0.0
FR;49;2021-01-15;7680;56;41144;266;0.5;0.0
FR;49;2021-01-16;1439;12;42583;278;0.5;0.0
FR;49;2021-01-17;652;9;43235;287;0.5;0.0
FR;49;2021-01-18;5139;54;48374;341;0.6;0.0
FR;49;2021-01-19;6936;57;55310;398;0.6;0.0
FR;49;2021-01-20;6730;48;62040;446;0.7;0.0
FR;49;2021-01-21;8526;69;70566;515;0.8;0.0
FR;49;2021-01-22;6361;73;76927;588;0.9;0.0
FR;49;2021-01-23;1051;8;77978;596;0.9;0.0
FR;49;2021-01-24;303;5;78281;601;0.9;0.0
FR;49;2021-01-25;2668;114;80949;715;0.9;0.0
FR;49;2021-01-26;3770;239;84719;954;1.0;0.0
FR;49;2021-01-27;4027;410;88746;1364;1.0;0.0
FR;49;2021-01-28;5620;1009;94366;2373;1.1;0.0
FR;49;2021-01-29;4455;1584;98821;3957;1.2;0.0
FR;49;2021-01-30;710;373;99531;4330;1.2;0.1
FR;49;2021-01-31;153;123;99684;4453;1.2;0.1
FR;49;2021-02-01;1410;2073;101094;6526;1.2;0.1
FR;49;2021-02-02;2336;3197;103430;9723;1.2;0.1
FR;49;2021-02-03;2343;3377;105773;13100;1.2;0.2
FR;49;2021-02-04;3436;4785;109209;17885;1.3;0.2
FR;49;2021-02-05;2844;4879;112053;22764;1.3;0.3
FR;49;2021-02-06;638;886;112691;23650;1.3;0.3
FR;49;2021-02-07;541;302;113232;23952;1.3;0.3
FR;49;2021-02-08;1965;4063;115197;28015;1.3;0.3
FR;49;2021-02-09;4378;5818;119575;33833;1.4;0.4
FR;49;2021-02-10;5588;6125;125163;39958;1.5;0.5
FR;49;2021-02-11;8094;8122;133257;48080;1.6;0.6
FR;49;2021-02-12;7379;6555;140636;54635;1.6;0.6
FR;49;2021-02-13;1718;1061;142354;55696;1.7;0.6
FR;49;2021-02-14;436;405;142790;56101;1.7;0.7
FR;49;2021-02-15;4164;3932;146954;60033;1.7;0.7
FR;49;2021-02-16;5446;5413;152400;65446;1.8;0.8
FR;49;2021-02-17;5190;4732;157590;70178;1.8;0.8
FR;49;2021-02-18;7579;6304;165169;76482;1.9;0.9
FR;49;2021-02-19;7143;5013;172312;81495;2.0;0.9
FR;49;2021-02-20;1528;818;173840;82313;2.0;1.0
FR;49;2021-02-21;317;226;174157;82539;2.0;1.0
FR;49;2021-02-22;3599;2694;177756;85233;2.1;1.0
FR;49;2021-02-23;4949;3214;182705;88447;2.1;1.0
FR;49;2021-02-24;5052;2921;187757;91368;2.2;1.1
FR;49;2021-02-25;7726;4350;195483;95718;2.3;1.1
FR;49;2021-02-26;8376;3311;203859;99029;2.4;1.2
FR;49;2021-02-27;2743;614;206602;99643;2.4;1.2
FR;49;2021-02-28;383;144;206985;99787;2.4;1.2
FR;49;2021-03-01;3965;1728;210950;101515;2.5;1.2
FR;49;2021-03-02;5900;2625;216850;104140;2.5;1.2
FR;49;2021-03-03;6200;2673;223050;106813;2.6;1.2
FR;49;2021-03-04;9174;3761;232224;110574;2.7;1.3
FR;49;2021-03-05;12813;3637;245037;114211;2.9;1.3
FR;49;2021-03-06;8769;806;253806;115017;3.0;1.3
FR;49;2021-03-07;4759;518;258565;115535;3.0;1.3
FR;49;2021-03-08;6566;1884;265131;117419;3.1;1.4
FR;49;2021-03-09;9781;2660;274912;120079;3.2;1.4
FR;49;2021-03-10;9164;2640;284076;122719;3.3;1.4
FR;49;2021-03-11;13073;3906;297149;126625;3.5;1.5
FR;49;2021-03-12;16731;3504;313880;130129;3.7;1.5
FR;49;2021-03-13;9686;844;323566;130973;3.8;1.5
FR;49;2021-03-14;3235;340;326801;131313;3.8;1.5
FR;49;2021-03-15;7054;1606;333855;132919;3.9;1.5
FR;49;2021-03-16;4764;2240;338619;135159;3.9;1.6
FR;49;2021-03-17;5333;2155;343952;137314;4.0;1.6
FR;49;2021-03-18;6745;2968;350697;140282;4.1;1.6
FR;49;2021-03-19;9788;2534;360485;142816;4.2;1.7
FR;49;2021-03-20;6053;685;366538;143501;4.3;1.7
FR;49;2021-03-21;3252;294;369790;143795;4.3;1.7
FR;49;2021-03-22;6554;1634;376344;145429;4.4;1.7
FR;49;2021-03-23;8843;2334;385187;147763;4.5;1.7
FR;49;2021-03-24;9770;2180;394957;149943;4.6;1.7
FR;49;2021-03-25;12589;2637;407546;152580;4.7;1.8
FR;49;2021-03-26;15023;2691;422569;155271;4.9;1.8
FR;49;2021-03-27;9524;1071;432093;156342;5.0;1.8
FR;49;2021-03-28;3932;389;436025;156731;5.1;1.8
FR;49;2021-03-29;10103;2037;446128;158768;5.2;1.8
FR;49;2021-03-30;14532;3079;460660;161847;5.4;1.9
FR;49;2021-03-31;15842;3177;476502;165024;5.5;1.9
FR;49;2021-04-01;20229;4217;496731;169241;5.8;2.0
FR;49;2021-04-02;17765;3894;514496;173135;6.0;2.0
FR;49;2021-04-03;9499;1978;523995;175113;6.1;2.0
FR;49;2021-04-04;4213;695;528208;175808;6.1;2.0
FR;49;2021-04-05;4366;610;532574;176418;6.2;2.1
FR;49;2021-04-06;13478;3609;546052;180027;6.4;2.1
FR;49;2021-04-07;17944;4566;563996;184593;6.6;2.1
FR;49;2021-04-08;22765;5699;586761;190292;6.8;2.2
FR;49;2021-04-09;23892;5876;610653;196168;7.1;2.3
FR;49;2021-04-10;12570;3531;623223;199699;7.3;2.3
FR;49;2021-04-11;4589;1744;627812;201443;7.3;2.3
FR;49;2021-04-12;14375;3968;642187;205411;7.5;2.4
FR;49;2021-04-13;19047;6029;661234;211440;7.7;2.5
FR;49;2021-04-14;19754;6247;680988;217687;7.9;2.5
FR;49;2021-04-15;20648;7446;701636;225133;8.2;2.6
FR;49;2021-04-16;17848;7634;719484;232767;8.4;2.7
FR;49;2021-04-17;10044;4767;729528;237534;8.5;2.8
FR;49;2021-04-18;3462;2341;732990;239875;8.5;2.8
FR;49;2021-04-19;12284;6543;745274;246418;8.7;2.9
FR;49;2021-04-20;14422;9239;759696;255657;8.8;3.0
FR;49;2021-04-21;16363;10387;776059;266044;9.0;3.1
FR;49;2021-04-22;17947;13450;794006;279494;9.2;3.3
FR;49;2021-04-23;18826;14799;812832;294293;9.5;3.4
FR;49;2021-04-24;12796;7938;825628;302231;9.6;3.5
FR;49;2021-04-25;5583;3206;831211;305437;9.7;3.6
FR;49;2021-04-26;13964;10108;845175;315545;9.8;3.7
FR;49;2021-04-27;18942;13332;864117;328877;10.1;3.8
FR;49;2021-04-28;23021;14935;887138;343812;10.3;4.0
FR;49;2021-04-29;28039;17735;915177;361547;10.7;4.2
FR;49;2021-04-30;32317;18514;947494;380061;11.0;4.4
FR;49;2021-05-01;24496;6020;971990;386081;11.3;4.5
FR;49;2021-05-02;16678;4057;988668;390138;11.5;4.5
FR;49;2021-05-03;40164;15858;1028832;405996;12.0;4.7
FR;49;2021-05-04;47146;20693;1075978;426689;12.5;5.0
FR;49;2021-05-05;56486;22078;1132464;448767;13.2;5.2
FR;49;2021-05-06;63041;25210;1195505;473977;13.9;5.5
FR;49;2021-05-07;66465;26544;1261970;500521;14.7;5.8
FR;49;2021-05-08;54189;9736;1316159;510257;15.3;5.9
FR;49;2021-05-09;32485;6479;1348644;516736;15.7;6.0
FR;49;2021-05-10;58184;21137;1406828;537873;16.4;6.3
FR;49;2021-05-11;72821;24416;1479649;562289;17.2;6.5
FR;49;2021-05-12;91775;24725;1571424;587014;18.3;6.8
FR;49;2021-05-13;81133;8192;1652557;595206;19.2;6.9
FR;49;2021-05-14;97714;16427;1750271;611633;20.4;7.1
FR;49;2021-05-15;87455;11511;1837726;623144;21.4;7.3
FR;49;2021-05-16;53511;4843;1891237;627987;22.0;7.3
FR;49;2021-05-17;82890;16890;1974127;644877;23.0;7.5
FR;49;2021-05-18;100425;18674;2074552;663551;24.1;7.7
FR;49;2021-05-19;111532;20185;2186084;683736;25.4;8.0
FR;49;2021-05-20;115407;20591;2301491;704327;26.8;8.2
FR;49;2021-05-21;114670;20728;2416161;725055;28.1;8.4
FR;49;2021-05-22;88063;11000;2504224;736055;29.1;8.6
FR;49;2021-05-23;43210;4255;2547434;740310;29.6;8.6
FR;49;2021-05-24;67804;7163;2615238;747473;30.4;8.7
FR;49;2021-05-25;95676;21387;2710914;768860;31.5;8.9
FR;49;2021-05-26;103343;23448;2814257;792308;32.8;9.2
FR;49;2021-05-27;105344;24618;2919601;816926;34.0;9.5
FR;49;2021-05-28;100782;27269;3020383;844195;35.1;9.8
FR;49;2021-05-29;74655;15860;3095038;860055;36.0;10.0
FR;49;2021-05-30;26996;4842;3122034;864897;36.3;10.1
FR;49;2021-05-31;88284;21681;3210318;886578;37.4;10.3
FR;49;2021-06-01;101835;26933;3312153;913511;38.5;10.6
FR;49;2021-06-02;103745;27149;3415898;940660;39.8;10.9
FR;49;2021-06-03;110229;28433;3526127;969093;41.0;11.3
FR;49;2021-06-04;110251;31862;3636378;1000955;42.3;11.6
FR;49;2021-06-05;75197;21213;3711575;1022168;43.2;11.9
FR;49;2021-06-06;32323;7712;3743898;1029880;43.6;12.0
FR;49;2021-06-07;78618;28070;3822516;1057950;44.5;12.3
FR;49;2021-06-08;89380;31205;3911896;1089155;45.5;12.7
FR;49;2021-06-09;90213;36005;4002109;1125160;46.6;13.1
FR;49;2021-06-10;89425;37100;4091534;1162260;47.6;13.5
FR;49;2021-06-11;88897;46648;4180431;1208908;48.6;14.1
FR;49;2021-06-12;66009;38485;4246440;1247393;49.4;14.5
FR;49;2021-06-13;23893;18123;4270333;1265516;49.7;14.7
FR;49;2021-06-14;51649;56833;4321982;1322349;50.3;15.4
FR;49;2021-06-15;59767;61445;4381749;1383794;51.0;16.1
FR;49;2021-06-16;58326;69605;4440075;1453399;51.7;16.9
FR;49;2021-06-17;60858;63752;4500933;1517151;52.4;17.7
FR;49;2021-06-18;59143;79729;4560076;1596880;53.1;18.6
FR;49;2021-06-19;39381;63643;4599457;1660523;53.5;19.3
FR;49;2021-06-20;12165;27097;4611622;1687620;53.7;19.6
FR;49;2021-06-21;33818;80959;4645440;1768579;54.1;20.6
FR;49;2021-06-22;38729;90835;4684169;1859414;54.5;21.6
FR;49;2021-06-23;37843;100749;4722012;1960163;55.0;22.8
FR;49;2021-06-24;41844;85106;4763856;2045269;55.4;23.8
FR;49;2021-06-25;40085;109972;4803941;2155241;55.9;25.1
FR;49;2021-06-26;26722;89834;4830663;2245075;56.2;26.1
FR;49;2021-06-27;9762;42093;4840425;2287168;56.3;26.6
FR;49;2021-06-28;25320;100530;4865745;2387698;56.6;27.8
FR;49;2021-06-29;29687;109296;4895432;2496994;57.0;29.1
FR;49;2021-06-30;31830;116184;4927262;2613178;57.3;30.4
FR;49;2021-07-01;36127;101571;4963389;2714749;57.8;31.6
FR;49;2021-07-02;38682;116567;5002071;2831316;58.2;32.9
FR;49;2021-07-03;25227;93883;5027298;2925199;58.5;34.0
FR;49;2021-07-04;10053;38060;5037351;2963259;58.6;34.5
FR;49;2021-07-05;27251;99155;5064602;3062414;58.9;35.6
FR;49;2021-07-06;32705;107567;5097307;3169981;59.3;36.9
FR;49;2021-07-07;35911;109949;5133218;3279930;59.7;38.2
FR;49;2021-07-08;39379;94812;5172597;3374742;60.2;39.3
FR;49;2021-07-09;40589;117593;5213186;3492335;60.7;40.6
FR;49;2021-07-10;27564;82392;5240750;3574727;61.0;41.6
FR;49;2021-07-11;10528;27326;5251278;3602053;61.1;41.9
FR;49;2021-07-12;27873;116011;5279151;3718064;61.4;43.3
FR;49;2021-07-13;46691;127248;5325842;3845312;62.0;44.7
FR;49;2021-07-14;29812;40750;5355654;3886062;62.3;45.2
FR;49;2021-07-15;55416;117180;5411070;4003242;63.0;46.6
FR;49;2021-07-16;62404;116558;5473474;4119800;63.7;47.9
FR;49;2021-07-17;44031;77745;5517505;4197545;64.2;48.8
FR;49;2021-07-18;17422;27697;5534927;4225242;64.4;49.2
FR;49;2021-07-19;44675;98499;5579602;4323741;64.9;50.3
FR;49;2021-07-20;60439;102191;5640041;4425932;65.6;51.5
FR;49;2021-07-21;63942;93104;5703983;4519036;66.4;52.6
FR;49;2021-07-22;71719;84644;5775702;4603680;67.2;53.6
FR;49;2021-07-23;72813;95044;5848515;4698724;68.1;54.7
FR;49;2021-07-24;48364;62041;5896879;4760765;68.6;55.4
FR;49;2021-07-25;19911;18654;5916790;4779419;68.9;55.6
FR;49;2021-07-26;56062;70447;5972852;4849866;69.5;56.4
FR;49;2021-07-27;74827;70969;6047679;4920835;70.4;57.3
FR;49;2021-07-28;74832;64171;6122511;4985006;71.3;58.0
FR;49;2021-07-29;79222;60649;6201733;5045655;72.2;58.7
FR;49;2021-07-30;75303;66949;6277036;5112604;73.0;59.5
FR;49;2021-07-31;47470;41900;6324506;5154504;73.6;60.0
FR;49;2021-08-01;17521;11582;6342027;5166086;73.8;60.1
FR;49;2021-08-02;51046;48724;6393073;5214810;74.4;60.7
FR;49;2021-08-03;61962;51058;6455035;5265868;75.1;61.3
FR;49;2021-08-04;59697;44412;6514732;5310280;75.8;61.8
FR;49;2021-08-05;57077;46860;6571809;5357140;76.5;62.3
FR;49;2021-08-06;58421;56450;6630230;5413590;77.2;63.0
FR;49;2021-08-07;35295;37022;6665525;5450612;77.6;63.4
FR;49;2021-08-08;11364;12245;6676889;5462857;77.7;63.6
FR;49;2021-08-09;40057;48667;6716946;5511524;78.2;64.1
FR;49;2021-08-10;47674;52312;6764620;5563836;78.7;64.7
FR;49;2021-08-11;43754;49448;6808374;5613284;79.2;65.3
FR;49;2021-08-12;42513;51887;6850887;5665171;79.7;65.9
FR;49;2021-08-13;40025;52053;6890912;5717224;80.2;66.5
FR;49;2021-08-14;23266;37537;6914178;5754761;80.5;67.0
FR;49;2021-08-15;5802;8961;6919980;5763722;80.5;67.1
FR;49;2021-08-16;27442;56404;6947422;5820126;80.9;67.7
FR;49;2021-08-17;32733;59775;6980155;5879901;81.2;68.4
FR;49;2021-08-18;29551;57918;7009706;5937819;81.6;69.1
FR;49;2021-08-19;28434;58349;7038140;5996168;81.9;69.8
FR;49;2021-08-20;27726;66873;7065866;6063041;82.2;70.6
FR;49;2021-08-21;15637;43645;7081503;6106686;82.4;71.1
FR;49;2021-08-22;4408;15037;7085911;6121723;82.5;71.2
FR;49;2021-08-23;19331;60644;7105242;6182367;82.7;71.9
FR;09;2020-12-27;0;0;0;0;0.0;0.0
FR;09;2020-12-28;0;0;0;0;0.0;0.0
FR;09;2020-12-29;0;0;0;0;0.0;0.0
FR;09;2020-12-30;0;0;0;0;0.0;0.0
FR;09;2020-12-31;0;0;0;0;0.0;0.0
FR;09;2021-01-01;0;0;0;0;0.0;0.0
FR;09;2021-01-02;0;0;0;0;0.0;0.0
FR;09;2021-01-03;0;0;0;0;0.0;0.0
FR;09;2021-01-04;0;0;0;0;0.0;0.0
FR;09;2021-01-05;0;0;0;0;0.0;0.0
FR;09;2021-01-06;0;0;0;0;0.0;0.0
FR;09;2021-01-07;0;0;0;0;0.0;0.0
FR;09;2021-01-08;0;0;0;0;0.0;0.0
FR;09;2021-01-09;0;0;0;0;0.0;0.0
FR;09;2021-01-10;0;0;0;0;0.0;0.0
FR;09;2021-01-11;1;0;1;0;0.0;0.0
FR;09;2021-01-12;2;0;3;0;0.0;0.0
FR;09;2021-01-13;1;0;4;0;0.0;0.0
FR;09;2021-01-14;0;0;4;0;0.0;0.0
FR;09;2021-01-15;2;0;6;0;0.0;0.0
FR;09;2021-01-16;1;0;7;0;0.0;0.0
FR;09;2021-01-17;0;0;7;0;0.0;0.0
FR;09;2021-01-18;0;0;7;0;0.0;0.0
FR;09;2021-01-19;2;0;9;0;0.0;0.0
FR;09;2021-01-20;3;0;12;0;0.0;0.0
FR;09;2021-01-21;2;0;14;0;0.0;0.0
FR;09;2021-01-22;0;0;14;0;0.0;0.0
FR;09;2021-01-23;1;0;15;0;0.0;0.0
FR;09;2021-01-24;0;0;15;0;0.0;0.0
FR;09;2021-01-25;1;0;16;0;0.0;0.0
FR;09;2021-01-26;0;0;16;0;0.0;0.0
FR;09;2021-01-27;1;0;17;0;0.0;0.0
FR;09;2021-01-28;6;0;23;0;0.0;0.0
FR;09;2021-01-29;2;0;25;0;0.0;0.0
FR;09;2021-01-30;0;0;25;0;0.0;0.0
FR;09;2021-01-31;0;0;25;0;0.0;0.0
FR;09;2021-02-01;0;0;25;0;0.0;0.0
FR;09;2021-02-02;0;0;25;0;0.0;0.0
FR;09;2021-02-03;2;0;27;0;0.0;0.0
FR;09;2021-02-04;1;1;28;1;0.0;0.0
FR;09;2021-02-05;1;0;29;1;0.0;0.0
FR;09;2021-02-06;1;0;30;1;0.0;0.0
FR;09;2021-02-07;0;0;30;1;0.0;0.0
FR;09;2021-02-08;3;0;33;1;0.0;0.0
FR;09;2021-02-09;2;0;35;1;0.0;0.0
FR;09;2021-02-10;0;0;35;1;0.0;0.0
FR;09;2021-02-11;4;0;39;1;0.0;0.0
FR;09;2021-02-12;5;0;44;1;0.0;0.0
FR;09;2021-02-13;1;0;45;1;0.0;0.0
FR;09;2021-02-14;0;0;45;1;0.0;0.0
FR;09;2021-02-15;0;0;45;1;0.0;0.0
FR;09;2021-02-16;2;1;47;2;0.0;0.0
FR;09;2021-02-17;0;1;47;3;0.0;0.0
FR;09;2021-02-18;0;0;47;3;0.0;0.0
FR;09;2021-02-19;0;0;47;3;0.0;0.0
FR;09;2021-02-20;2;0;49;3;0.0;0.0
FR;09;2021-02-21;0;0;49;3;0.0;0.0
FR;09;2021-02-22;0;1;49;4;0.0;0.0
FR;09;2021-02-23;2;0;51;4;0.0;0.0
FR;09;2021-02-24;0;1;51;5;0.0;0.0
FR;09;2021-02-25;2;1;53;6;0.0;0.0
FR;09;2021-02-26;6;0;59;6;0.0;0.0
FR;09;2021-02-27;5;0;64;6;0.0;0.0
FR;09;2021-02-28;0;0;64;6;0.0;0.0
FR;09;2021-03-01;3;1;67;7;0.0;0.0
FR;09;2021-03-02;5;1;72;8;0.0;0.0
FR;09;2021-03-03;1;0;73;8;0.0;0.0
FR;09;2021-03-04;2;0;75;8;0.0;0.0
FR;09;2021-03-05;8;0;83;8;0.0;0.0
FR;09;2021-03-06;3;0;86;8;0.0;0.0
FR;09;2021-03-07;2;0;88;8;0.0;0.0
FR;09;2021-03-08;1;0;89;8;0.0;0.0
FR;09;2021-03-09;2;0;91;8;0.0;0.0
FR;09;2021-03-10;0;0;91;8;0.0;0.0
FR;09;2021-03-11;3;0;94;8;0.0;0.0
FR;09;2021-03-12;11;3;105;11;0.0;0.0
FR;09;2021-03-13;3;0;108;11;0.0;0.0
FR;09;2021-03-14;0;0;108;11;0.0;0.0
FR;09;2021-03-15;2;0;110;11;0.0;0.0
FR;09;2021-03-16;2;1;112;12;0.0;0.0
FR;09;2021-03-17;2;0;114;12;0.0;0.0
FR;09;2021-03-18;3;1;117;13;0.0;0.0
FR;09;2021-03-19;2;0;119;13;0.0;0.0
FR;09;2021-03-20;0;0;119;13;0.0;0.0
FR;09;2021-03-21;0;0;119;13;0.0;0.0
FR;09;2021-03-22;2;0;121;13;0.0;0.0
FR;09;2021-03-23;3;1;124;14;0.0;0.0
FR;09;2021-03-24;3;1;127;15;0.0;0.0
FR;09;2021-03-25;4;0;131;15;0.0;0.0
FR;09;2021-03-26;2;0;133;15;0.0;0.0
FR;09;2021-03-27;1;0;134;15;0.0;0.0
FR;09;2021-03-28;2;0;136;15;0.0;0.0
FR;09;2021-03-29;5;0;141;15;0.0;0.0
FR;09;2021-03-30;6;0;147;15;0.0;0.0
FR;09;2021-03-31;2;1;149;16;0.0;0.0
FR;09;2021-04-01;7;0;156;16;0.0;0.0
FR;09;2021-04-02;9;0;165;16;0.0;0.0
FR;09;2021-04-03;1;0;166;16;0.0;0.0
FR;09;2021-04-04;0;0;166;16;0.0;0.0
FR;09;2021-04-05;1;1;167;17;0.0;0.0
FR;09;2021-04-06;4;0;171;17;0.0;0.0
FR;09;2021-04-07;5;1;176;18;0.0;0.0
FR;09;2021-04-08;7;1;183;19;0.0;0.0
FR;09;2021-04-09;6;1;189;20;0.0;0.0
FR;09;2021-04-10;6;0;195;20;0.0;0.0
FR;09;2021-04-11;0;0;195;20;0.0;0.0
FR;09;2021-04-12;3;2;198;22;0.0;0.0
FR;09;2021-04-13;5;1;203;23;0.0;0.0
FR;09;2021-04-14;13;2;216;25;0.0;0.0
FR;09;2021-04-15;7;1;223;26;0.0;0.0
FR;09;2021-04-16;9;0;232;26;0.0;0.0
FR;09;2021-04-17;2;2;234;28;0.0;0.0
FR;09;2021-04-18;1;0;235;28;0.0;0.0
FR;09;2021-04-19;6;1;241;29;0.0;0.0
FR;09;2021-04-20;5;4;246;33;0.0;0.0
FR;09;2021-04-21;6;0;252;33;0.0;0.0
FR;09;2021-04-22;8;0;260;33;0.0;0.0
FR;09;2021-04-23;3;0;263;33;0.0;0.0
FR;09;2021-04-24;5;0;268;33;0.0;0.0
FR;09;2021-04-25;2;0;270;33;0.0;0.0
FR;09;2021-04-26;3;2;273;35;0.0;0.0
FR;09;2021-04-27;8;1;281;36;0.0;0.0
FR;09;2021-04-28;5;1;286;37;0.0;0.0
FR;09;2021-04-29;6;0;292;37;0.0;0.0
FR;09;2021-04-30;8;2;300;39;0.0;0.0
FR;09;2021-05-01;2;1;302;40;0.0;0.0
FR;09;2021-05-02;2;0;304;40;0.0;0.0
FR;09;2021-05-03;8;1;312;41;0.0;0.0
FR;09;2021-05-04;11;1;323;42;0.0;0.0
FR;09;2021-05-05;13;3;336;45;0.0;0.0
FR;09;2021-05-06;14;0;350;45;0.0;0.0
FR;09;2021-05-07;11;4;361;49;0.0;0.0
FR;09;2021-05-08;8;0;369;49;0.0;0.0
FR;09;2021-05-09;3;1;372;50;0.0;0.0
FR;09;2021-05-10;13;2;385;52;0.0;0.0
FR;09;2021-05-11;17;1;402;53;0.0;0.0
FR;09;2021-05-12;20;2;422;55;0.0;0.0
FR;09;2021-05-13;7;0;429;55;0.0;0.0
FR;09;2021-05-14;30;1;459;56;0.0;0.0
FR;09;2021-05-15;12;0;471;56;0.0;0.0
FR;09;2021-05-16;10;1;481;57;0.0;0.0
FR;09;2021-05-17;17;0;498;57;0.0;0.0
FR;09;2021-05-18;17;2;515;59;0.0;0.0
FR;09;2021-05-19;15;4;530;63;0.0;0.0
FR;09;2021-05-20;18;3;548;66;0.0;0.0
FR;09;2021-05-21;21;3;569;69;0.0;0.0
FR;09;2021-05-22;9;1;578;70;0.0;0.0
FR;09;2021-05-23;7;0;585;70;0.0;0.0
FR;09;2021-05-24;14;0;599;70;0.0;0.0
FR;09;2021-05-25;24;1;623;71;0.0;0.0
FR;09;2021-05-26;14;2;637;73;0.0;0.0
FR;09;2021-05-27;26;3;663;76;0.0;0.0
FR;09;2021-05-28;25;3;688;79;0.0;0.0
FR;09;2021-05-29;14;1;702;80;0.0;0.0
FR;09;2021-05-30;9;0;711;80;0.0;0.0
FR;09;2021-05-31;23;5;734;85;0.0;0.0
FR;09;2021-06-01;24;2;758;87;0.0;0.0
FR;09;2021-06-02;18;4;776;91;0.0;0.0
FR;09;2021-06-03;27;6;803;97;0.0;0.0
FR;09;2021-06-04;15;1;818;98;0.0;0.0
FR;09;2021-06-05;18;1;836;99;0.0;0.0
FR;09;2021-06-06;9;0;845;99;0.0;0.0
FR;09;2021-06-07;10;1;855;100;0.0;0.0
FR;09;2021-06-08;20;0;875;100;0.0;0.0
FR;09;2021-06-09;24;1;899;101;0.0;0.0
FR;09;2021-06-10;21;4;920;105;0.0;0.0
FR;09;2021-06-11;17;2;937;107;0.0;0.0
FR;09;2021-06-12;12;0;949;107;0.0;0.0
FR;09;2021-06-13;3;0;952;107;0.0;0.0
FR;09;2021-06-14;8;3;960;110;0.0;0.0
FR;09;2021-06-15;12;0;972;110;0.0;0.0
FR;09;2021-06-16;21;2;993;112;0.0;0.0
FR;09;2021-06-17;11;4;1004;116;0.0;0.0
FR;09;2021-06-18;28;3;1032;119;0.0;0.0
FR;09;2021-06-19;13;3;1045;122;0.0;0.0
FR;09;2021-06-20;5;1;1050;123;0.0;0.0
FR;09;2021-06-21;8;1;1058;124;0.0;0.0
FR;09;2021-06-22;12;5;1070;129;0.0;0.0
FR;09;2021-06-23;17;1;1087;130;0.0;0.0
FR;09;2021-06-24;13;4;1100;134;0.0;0.0
FR;09;2021-06-25;7;2;1107;136;0.0;0.0
FR;09;2021-06-26;13;4;1120;140;0.0;0.0
FR;09;2021-06-27;2;2;1122;142;0.0;0.0
FR;09;2021-06-28;9;3;1131;145;0.0;0.0
FR;09;2021-06-29;10;4;1141;149;0.0;0.0
FR;09;2021-06-30;13;5;1154;154;0.0;0.0
FR;09;2021-07-01;19;4;1173;158;0.0;0.0
FR;09;2021-07-02;13;7;1186;165;0.0;0.0
FR;09;2021-07-03;11;4;1197;169;0.0;0.0
FR;09;2021-07-04;5;0;1202;169;0.0;0.0
FR;09;2021-07-05;10;3;1212;172;0.0;0.0
FR;09;2021-07-06;20;6;1232;178;0.0;0.0
FR;09;2021-07-07;15;2;1247;180;0.0;0.0
FR;09;2021-07-08;15;4;1262;184;0.0;0.0
FR;09;2021-07-09;19;8;1281;192;0.0;0.0
FR;09;2021-07-10;7;4;1288;196;0.0;0.0
FR;09;2021-07-11;2;1;1290;197;0.0;0.0
FR;09;2021-07-12;15;10;1305;207;0.0;0.0
FR;09;2021-07-13;18;9;1323;216;0.0;0.0
FR;09;2021-07-14;15;4;1338;220;0.0;0.0
FR;09;2021-07-15;20;9;1358;229;0.0;0.0
FR;09;2021-07-16;22;12;1380;241;0.0;0.0
FR;09;2021-07-17;15;4;1395;245;0.0;0.0
FR;09;2021-07-18;2;0;1397;245;0.0;0.0
FR;09;2021-07-19;15;5;1412;250;0.0;0.0
FR;09;2021-07-20;19;8;1431;258;0.0;0.0
FR;09;2021-07-21;14;11;1445;269;0.0;0.0
FR;09;2021-07-22;13;8;1458;277;0.0;0.0
FR;09;2021-07-23;27;5;1485;282;0.0;0.0
FR;09;2021-07-24;17;9;1502;291;0.0;0.0
FR;09;2021-07-25;3;4;1505;295;0.0;0.0
FR;09;2021-07-26;26;9;1531;304;0.0;0.0
FR;09;2021-07-27;7;2;1538;306;0.0;0.0
FR;09;2021-07-28;10;7;1548;313;0.0;0.0
FR;09;2021-07-29;12;5;1560;318;0.0;0.0
FR;09;2021-07-30;15;4;1575;322;0.0;0.0
FR;09;2021-07-31;10;4;1585;326;0.0;0.0
FR;09;2021-08-01;3;0;1588;326;0.0;0.0
FR;09;2021-08-02;6;1;1594;327;0.0;0.0
FR;09;2021-08-03;16;5;1610;332;0.0;0.0
FR;09;2021-08-04;16;8;1626;340;0.0;0.0
FR;09;2021-08-05;10;0;1636;340;0.0;0.0
FR;09;2021-08-06;8;7;1644;347;0.0;0.0
FR;09;2021-08-07;6;2;1650;349;0.0;0.0
FR;09;2021-08-08;4;0;1654;349;0.0;0.0
FR;09;2021-08-09;7;4;1661;353;0.0;0.0
FR;09;2021-08-10;8;3;1669;356;0.0;0.0
FR;09;2021-08-11;6;6;1675;362;0.0;0.0
FR;09;2021-08-12;10;4;1685;366;0.0;0.0
FR;09;2021-08-13;3;0;1688;366;0.0;0.0
FR;09;2021-08-14;3;0;1691;366;0.0;0.0
FR;09;2021-08-15;1;0;1692;366;0.0;0.0
FR;09;2021-08-16;7;5;1699;371;0.0;0.0
FR;09;2021-08-17;5;4;1704;375;0.0;0.0
FR;09;2021-08-18;12;4;1716;379;0.0;0.0
FR;09;2021-08-19;5;4;1721;383;0.0;0.0
FR;09;2021-08-20;6;3;1727;386;0.0;0.0
FR;09;2021-08-21;5;1;1732;387;0.0;0.0
FR;09;2021-08-22;0;1;1732;388;0.0;0.0
FR;09;2021-08-23;8;2;1740;390;0.0;0.0
FR;59;2020-12-27;33;1;33;1;0.0;0.0
FR;59;2020-12-28;36;0;69;1;0.0;0.0
FR;59;2020-12-29;26;0;95;1;0.0;0.0
FR;59;2020-12-30;16;0;111;1;0.0;0.0
FR;59;2020-12-31;27;0;138;1;0.0;0.0
FR;59;2021-01-01;45;0;183;1;0.0;0.0
FR;59;2021-01-02;46;0;229;1;0.0;0.0
FR;59;2021-01-03;64;1;293;2;0.0;0.0
FR;59;2021-01-04;617;6;910;8;0.0;0.0
FR;59;2021-01-05;2212;12;3122;20;0.0;0.0
FR;59;2021-01-06;4859;21;7981;41;0.1;0.0
FR;59;2021-01-07;10585;39;18566;80;0.2;0.0
FR;59;2021-01-08;14418;58;32984;138;0.4;0.0
FR;59;2021-01-09;4095;13;37079;151;0.4;0.0
FR;59;2021-01-10;2009;6;39088;157;0.4;0.0
FR;59;2021-01-11;16086;56;55174;213;0.6;0.0
FR;59;2021-01-12;21280;86;76454;299;0.9;0.0
FR;59;2021-01-13;22879;107;99333;406;1.1;0.0
FR;59;2021-01-14;25026;285;124359;691;1.4;0.0
FR;59;2021-01-15;21767;173;146126;864;1.7;0.0
FR;59;2021-01-16;5461;45;151587;909;1.7;0.0
FR;59;2021-01-17;1838;16;153425;925;1.7;0.0
FR;59;2021-01-18;13704;128;167129;1053;1.9;0.0
FR;59;2021-01-19;18114;155;185243;1208;2.1;0.0
FR;59;2021-01-20;17290;133;202533;1341;2.3;0.0
FR;59;2021-01-21;19019;129;221552;1470;2.5;0.0
FR;59;2021-01-22;14077;148;235629;1618;2.7;0.0
FR;59;2021-01-23;2994;35;238623;1653;2.7;0.0
FR;59;2021-01-24;860;14;239483;1667;2.7;0.0
FR;59;2021-01-25;6770;653;246253;2320;2.8;0.0
FR;59;2021-01-26;8511;1425;254764;3745;2.9;0.0
FR;59;2021-01-27;8910;2445;263674;6190;3.0;0.1
FR;59;2021-01-28;10623;5087;274297;11277;3.1;0.1
FR;59;2021-01-29;7899;6697;282196;17974;3.2;0.2
FR;59;2021-01-30;1781;1512;283977;19486;3.2;0.2
FR;59;2021-01-31;381;548;284358;20034;3.2;0.2
FR;59;2021-02-01;3203;8730;287561;28764;3.3;0.3
FR;59;2021-02-02;4755;12457;292316;41221;3.3;0.5
FR;59;2021-02-03;4871;13528;297187;54749;3.4;0.6
FR;59;2021-02-04;6004;15884;303191;70633;3.4;0.8
FR;59;2021-02-05;4882;14879;308073;85512;3.5;1.0
FR;59;2021-02-06;1253;2993;309326;88505;3.5;1.0
FR;59;2021-02-07;399;984;309725;89489;3.5;1.0
FR;59;2021-02-08;2797;12457;312522;101946;3.6;1.2
FR;59;2021-02-09;4970;16204;317492;118150;3.6;1.3
FR;59;2021-02-10;5808;16074;323300;134224;3.7;1.5
FR;59;2021-02-11;7744;19782;331044;154006;3.8;1.8
FR;59;2021-02-12;6833;16072;337877;170078;3.8;1.9
FR;59;2021-02-13;1714;3449;339591;173527;3.9;2.0
FR;59;2021-02-14;380;986;339971;174513;3.9;2.0
FR;59;2021-02-15;3310;10542;343281;185055;3.9;2.1
FR;59;2021-02-16;4791;13584;348072;198639;4.0;2.3
FR;59;2021-02-17;5013;12367;353085;211006;4.0;2.4
FR;59;2021-02-18;7188;13877;360273;224883;4.1;2.6
FR;59;2021-02-19;6583;10778;366856;235661;4.2;2.7
FR;59;2021-02-20;1452;2464;368308;238125;4.2;2.7
FR;59;2021-02-21;314;576;368622;238701;4.2;2.7
FR;59;2021-02-22;3324;6339;371946;245040;4.2;2.8
FR;59;2021-02-23;4898;7169;376844;252209;4.3;2.9
FR;59;2021-02-24;7011;6477;383855;258686;4.4;2.9
FR;59;2021-02-25;21410;8757;405265;267443;4.6;3.0
FR;59;2021-02-26;28440;6600;433705;274043;4.9;3.1
FR;59;2021-02-27;17233;1761;450938;275804;5.1;3.1
FR;59;2021-02-28;1150;398;452088;276202;5.1;3.1
FR;59;2021-03-01;8981;3614;461069;279816;5.2;3.2
FR;59;2021-03-02;17345;5205;478414;285021;5.4;3.2
FR;59;2021-03-03;20910;5355;499324;290376;5.7;3.3
FR;59;2021-03-04;32634;6445;531958;296821;6.1;3.4
FR;59;2021-03-05;41220;6216;573178;303037;6.5;3.4
FR;59;2021-03-06;36511;2130;609689;305167;6.9;3.5
FR;59;2021-03-07;14306;1352;623995;306519;7.1;3.5
FR;59;2021-03-08;12489;3431;636484;309950;7.2;3.5
FR;59;2021-03-09;23103;4592;659587;314542;7.5;3.6
FR;59;2021-03-10;23426;4773;683013;319315;7.8;3.6
FR;59;2021-03-11;34670;6145;717683;325460;8.2;3.7
FR;59;2021-03-12;45757;5578;763440;331038;8.7;3.8
FR;59;2021-03-13;36418;2020;799858;333058;9.1;3.8
FR;59;2021-03-14;7287;586;807145;333644;9.2;3.8
FR;59;2021-03-15;14705;2763;821850;336407;9.3;3.8
FR;59;2021-03-16;8074;3136;829924;339543;9.4;3.9
FR;59;2021-03-17;8925;3289;838849;342832;9.5;3.9
FR;59;2021-03-18;10653;4162;849502;346994;9.7;3.9
FR;59;2021-03-19;23769;3870;873271;350864;9.9;4.0
FR;59;2021-03-20;21296;1419;894567;352283;10.2;4.0
FR;59;2021-03-21;6380;494;900947;352777;10.2;4.0
FR;59;2021-03-22;15734;2854;916681;355631;10.4;4.0
FR;59;2021-03-23;25747;3840;942428;359471;10.7;4.1
FR;59;2021-03-24;28327;3876;970755;363347;11.0;4.1
FR;59;2021-03-25;38343;4410;1009098;367757;11.5;4.2
FR;59;2021-03-26;43265;4769;1052363;372526;12.0;4.2
FR;59;2021-03-27;27114;2166;1079477;374692;12.3;4.3
FR;59;2021-03-28;7647;588;1087124;375280;12.4;4.3
FR;59;2021-03-29;21916;3596;1109040;378876;12.6;4.3
FR;59;2021-03-30;32430;4841;1141470;383717;13.0;4.4
FR;59;2021-03-31;31740;5153;1173210;388870;13.3;4.4
FR;59;2021-04-01;38817;6415;1212027;395285;13.8;4.5
FR;59;2021-04-02;37184;6312;1249211;401597;14.2;4.6
FR;59;2021-04-03;21445;3684;1270656;405281;14.5;4.6
FR;59;2021-04-04;7428;1299;1278084;406580;14.5;4.6
FR;59;2021-04-05;8391;1218;1286475;407798;14.6;4.6
FR;59;2021-04-06;26020;6194;1312495;413992;14.9;4.7
FR;59;2021-04-07;34170;7589;1346665;421581;15.3;4.8
FR;59;2021-04-08;45385;9051;1392050;430632;15.8;4.9
FR;59;2021-04-09;61214;9909;1453264;440541;16.5;5.0
FR;59;2021-04-10;36685;7452;1489949;447993;16.9;5.1
FR;59;2021-04-11;9852;3634;1499801;451627;17.1;5.1
FR;59;2021-04-12;35572;7775;1535373;459402;17.5;5.2
FR;59;2021-04-13;50170;10721;1585543;470123;18.0;5.3
FR;59;2021-04-14;50575;10746;1636118;480869;18.6;5.5
FR;59;2021-04-15;59911;12493;1696029;493362;19.3;5.6
FR;59;2021-04-16;63767;13171;1759796;506533;20.0;5.8
FR;59;2021-04-17;41739;10102;1801535;516635;20.5;5.9
FR;59;2021-04-18;12372;4739;1813907;521374;20.6;5.9
FR;59;2021-04-19;33459;11487;1847366;532861;21.0;6.1
FR;59;2021-04-20;45045;15195;1892411;548056;21.5;6.2
FR;59;2021-04-21;47793;17019;1940204;565075;22.1;6.4
FR;59;2021-04-22;56393;20214;1996597;585289;22.7;6.7
FR;59;2021-04-23;66247;21924;2062844;607213;23.5;6.9
FR;59;2021-04-24;47763;15975;2110607;623188;24.0;7.1
FR;59;2021-04-25;16765;5597;2127372;628785;24.2;7.2
FR;59;2021-04-26;41779;17830;2169151;646615;24.7;7.4
FR;59;2021-04-27;56949;23799;2226100;670414;25.3;7.6
FR;59;2021-04-28;64767;26596;2290867;697010;26.1;7.9
FR;59;2021-04-29;78648;32401;2369515;729411;26.9;8.3
FR;59;2021-04-30;93120;37450;2462635;766861;28.0;8.7
FR;59;2021-05-01;43850;11461;2506485;778322;28.5;8.9
FR;59;2021-05-02;23605;7465;2530090;785787;28.8;8.9
FR;59;2021-05-03;63215;26709;2593305;812496;29.5;9.2
FR;59;2021-05-04;71727;34884;2665032;847380;30.3;9.6
FR;59;2021-05-05;78132;37883;2743164;885263;31.2;10.1
FR;59;2021-05-06;90068;44383;2833232;929646;32.2;10.6
FR;59;2021-05-07;98620;54516;2931852;984162;33.3;11.2
FR;59;2021-05-08;61316;17084;2993168;1001246;34.0;11.4
FR;59;2021-05-09;39552;10618;3032720;1011864;34.5;11.5
FR;59;2021-05-10;96624;40619;3129344;1052483;35.6;12.0
FR;59;2021-05-11;126565;50032;3255909;1102515;37.0;12.5
FR;59;2021-05-12;124606;46942;3380515;1149457;38.4;13.1
FR;59;2021-05-13;93189;14873;3473704;1164330;39.5;13.2
FR;59;2021-05-14;130074;34967;3603778;1199297;41.0;13.6
FR;59;2021-05-15;115112;26010;3718890;1225307;42.3;13.9
FR;59;2021-05-16;55573;7406;3774463;1232713;42.9;14.0
FR;59;2021-05-17;106245;31160;3880708;1263873;44.1;14.4
FR;59;2021-05-18;119229;34892;3999937;1298765;45.5;14.8
FR;59;2021-05-19;119728;36171;4119665;1334936;46.9;15.2
FR;59;2021-05-20;123614;42915;4243279;1377851;48.3;15.7
FR;59;2021-05-21;122966;49251;4366245;1427102;49.7;16.2
FR;59;2021-05-22;82370;25741;4448615;1452843;50.6;16.5
FR;59;2021-05-23;31471;5306;4480086;1458149;51.0;16.6
FR;59;2021-05-24;52461;10126;4532547;1468275;51.5;16.7
FR;59;2021-05-25;85203;42357;4617750;1510632;52.5;17.2
FR;59;2021-05-26;84923;44771;4702673;1555403;53.5;17.7
FR;59;2021-05-27;90919;52773;4793592;1608176;54.5;18.3
FR;59;2021-05-28;92578;66999;4886170;1675175;55.6;19.1
FR;59;2021-05-29;60743;40237;4946913;1715412;56.3;19.5
FR;59;2021-05-30;16278;7881;4963191;1723293;56.4;19.6
FR;59;2021-05-31;59103;42663;5022294;1765956;57.1;20.1
FR;59;2021-06-01;69248;54079;5091542;1820035;57.9;20.7
FR;59;2021-06-02;63690;53127;5155232;1873162;58.6;21.3
FR;59;2021-06-03;70551;58665;5225783;1931827;59.4;22.0
FR;59;2021-06-04;72792;71979;5298575;2003806;60.3;22.8
FR;59;2021-06-05;46281;48906;5344856;2052712;60.8;23.3
FR;59;2021-06-06;14456;12629;5359312;2065341;61.0;23.5
FR;59;2021-06-07;44569;55042;5403881;2120383;61.5;24.1
FR;59;2021-06-08;54099;61759;5457980;2182142;62.1;24.8
FR;59;2021-06-09;51381;65307;5509361;2247449;62.7;25.6
FR;59;2021-06-10;55075;65124;5564436;2312573;63.3;26.3
FR;59;2021-06-11;56682;85406;5621118;2397979;63.9;27.3
FR;59;2021-06-12;39339;56868;5660457;2454847;64.4;27.9
FR;59;2021-06-13;11297;19677;5671754;2474524;64.5;28.1
FR;59;2021-06-14;30927;79438;5702681;2553962;64.9;29.0
FR;59;2021-06-15;36489;85511;5739170;2639473;65.3;30.0
FR;59;2021-06-16;34309;87499;5773479;2726972;65.7;31.0
FR;59;2021-06-17;37634;86346;5811113;2813318;66.1;32.0
FR;59;2021-06-18;38640;113828;5849753;2927146;66.5;33.3
FR;59;2021-06-19;24335;80278;5874088;3007424;66.8;34.2
FR;59;2021-06-20;6188;30786;5880276;3038210;66.9;34.6
FR;59;2021-06-21;20794;114217;5901070;3152427;67.1;35.9
FR;59;2021-06-22;26014;128416;5927084;3280843;67.4;37.3
FR;59;2021-06-23;23904;125362;5950988;3406205;67.7;38.7
FR;59;2021-06-24;28318;106283;5979306;3512488;68.0;39.9
FR;59;2021-06-25;28096;146676;6007402;3659164;68.3;41.6
FR;59;2021-06-26;18157;108953;6025559;3768117;68.5;42.9
FR;59;2021-06-27;5236;39680;6030795;3807797;68.6;43.3
FR;59;2021-06-28;16775;120224;6047570;3928021;68.8;44.7
FR;59;2021-06-29;21212;129319;6068782;4057340;69.0;46.1
FR;59;2021-06-30;21845;123072;6090627;4180412;69.3;47.5
FR;59;2021-07-01;25892;108681;6116519;4289093;69.6;48.8
FR;59;2021-07-02;28407;129713;6144926;4418806;69.9;50.3
FR;59;2021-07-03;17618;90878;6162544;4509684;70.1;51.3
FR;59;2021-07-04;5794;27587;6168338;4537271;70.2;51.6
FR;59;2021-07-05;18850;92990;6187188;4630261;70.4;52.7
FR;59;2021-07-06;23599;106496;6210787;4736757;70.6;53.9
FR;59;2021-07-07;24613;95446;6235400;4832203;70.9;55.0
FR;59;2021-07-08;28760;90681;6264160;4922884;71.2;56.0
FR;59;2021-07-09;31340;114749;6295500;5037633;71.6;57.3
FR;59;2021-07-10;19892;71086;6315392;5108719;71.8;58.1
FR;59;2021-07-11;6521;16874;6321913;5125593;71.9;58.3
FR;59;2021-07-12;20433;83371;6342346;5208964;72.1;59.2
FR;59;2021-07-13;34535;94922;6376881;5303886;72.5;60.3
FR;59;2021-07-14;16825;21137;6393706;5325023;72.7;60.6
FR;59;2021-07-15;41213;87357;6434919;5412380;73.2;61.6
FR;59;2021-07-16;48121;94867;6483040;5507247;73.7;62.6
FR;59;2021-07-17;30762;56618;6513802;5563865;74.1;63.3
FR;59;2021-07-18;10167;15716;6523969;5579581;74.2;63.5
FR;59;2021-07-19;32704;67790;6556673;5647371;74.6;64.2
FR;59;2021-07-20;44285;76487;6600958;5723858;75.1;65.1
FR;59;2021-07-21;45593;65820;6646551;5789678;75.6;65.8
FR;59;2021-07-22;52217;68648;6698768;5858326;76.2;66.6
FR;59;2021-07-23;55003;79105;6753771;5937431;76.8;67.5
FR;59;2021-07-24;34216;44423;6787987;5981854;77.2;68.0
FR;59;2021-07-25;11687;10830;6799674;5992684;77.3;68.2
FR;59;2021-07-26;39543;49176;6839217;6041860;77.8;68.7
FR;59;2021-07-27;54174;55761;6893391;6097621;78.4;69.3
FR;59;2021-07-28;52878;48426;6946269;6146047;79.0;69.9
FR;59;2021-07-29;57724;50896;7003993;6196943;79.7;70.5
FR;59;2021-07-30;57322;56581;7061315;6253524;80.3;71.1
FR;59;2021-07-31;34213;30963;7095528;6284487;80.7;71.5
FR;59;2021-08-01;10474;6909;7106002;6291396;80.8;71.6
FR;59;2021-08-02;36775;34507;7142777;6325903;81.2;71.9
FR;59;2021-08-03;46354;40167;7189131;6366070;81.8;72.4
FR;59;2021-08-04;43773;33150;7232904;6399220;82.3;72.8
FR;59;2021-08-05;43144;35590;7276048;6434810;82.8;73.2
FR;59;2021-08-06;44498;43695;7320546;6478505;83.3;73.7
FR;59;2021-08-07;25419;25754;7345965;6504259;83.5;74.0
FR;59;2021-08-08;7080;7225;7353045;6511484;83.6;74.1
FR;59;2021-08-09;28940;33826;7381985;6545310;84.0;74.4
FR;59;2021-08-10;36304;39027;7418289;6584337;84.4;74.9
FR;59;2021-08-11;32830;34681;7451119;6619018;84.7;75.3
FR;59;2021-08-12;33134;38310;7484253;6657328;85.1;75.7
FR;59;2021-08-13;30513;37959;7514766;6695287;85.5;76.1
FR;59;2021-08-14;16667;25655;7531433;6720942;85.7;76.4
FR;59;2021-08-15;3689;5470;7535122;6726412;85.7;76.5
FR;59;2021-08-16;20484;37526;7555606;6763938;85.9;76.9
FR;59;2021-08-17;24759;42729;7580365;6806667;86.2;77.4
FR;59;2021-08-18;22335;40031;7602700;6846698;86.5;77.9
FR;59;2021-08-19;22499;42161;7625199;6888859;86.7;78.3
FR;59;2021-08-20;21836;48536;7647035;6937395;87.0;78.9
FR;59;2021-08-21;11269;29508;7658304;6966903;87.1;79.2
FR;59;2021-08-22;2668;8806;7660972;6975709;87.1;79.3
FR;59;2021-08-23;13874;40045;7674846;7015754;87.3;79.8
FR;64;2020-12-27;33;1;33;1;0.0;0.0
FR;64;2020-12-28;24;0;57;1;0.0;0.0
FR;64;2020-12-29;11;0;68;1;0.0;0.0
FR;64;2020-12-30;20;0;88;1;0.0;0.0
FR;64;2020-12-31;18;0;106;1;0.0;0.0
FR;64;2021-01-01;21;0;127;1;0.0;0.0
FR;64;2021-01-02;23;0;150;1;0.0;0.0
FR;64;2021-01-03;33;0;183;1;0.0;0.0
FR;64;2021-01-04;221;1;404;2;0.0;0.0
FR;64;2021-01-05;914;5;1318;7;0.0;0.0
FR;64;2021-01-06;1714;9;3032;16;0.1;0.0
FR;64;2021-01-07;3687;15;6719;31;0.2;0.0
FR;64;2021-01-08;4927;18;11646;49;0.3;0.0
FR;64;2021-01-09;1971;2;13617;51;0.3;0.0
FR;64;2021-01-10;1043;1;14660;52;0.4;0.0
FR;64;2021-01-11;5336;13;19996;65;0.5;0.0
FR;64;2021-01-12;7200;22;27196;87;0.7;0.0
FR;64;2021-01-13;7517;27;34713;114;0.8;0.0
FR;64;2021-01-14;8682;103;43395;217;1.1;0.0
FR;64;2021-01-15;7163;51;50558;268;1.2;0.0
FR;64;2021-01-16;2234;21;52792;289;1.3;0.0
FR;64;2021-01-17;858;8;53650;297;1.3;0.0
FR;64;2021-01-18;4722;27;58372;324;1.4;0.0
FR;64;2021-01-19;6467;41;64839;365;1.6;0.0
FR;64;2021-01-20;6320;55;71159;420;1.7;0.0
FR;64;2021-01-21;7021;41;78180;461;1.9;0.0
FR;64;2021-01-22;5495;45;83675;506;2.0;0.0
FR;64;2021-01-23;1432;15;85107;521;2.1;0.0
FR;64;2021-01-24;448;9;85555;530;2.1;0.0
FR;64;2021-01-25;2814;209;88369;739;2.2;0.0
FR;64;2021-01-26;3573;504;91942;1243;2.2;0.0
FR;64;2021-01-27;3792;886;95734;2129;2.3;0.1
FR;64;2021-01-28;4630;1754;100364;3883;2.4;0.1
FR;64;2021-01-29;3570;2323;103934;6206;2.5;0.2
FR;64;2021-01-30;848;694;104782;6900;2.6;0.2
FR;64;2021-01-31;181;278;104963;7178;2.6;0.2
FR;64;2021-02-01;1550;2845;106513;10023;2.6;0.2
FR;64;2021-02-02;2175;4121;108688;14144;2.6;0.3
FR;64;2021-02-03;2326;4349;111014;18493;2.7;0.5
FR;64;2021-02-04;2841;5480;113855;23973;2.8;0.6
FR;64;2021-02-05;2209;4946;116064;28919;2.8;0.7
FR;64;2021-02-06;697;1294;116761;30213;2.8;0.7
FR;64;2021-02-07;177;485;116938;30698;2.9;0.7
FR;64;2021-02-08;1507;4175;118445;34873;2.9;0.9
FR;64;2021-02-09;2369;5654;120814;40527;2.9;1.0
FR;64;2021-02-10;2611;5637;123425;46164;3.0;1.1
FR;64;2021-02-11;3499;7156;126924;53320;3.1;1.3
FR;64;2021-02-12;3151;5414;130075;58734;3.2;1.4
FR;64;2021-02-13;859;1443;130934;60177;3.2;1.5
FR;64;2021-02-14;204;438;131138;60615;3.2;1.5
FR;64;2021-02-15;1615;3848;132753;64463;3.2;1.6
FR;64;2021-02-16;2114;5068;134867;69531;3.3;1.7
FR;64;2021-02-17;2236;4595;137103;74126;3.3;1.8
FR;64;2021-02-18;3296;5398;140399;79524;3.4;1.9
FR;64;2021-02-19;3057;4168;143456;83692;3.5;2.0
FR;64;2021-02-20;827;1183;144283;84875;3.5;2.1
FR;64;2021-02-21;147;254;144430;85129;3.5;2.1
FR;64;2021-02-22;1534;2595;145964;87724;3.6;2.1
FR;64;2021-02-23;2444;2859;148408;90583;3.6;2.2
FR;64;2021-02-24;3967;2851;152375;93434;3.7;2.3
FR;64;2021-02-25;16197;3952;168572;97386;4.1;2.4
FR;64;2021-02-26;21967;2963;190539;100349;4.6;2.4
FR;64;2021-02-27;13145;891;203684;101240;5.0;2.5
FR;64;2021-02-28;820;189;204504;101429;5.0;2.5
FR;64;2021-03-01;6656;1806;211160;103235;5.1;2.5
FR;64;2021-03-02;13251;2509;224411;105744;5.5;2.6
FR;64;2021-03-03;16135;2541;240546;108285;5.9;2.6
FR;64;2021-03-04;25471;3165;266017;111450;6.5;2.7
FR;64;2021-03-05;30711;3076;296728;114526;7.2;2.8
FR;64;2021-03-06;27114;1181;323842;115707;7.9;2.8
FR;64;2021-03-07;10001;693;333843;116400;8.1;2.8
FR;64;2021-03-08;8956;1881;342799;118281;8.4;2.9
FR;64;2021-03-09;17006;2225;359805;120506;8.8;2.9
FR;64;2021-03-10;17268;2356;377073;122862;9.2;3.0
FR;64;2021-03-11;26141;3217;403214;126079;9.8;3.1
FR;64;2021-03-12;33728;2899;436942;128978;10.7;3.1
FR;64;2021-03-13;27571;1182;464513;130160;11.3;3.2
FR;64;2021-03-14;5492;308;470005;130468;11.5;3.2
FR;64;2021-03-15;11179;1565;481184;132033;11.7;3.2
FR;64;2021-03-16;6107;1799;487291;133832;11.9;3.3
FR;64;2021-03-17;6257;1735;493548;135567;12.0;3.3
FR;64;2021-03-18;7793;2110;501341;137677;12.2;3.4
FR;64;2021-03-19;19113;2094;520454;139771;12.7;3.4
FR;64;2021-03-20;18648;952;539102;140723;13.1;3.4
FR;64;2021-03-21;4755;291;543857;141014;13.3;3.4
FR;64;2021-03-22;13665;1696;557522;142710;13.6;3.5
FR;64;2021-03-23;23713;2228;581235;144938;14.2;3.5
FR;64;2021-03-24;25356;2353;606591;147291;14.8;3.6
FR;64;2021-03-25;36875;2780;643466;150071;15.7;3.7
FR;64;2021-03-26;40458;2737;683924;152808;16.7;3.7
FR;64;2021-03-27;21453;1270;705377;154078;17.2;3.8
FR;64;2021-03-28;5140;311;710517;154389;17.3;3.8
FR;64;2021-03-29;17661;2261;728178;156650;17.8;3.8
FR;64;2021-03-30;27488;3089;755666;159739;18.4;3.9
FR;64;2021-03-31;24318;3144;779984;162883;19.0;4.0
FR;64;2021-04-01;30830;4088;810814;166971;19.8;4.1
FR;64;2021-04-02;29409;3886;840223;170857;20.5;4.2
FR;64;2021-04-03;16109;2485;856332;173342;20.9;4.2
FR;64;2021-04-04;4057;847;860389;174189;21.0;4.2
FR;64;2021-04-05;5152;845;865541;175034;21.1;4.3
FR;64;2021-04-06;19409;4400;884950;179434;21.6;4.4
FR;64;2021-04-07;23757;4983;908707;184417;22.2;4.5
FR;64;2021-04-08;34868;5931;943575;190348;23.0;4.6
FR;64;2021-04-09;53857;6617;997432;196965;24.3;4.8
FR;64;2021-04-10;30046;5352;1027478;202317;25.0;4.9
FR;64;2021-04-11;6306;2646;1033784;204963;25.2;5.0
FR;64;2021-04-12;28205;5398;1061989;210361;25.9;5.1
FR;64;2021-04-13;42825;7730;1104814;218091;26.9;5.3
FR;64;2021-04-14;40970;7468;1145784;225559;27.9;5.5
FR;64;2021-04-15;52204;8788;1197988;234347;29.2;5.7
FR;64;2021-04-16;64597;9430;1262585;243777;30.8;5.9
FR;64;2021-04-17;38718;7436;1301303;251213;31.7;6.1
FR;64;2021-04-18;10969;3414;1312272;254627;32.0;6.2
FR;64;2021-04-19;42088;8816;1354360;263443;33.0;6.4
FR;64;2021-04-20;52769;10729;1407129;274172;34.3;6.7
FR;64;2021-04-21;52723;11208;1459852;285380;35.6;7.0
FR;64;2021-04-22;57599;13169;1517451;298549;37.0;7.3
FR;64;2021-04-23;61188;13290;1578639;311839;38.5;7.6
FR;64;2021-04-24;43554;9449;1622193;321288;39.5;7.8
FR;64;2021-04-25;16270;3483;1638463;324771;39.9;7.9
FR;64;2021-04-26;50188;11862;1688651;336633;41.2;8.2
FR;64;2021-04-27;63179;15938;1751830;352571;42.7;8.6
FR;64;2021-04-28;64174;16456;1816004;369027;44.3;9.0
FR;64;2021-04-29;73942;20923;1889946;389950;46.1;9.5
FR;64;2021-04-30;75501;22484;1965447;412434;47.9;10.1
FR;64;2021-05-01;29419;6868;1994866;419302;48.6;10.2
FR;64;2021-05-02;14524;4080;2009390;423382;49.0;10.3
FR;64;2021-05-03;52456;16140;2061846;439522;50.3;10.7
FR;64;2021-05-04;53445;21922;2115291;461444;51.6;11.2
FR;64;2021-05-05;49685;22955;2164976;484399;52.8;11.8
FR;64;2021-05-06;57059;29160;2222035;513559;54.2;12.5
FR;64;2021-05-07;51141;34262;2273176;547821;55.4;13.4
FR;64;2021-05-08;21219;9456;2294395;557277;55.9;13.6
FR;64;2021-05-09;10091;5557;2304486;562834;56.2;13.7
FR;64;2021-05-10;34834;26965;2339320;589799;57.0;14.4
FR;64;2021-05-11;44298;37359;2383618;627158;58.1;15.3
FR;64;2021-05-12;39492;35200;2423110;662358;59.1;16.1
FR;64;2021-05-13;22175;10145;2445285;672503;59.6;16.4
FR;64;2021-05-14;36543;29252;2481828;701755;60.5;17.1
FR;64;2021-05-15;21416;19095;2503244;720850;61.0;17.6
FR;64;2021-05-16;8029;4333;2511273;725183;61.2;17.7
FR;64;2021-05-17;27095;25565;2538368;750748;61.9;18.3
FR;64;2021-05-18;33980;28612;2572348;779360;62.7;19.0
FR;64;2021-05-19;30724;26613;2603072;805973;63.5;19.6
FR;64;2021-05-20;35302;33450;2638374;839423;64.3;20.5
FR;64;2021-05-21;30471;37556;2668845;876979;65.1;21.4
FR;64;2021-05-22;14936;17761;2683781;894740;65.4;21.8
FR;64;2021-05-23;5150;2870;2688931;897610;65.5;21.9
FR;64;2021-05-24;10880;6542;2699811;904152;65.8;22.0
FR;64;2021-05-25;22921;34504;2722732;938656;66.4;22.9
FR;64;2021-05-26;21851;35081;2744583;973737;66.9;23.7
FR;64;2021-05-27;26184;43130;2770767;1016867;67.5;24.8
FR;64;2021-05-28;24693;55855;2795460;1072722;68.1;26.1
FR;64;2021-05-29;11996;33567;2807456;1106289;68.4;27.0
FR;64;2021-05-30;2701;7437;2810157;1113726;68.5;27.1
FR;64;2021-05-31;15959;46030;2826116;1159756;68.9;28.3
FR;64;2021-06-01;21061;56422;2847177;1216178;69.4;29.6
FR;64;2021-06-02;17383;50518;2864560;1266696;69.8;30.9
FR;64;2021-06-03;21421;55055;2885981;1321751;70.4;32.2
FR;64;2021-06-04;20084;66560;2906065;1388311;70.8;33.8
FR;64;2021-06-05;9498;43238;2915563;1431549;71.1;34.9
FR;64;2021-06-06;2691;10971;2918254;1442520;71.1;35.2
FR;64;2021-06-07;12479;60892;2930733;1503412;71.4;36.6
FR;64;2021-06-08;16691;66682;2947424;1570094;71.8;38.3
FR;64;2021-06-09;14802;58468;2962226;1628562;72.2;39.7
FR;64;2021-06-10;16922;57092;2979148;1685654;72.6;41.1
FR;64;2021-06-11;15273;69928;2994421;1755582;73.0;42.8
FR;64;2021-06-12;8187;36089;3002608;1791671;73.2;43.7
FR;64;2021-06-13;2141;9749;3004749;1801420;73.2;43.9
FR;64;2021-06-14;9121;64649;3013870;1866069;73.5;45.5
FR;64;2021-06-15;11906;66281;3025776;1932350;73.8;47.1
FR;64;2021-06-16;10119;53338;3035895;1985688;74.0;48.4
FR;64;2021-06-17;12212;55835;3048107;2041523;74.3;49.8
FR;64;2021-06-18;11286;61286;3059393;2102809;74.6;51.3
FR;64;2021-06-19;5554;29092;3064947;2131901;74.7;52.0
FR;64;2021-06-20;1188;6584;3066135;2138485;74.7;52.1
FR;64;2021-06-21;6425;45170;3072560;2183655;74.9;53.2
FR;64;2021-06-22;8540;52549;3081100;2236204;75.1;54.5
FR;64;2021-06-23;7512;40732;3088612;2276936;75.3;55.5
FR;64;2021-06-24;9534;40150;3098146;2317086;75.5;56.5
FR;64;2021-06-25;8826;50860;3106972;2367946;75.7;57.7
FR;64;2021-06-26;4407;25650;3111379;2393596;75.8;58.3
FR;64;2021-06-27;1151;6579;3112530;2400175;75.9;58.5
FR;64;2021-06-28;5610;38228;3118140;2438403;76.0;59.4
FR;64;2021-06-29;7432;45202;3125572;2483605;76.2;60.5
FR;64;2021-06-30;7267;37145;3132839;2520750;76.4;61.4
FR;64;2021-07-01;9327;39773;3142166;2560523;76.6;62.4
FR;64;2021-07-02;9005;44522;3151171;2605045;76.8;63.5
FR;64;2021-07-03;4588;22077;3155759;2627122;76.9;64.0
FR;64;2021-07-04;1224;5373;3156983;2632495;77.0;64.2
FR;64;2021-07-05;6604;30212;3163587;2662707;77.1;64.9
FR;64;2021-07-06;8525;38425;3172112;2701132;77.3;65.8
FR;64;2021-07-07;8297;30238;3180409;2731370;77.5;66.6
FR;64;2021-07-08;10241;34276;3190650;2765646;77.8;67.4
FR;64;2021-07-09;9893;38043;3200543;2803689;78.0;68.3
FR;64;2021-07-10;4963;17611;3205506;2821300;78.1;68.8
FR;64;2021-07-11;1464;3461;3206970;2824761;78.2;68.9
FR;64;2021-07-12;6606;25361;3213576;2850122;78.3;69.5
FR;64;2021-07-13;11563;31328;3225139;2881450;78.6;70.2
FR;64;2021-07-14;3802;4950;3228941;2886400;78.7;70.4
FR;64;2021-07-15;13918;29969;3242859;2916369;79.1;71.1
FR;64;2021-07-16;15592;31510;3258451;2947879;79.4;71.9
FR;64;2021-07-17;8196;13942;3266647;2961821;79.6;72.2
FR;64;2021-07-18;2201;3258;3268848;2965079;79.7;72.3
FR;64;2021-07-19;10365;21377;3279213;2986456;79.9;72.8
FR;64;2021-07-20;14493;26509;3293706;3012965;80.3;73.4
FR;64;2021-07-21;13688;21703;3307394;3034668;80.6;74.0
FR;64;2021-07-22;16214;24569;3323608;3059237;81.0;74.6
FR;64;2021-07-23;16783;25835;3340391;3085072;81.4;75.2
FR;64;2021-07-24;8684;10523;3349075;3095595;81.6;75.5
FR;64;2021-07-25;2646;2399;3351721;3097994;81.7;75.5
FR;64;2021-07-26;11961;16015;3363682;3114009;82.0;75.9
FR;64;2021-07-27;17090;20117;3380772;3134126;82.4;76.4
FR;64;2021-07-28;15793;16725;3396565;3150851;82.8;76.8
FR;64;2021-07-29;17812;18656;3414377;3169507;83.2;77.3
FR;64;2021-07-30;16903;19187;3431280;3188694;83.6;77.7
FR;64;2021-07-31;8442;8009;3439722;3196703;83.9;77.9
FR;64;2021-08-01;2234;1596;3441956;3198299;83.9;78.0
FR;64;2021-08-02;11000;11348;3452956;3209647;84.2;78.2
FR;64;2021-08-03;14295;14360;3467251;3224007;84.5;78.6
FR;64;2021-08-04;13562;11533;3480813;3235540;84.9;78.9
FR;64;2021-08-05;13808;12513;3494621;3248053;85.2;79.2
FR;64;2021-08-06;13608;13845;3508229;3261898;85.5;79.5
FR;64;2021-08-07;6361;6730;3514590;3268628;85.7;79.7
FR;64;2021-08-08;1665;1675;3516255;3270303;85.7;79.7
FR;64;2021-08-09;8910;10601;3525165;3280904;85.9;80.0
FR;64;2021-08-10;11728;13459;3536893;3294363;86.2;80.3
FR;64;2021-08-11;10437;11478;3547330;3305841;86.5;80.6
FR;64;2021-08-12;11100;12842;3558430;3318683;86.7;80.9
FR;64;2021-08-13;9433;11665;3567863;3330348;87.0;81.2
FR;64;2021-08-14;4360;6233;3572223;3336581;87.1;81.3
FR;64;2021-08-15;937;1228;3573160;3337809;87.1;81.4
FR;64;2021-08-16;6344;10815;3579504;3348624;87.3;81.6
FR;64;2021-08-17;8140;13183;3587644;3361807;87.5;82.0
FR;64;2021-08-18;7203;12307;3594847;3374114;87.6;82.3
FR;64;2021-08-19;7516;13167;3602363;3387281;87.8;82.6
FR;64;2021-08-20;6856;14015;3609219;3401296;88.0;82.9
FR;64;2021-08-21;3028;6705;3612247;3408001;88.1;83.1
FR;64;2021-08-22;662;1836;3612909;3409837;88.1;83.1
FR;64;2021-08-23;4352;11075;3617261;3420912;88.2;83.4
FR;69;2020-12-27;32;0;32;0;0.0;0.0
FR;69;2020-12-28;33;0;65;0;0.0;0.0
FR;69;2020-12-29;18;0;83;0;0.0;0.0
FR;69;2020-12-30;22;0;105;0;0.0;0.0
FR;69;2020-12-31;17;0;122;0;0.0;0.0
FR;69;2021-01-01;18;0;140;0;0.0;0.0
FR;69;2021-01-02;16;1;156;1;0.0;0.0
FR;69;2021-01-03;22;0;178;1;0.0;0.0
FR;69;2021-01-04;131;0;309;1;0.0;0.0
FR;69;2021-01-05;429;4;738;5;0.0;0.0
FR;69;2021-01-06;829;2;1567;7;0.0;0.0
FR;69;2021-01-07;1921;6;3488;13;0.1;0.0
FR;69;2021-01-08;2494;5;5982;18;0.2;0.0
FR;69;2021-01-09;1140;2;7122;20;0.2;0.0
FR;69;2021-01-10;673;1;7795;21;0.2;0.0
FR;69;2021-01-11;2761;6;10556;27;0.3;0.0
FR;69;2021-01-12;3938;3;14494;30;0.4;0.0
FR;69;2021-01-13;3846;18;18340;48;0.5;0.0
FR;69;2021-01-14;4699;47;23039;95;0.6;0.0
FR;69;2021-01-15;3903;20;26942;115;0.7;0.0
FR;69;2021-01-16;1364;13;28306;128;0.7;0.0
FR;69;2021-01-17;656;5;28962;133;0.7;0.0
FR;69;2021-01-18;3306;24;32268;157;0.8;0.0
FR;69;2021-01-19;4867;25;37135;182;1.0;0.0
FR;69;2021-01-20;4841;24;41976;206;1.1;0.0
FR;69;2021-01-21;5639;31;47615;237;1.2;0.0
FR;69;2021-01-22;4433;25;52048;262;1.3;0.0
FR;69;2021-01-23;1385;7;53433;269;1.4;0.0
FR;69;2021-01-24;467;8;53900;277;1.4;0.0
FR;69;2021-01-25;2772;80;56672;357;1.5;0.0
FR;69;2021-01-26;3425;191;60097;548;1.5;0.0
FR;69;2021-01-27;3705;419;63802;967;1.6;0.0
FR;69;2021-01-28;4391;883;68193;1850;1.7;0.0
FR;69;2021-01-29;3545;1228;71738;3078;1.8;0.1
FR;69;2021-01-30;968;396;72706;3474;1.9;0.1
FR;69;2021-01-31;188;159;72894;3633;1.9;0.1
FR;69;2021-02-01;1849;1496;74743;5129;1.9;0.1
FR;69;2021-02-02;2476;2183;77219;7312;2.0;0.2
FR;69;2021-02-03;2460;2241;79679;9553;2.0;0.2
FR;69;2021-02-04;3037;2896;82716;12449;2.1;0.3
FR;69;2021-02-05;2568;2519;85284;14968;2.2;0.4
FR;69;2021-02-06;769;800;86053;15768;2.2;0.4
FR;69;2021-02-07;177;386;86230;16154;2.2;0.4
FR;69;2021-02-08;1634;2379;87864;18533;2.3;0.5
FR;69;2021-02-09;2466;3370;90330;21903;2.3;0.6
FR;69;2021-02-10;2627;3352;92957;25255;2.4;0.6
FR;69;2021-02-11;3580;4786;96537;30041;2.5;0.8
FR;69;2021-02-12;3221;3354;99758;33395;2.6;0.9
FR;69;2021-02-13;903;1018;100661;34413;2.6;0.9
FR;69;2021-02-14;232;413;100893;34826;2.6;0.9
FR;69;2021-02-15;1368;2700;102261;37526;2.6;1.0
FR;69;2021-02-16;1911;3871;104172;41397;2.7;1.1
FR;69;2021-02-17;2067;3543;106239;44940;2.7;1.2
FR;69;2021-02-18;3104;4417;109343;49357;2.8;1.3
FR;69;2021-02-19;2936;3401;112279;52758;2.9;1.4
FR;69;2021-02-20;795;1006;113074;53764;2.9;1.4
FR;69;2021-02-21;168;231;113242;53995;2.9;1.4
FR;69;2021-02-22;1656;2488;114898;56483;2.9;1.4
FR;69;2021-02-23;2316;2758;117214;59241;3.0;1.5
FR;69;2021-02-24;2719;2808;119933;62049;3.1;1.6
FR;69;2021-02-25;3956;3468;123889;65517;3.2;1.7
FR;69;2021-02-26;4347;2560;128236;68077;3.3;1.7
FR;69;2021-02-27;1854;707;130090;68784;3.3;1.8
FR;69;2021-02-28;320;184;130410;68968;3.3;1.8
FR;69;2021-03-01;2857;1894;133267;70862;3.4;1.8
FR;69;2021-03-02;4793;2416;138060;73278;3.5;1.9
FR;69;2021-03-03;6828;2454;144888;75732;3.7;1.9
FR;69;2021-03-04;11944;3055;156832;78787;4.0;2.0
FR;69;2021-03-05;17666;2808;174498;81595;4.5;2.1
FR;69;2021-03-06;23544;1012;198042;82607;5.1;2.1
FR;69;2021-03-07;14899;613;212941;83220;5.5;2.1
FR;69;2021-03-08;9890;2097;222831;85317;5.7;2.2
FR;69;2021-03-09;17658;2628;240489;87945;6.2;2.3
FR;69;2021-03-10;19040;2676;259529;90621;6.7;2.3
FR;69;2021-03-11;29428;3485;288957;94106;7.4;2.4
FR;69;2021-03-12;40233;3405;329190;97511;8.4;2.5
FR;69;2021-03-13;36393;1411;365583;98922;9.4;2.5
FR;69;2021-03-14;8249;383;373832;99305;9.6;2.5
FR;69;2021-03-15;16851;1910;390683;101215;10.0;2.6
FR;69;2021-03-16;10839;2251;401522;103466;10.3;2.7
FR;69;2021-03-17;11872;2232;413394;105698;10.6;2.7
FR;69;2021-03-18;13238;2630;426632;108328;10.9;2.8
FR;69;2021-03-19;29079;2618;455711;110946;11.7;2.8
FR;69;2021-03-20;27093;1147;482804;112093;12.4;2.9
FR;69;2021-03-21;7163;344;489967;112437;12.6;2.9
FR;69;2021-03-22;21360;2340;511327;114777;13.1;2.9
FR;69;2021-03-23;36457;3026;547784;117803;14.0;3.0
FR;69;2021-03-24;37722;3049;585506;120852;15.0;3.1
FR;69;2021-03-25;55364;3535;640870;124387;16.4;3.2
FR;69;2021-03-26;59456;3399;700326;127786;17.9;3.3
FR;69;2021-03-27;30368;1657;730694;129443;18.7;3.3
FR;69;2021-03-28;7644;449;738338;129892;18.9;3.3
FR;69;2021-03-29;27818;3615;766156;133507;19.6;3.4
FR;69;2021-03-30;42459;4611;808615;138118;20.7;3.5
FR;69;2021-03-31;35571;4642;844186;142760;21.6;3.7
FR;69;2021-04-01;43511;5985;887697;148745;22.8;3.8
FR;69;2021-04-02;41545;6198;929242;154943;23.8;4.0
FR;69;2021-04-03;21770;4046;951012;158989;24.4;4.1
FR;69;2021-04-04;5829;1355;956841;160344;24.5;4.1
FR;69;2021-04-05;7648;1112;964489;161456;24.7;4.1
FR;69;2021-04-06;28063;7319;992552;168775;25.4;4.3
FR;69;2021-04-07;32559;7877;1025111;176652;26.3;4.5
FR;69;2021-04-08;48820;9081;1073931;185733;27.5;4.8
FR;69;2021-04-09;70967;9539;1144898;195272;29.3;5.0
FR;69;2021-04-10;36860;8109;1181758;203381;30.3;5.2
FR;69;2021-04-11;8009;4328;1189767;207709;30.5;5.3
FR;69;2021-04-12;38761;8989;1228528;216698;31.5;5.6
FR;69;2021-04-13;53793;12215;1282321;228913;32.9;5.9
FR;69;2021-04-14;49580;11921;1331901;240834;34.1;6.2
FR;69;2021-04-15;62079;13841;1393980;254675;35.7;6.5
FR;69;2021-04-16;72890;14510;1466870;269185;37.6;6.9
FR;69;2021-04-17;39850;10908;1506720;280093;38.6;7.2
FR;69;2021-04-18;10069;5091;1516789;285184;38.9;7.3
FR;69;2021-04-19;45993;14081;1562782;299265;40.1;7.7
FR;69;2021-04-20;57305;17104;1620087;316369;41.5;8.1
FR;69;2021-04-21;53671;16803;1673758;333172;42.9;8.5
FR;69;2021-04-22;60467;19061;1734225;352233;44.4;9.0
FR;69;2021-04-23;59631;19228;1793856;371461;46.0;9.5
FR;69;2021-04-24;37469;13355;1831325;384816;46.9;9.9
FR;69;2021-04-25;13310;5066;1844635;389882;47.3;10.0
FR;69;2021-04-26;49864;18578;1894499;408460;48.6;10.5
FR;69;2021-04-27;61959;23502;1956458;431962;50.1;11.1
FR;69;2021-04-28;60001;22457;2016459;454419;51.7;11.6
FR;69;2021-04-29;70320;25296;2086779;479715;53.5;12.3
FR;69;2021-04-30;67140;24330;2153919;504045;55.2;12.9
FR;69;2021-05-01;23956;7750;2177875;511795;55.8;13.1
FR;69;2021-05-02;11221;5227;2189096;517022;56.1;13.3
FR;69;2021-05-03;47608;21570;2236704;538592;57.3;13.8
FR;69;2021-05-04;48154;28013;2284858;566605;58.6;14.5
FR;69;2021-05-05;42920;27356;2327778;593961;59.7;15.2
FR;69;2021-05-06;51029;30480;2378807;624441;61.0;16.0
FR;69;2021-05-07;42489;34476;2421296;658917;62.1;16.9
FR;69;2021-05-08;16139;9493;2437435;668410;62.5;17.1
FR;69;2021-05-09;7343;6611;2444778;675021;62.7;17.3
FR;69;2021-05-10;29948;34882;2474726;709903;63.4;18.2
FR;69;2021-05-11;38427;44002;2513153;753905;64.4;19.3
FR;69;2021-05-12;33356;39405;2546509;793310;65.3;20.3
FR;69;2021-05-13;17574;11594;2564083;804904;65.7;20.6
FR;69;2021-05-14;30202;34320;2594285;839224;66.5;21.5
FR;69;2021-05-15;15353;18586;2609638;857810;66.9;22.0
FR;69;2021-05-16;5483;4335;2615121;862145;67.0;22.1
FR;69;2021-05-17;22009;28971;2637130;891116;67.6;22.8
FR;69;2021-05-18;28290;29854;2665420;920970;68.3;23.6
FR;69;2021-05-19;24555;25455;2689975;946425;68.9;24.3
FR;69;2021-05-20;28630;28084;2718605;974509;69.7;25.0
FR;69;2021-05-21;23167;30898;2741772;1005407;70.3;25.8
FR;69;2021-05-22;9737;14402;2751509;1019809;70.5;26.1
FR;69;2021-05-23;3206;2408;2754715;1022217;70.6;26.2
FR;69;2021-05-24;8194;7164;2762909;1029381;70.8;26.4
FR;69;2021-05-25;18025;36390;2780934;1065771;71.3;27.3
FR;69;2021-05-26;16611;34626;2797545;1100397;71.7;28.2
FR;69;2021-05-27;20747;42397;2818292;1142794;72.2;29.3
FR;69;2021-05-28;18447;53950;2836739;1196744;72.7;30.7
FR;69;2021-05-29;7718;31262;2844457;1228006;72.9;31.5
FR;69;2021-05-30;1713;6894;2846170;1234900;72.9;31.6
FR;69;2021-05-31;12428;47579;2858598;1282479;73.3;32.9
FR;69;2021-06-01;16379;57759;2874977;1340238;73.7;34.3
FR;69;2021-06-02;13227;50112;2888204;1390350;74.0;35.6
FR;69;2021-06-03;16543;57687;2904747;1448037;74.4;37.1
FR;69;2021-06-04;14724;67103;2919471;1515140;74.8;38.8
FR;69;2021-06-05;6153;39516;2925624;1554656;75.0;39.8
FR;69;2021-06-06;1580;9073;2927204;1563729;75.0;40.1
FR;69;2021-06-07;9815;59511;2937019;1623240;75.3;41.6
FR;69;2021-06-08;13533;66455;2950552;1689695;75.6;43.3
FR;69;2021-06-09;11753;55005;2962305;1744700;75.9;44.7
FR;69;2021-06-10;14179;57925;2976484;1802625;76.3;46.2
FR;69;2021-06-11;12229;69324;2988713;1871949;76.6;48.0
FR;69;2021-06-12;5681;32228;2994394;1904177;76.7;48.8
FR;69;2021-06-13;1336;7837;2995730;1912014;76.8;49.0
FR;69;2021-06-14;7472;61096;3003202;1973110;77.0;50.6
FR;69;2021-06-15;10094;66407;3013296;2039517;77.2;52.3
FR;69;2021-06-16;8224;50195;3021520;2089712;77.4;53.6
FR;69;2021-06-17;9866;57179;3031386;2146891;77.7;55.0
FR;69;2021-06-18;8732;60773;3040118;2207664;77.9;56.6
FR;69;2021-06-19;3723;24265;3043841;2231929;78.0;57.2
FR;69;2021-06-20;748;4939;3044589;2236868;78.0;57.3
FR;69;2021-06-21;5134;41834;3049723;2278702;78.2;58.4
FR;69;2021-06-22;6961;50961;3056684;2329663;78.3;59.7
FR;69;2021-06-23;5946;37003;3062630;2366666;78.5;60.7
FR;69;2021-06-24;7741;39298;3070371;2405964;78.7;61.7
FR;69;2021-06-25;6627;47439;3076998;2453403;78.9;62.9
FR;69;2021-06-26;2909;19997;3079907;2473400;78.9;63.4
FR;69;2021-06-27;653;4707;3080560;2478107;79.0;63.5
FR;69;2021-06-28;4333;33037;3084893;2511144;79.1;64.4
FR;69;2021-06-29;5917;40905;3090810;2552049;79.2;65.4
FR;69;2021-06-30;5783;31995;3096593;2584044;79.4;66.2
FR;69;2021-07-01;7236;36102;3103829;2620146;79.5;67.2
FR;69;2021-07-02;6810;40273;3110639;2660419;79.7;68.2
FR;69;2021-07-03;2847;16355;3113486;2676774;79.8;68.6
FR;69;2021-07-04;785;3564;3114271;2680338;79.8;68.7
FR;69;2021-07-05;4916;25636;3119187;2705974;79.9;69.4
FR;69;2021-07-06;6668;33874;3125855;2739848;80.1;70.2
FR;69;2021-07-07;6344;24898;3132199;2764746;80.3;70.9
FR;69;2021-07-08;7669;29207;3139868;2793953;80.5;71.6
FR;69;2021-07-09;7055;31494;3146923;2825447;80.7;72.4
FR;69;2021-07-10;3085;12154;3150008;2837601;80.7;72.7
FR;69;2021-07-11;838;2211;3150846;2839812;80.8;72.8
FR;69;2021-07-12;4921;19819;3155767;2859631;80.9;73.3
FR;69;2021-07-13;8247;25335;3164014;2884966;81.1;73.9
FR;69;2021-07-14;2352;3501;3166366;2888467;81.1;74.0
FR;69;2021-07-15;9608;24259;3175974;2912726;81.4;74.6
FR;69;2021-07-16;10590;24458;3186564;2937184;81.7;75.3
FR;69;2021-07-17;4869;9221;3191433;2946405;81.8;75.5
FR;69;2021-07-18;1247;2001;3192680;2948406;81.8;75.6
FR;69;2021-07-19;6976;16582;3199656;2964988;82.0;76.0
FR;69;2021-07-20;9725;21328;3209381;2986316;82.3;76.5
FR;69;2021-07-21;9170;16925;3218551;3003241;82.5;77.0
FR;69;2021-07-22;10726;19723;3229277;3022964;82.8;77.5
FR;69;2021-07-23;10878;19327;3240155;3042291;83.0;78.0
FR;69;2021-07-24;5080;6673;3245235;3048964;83.2;78.1
FR;69;2021-07-25;1435;1483;3246670;3050447;83.2;78.2
FR;69;2021-07-26;7782;12240;3254452;3062687;83.4;78.5
FR;69;2021-07-27;11309;15774;3265761;3078461;83.7;78.9
FR;69;2021-07-28;10668;12763;3276429;3091224;84.0;79.2
FR;69;2021-07-29;12008;14434;3288437;3105658;84.3;79.6
FR;69;2021-07-30;11235;14260;3299672;3119918;84.6;80.0
FR;69;2021-07-31;5187;5234;3304859;3125152;84.7;80.1
FR;69;2021-08-01;1406;995;3306265;3126147;84.7;80.1
FR;69;2021-08-02;7692;8572;3313957;3134719;84.9;80.3
FR;69;2021-08-03;10068;11105;3324025;3145824;85.2;80.6
FR;69;2021-08-04;9551;8695;3333576;3154519;85.4;80.8
FR;69;2021-08-05;9751;9339;3343327;3163858;85.7;81.1
FR;69;2021-08-06;9363;10104;3352690;3173962;85.9;81.3
FR;69;2021-08-07;4119;4205;3356809;3178167;86.0;81.5
FR;69;2021-08-08;1103;1114;3357912;3179281;86.1;81.5
FR;69;2021-08-09;6072;7669;3363984;3186950;86.2;81.7
FR;69;2021-08-10;7946;9730;3371930;3196680;86.4;81.9
FR;69;2021-08-11;7335;8209;3379265;3204889;86.6;82.1
FR;69;2021-08-12;7712;9296;3386977;3214185;86.8;82.4
FR;69;2021-08-13;6604;8378;3393581;3222563;87.0;82.6
FR;69;2021-08-14;2732;3965;3396313;3226528;87.0;82.7
FR;69;2021-08-15;547;704;3396860;3227232;87.1;82.7
FR;69;2021-08-16;4391;7479;3401251;3234711;87.2;82.9
FR;69;2021-08-17;5616;9297;3406867;3244008;87.3;83.1
FR;69;2021-08-18;5090;8530;3411957;3252538;87.4;83.4
FR;69;2021-08-19;5364;9099;3417321;3261637;87.6;83.6
FR;69;2021-08-20;4781;9598;3422102;3271235;87.7;83.8
FR;69;2021-08-21;1883;4156;3423985;3275391;87.8;83.9
FR;69;2021-08-22;371;1049;3424356;3276440;87.8;84.0
FR;69;2021-08-23;3122;7660;3427478;3284100;87.8;84.2
FR;74;2020-12-27;38;0;38;0;0.0;0.0
FR;74;2020-12-28;27;0;65;0;0.0;0.0
FR;74;2020-12-29;21;0;86;0;0.0;0.0
FR;74;2020-12-30;23;0;109;0;0.0;0.0
FR;74;2020-12-31;22;0;131;0;0.0;0.0
FR;74;2021-01-01;27;2;158;2;0.0;0.0
FR;74;2021-01-02;14;0;172;2;0.0;0.0
FR;74;2021-01-03;22;0;194;2;0.0;0.0
FR;74;2021-01-04;106;1;300;3;0.0;0.0
FR;74;2021-01-05;319;0;619;3;0.0;0.0
FR;74;2021-01-06;574;3;1193;6;0.0;0.0
FR;74;2021-01-07;1498;0;2691;6;0.1;0.0
FR;74;2021-01-08;1836;4;4527;10;0.1;0.0
FR;74;2021-01-09;810;0;5337;10;0.2;0.0
FR;74;2021-01-10;547;0;5884;10;0.2;0.0
FR;74;2021-01-11;2178;2;8062;12;0.2;0.0
FR;74;2021-01-12;3192;8;11254;20;0.3;0.0
FR;74;2021-01-13;3262;11;14516;31;0.4;0.0
FR;74;2021-01-14;4085;44;18601;75;0.5;0.0
FR;74;2021-01-15;3601;15;22202;90;0.6;0.0
FR;74;2021-01-16;1355;5;23557;95;0.7;0.0
FR;74;2021-01-17;780;6;24337;101;0.7;0.0
FR;74;2021-01-18;4793;22;29130;123;0.8;0.0
FR;74;2021-01-19;6902;27;36032;150;1.0;0.0
FR;74;2021-01-20;7215;14;43247;164;1.2;0.0
FR;74;2021-01-21;8332;37;51579;201;1.5;0.0
FR;74;2021-01-22;6665;25;58244;226;1.7;0.0
FR;74;2021-01-23;2287;4;60531;230;1.7;0.0
FR;74;2021-01-24;627;3;61158;233;1.8;0.0
FR;74;2021-01-25;4590;49;65748;282;1.9;0.0
FR;74;2021-01-26;5714;152;71462;434;2.1;0.0
FR;74;2021-01-27;6053;276;77515;710;2.2;0.0
FR;74;2021-01-28;7078;763;84593;1473;2.4;0.0
FR;74;2021-01-29;5782;894;90375;2367;2.6;0.1
FR;74;2021-01-30;1794;258;92169;2625;2.6;0.1
FR;74;2021-01-31;315;110;92484;2735;2.7;0.1
FR;74;2021-02-01;3351;1038;95835;3773;2.8;0.1
FR;74;2021-02-02;4370;1771;100205;5544;2.9;0.2
FR;74;2021-02-03;4389;1773;104594;7317;3.0;0.2
FR;74;2021-02-04;5234;2433;109828;9750;3.2;0.3
FR;74;2021-02-05;4455;2167;114283;11917;3.3;0.3
FR;74;2021-02-06;1486;682;115769;12599;3.3;0.4
FR;74;2021-02-07;254;349;116023;12948;3.3;0.4
FR;74;2021-02-08;3117;2484;119140;15432;3.4;0.4
FR;74;2021-02-09;4176;3665;123316;19097;3.5;0.5
FR;74;2021-02-10;4483;3731;127799;22828;3.7;0.7
FR;74;2021-02-11;5716;5378;133515;28206;3.8;0.8
FR;74;2021-02-12;5352;3726;138867;31932;4.0;0.9
FR;74;2021-02-13;1685;1199;140552;33131;4.0;1.0
FR;74;2021-02-14;418;468;140970;33599;4.1;1.0
FR;74;2021-02-15;2459;4076;143429;37675;4.1;1.1
FR;74;2021-02-16;3310;5504;146739;43179;4.2;1.2
FR;74;2021-02-17;3429;5298;150168;48477;4.3;1.4
FR;74;2021-02-18;5003;6621;155171;55098;4.5;1.6
FR;74;2021-02-19;4936;5255;160107;60353;4.6;1.7
FR;74;2021-02-20;1564;1710;161671;62063;4.6;1.8
FR;74;2021-02-21;236;408;161907;62471;4.7;1.8
FR;74;2021-02-22;2909;4155;164816;66626;4.7;1.9
FR;74;2021-02-23;4185;4783;169001;71409;4.9;2.1
FR;74;2021-02-24;4599;4717;173600;76126;5.0;2.2
FR;74;2021-02-25;5582;5529;179182;81655;5.2;2.3
FR;74;2021-02-26;5560;4402;184742;86057;5.3;2.5
FR;74;2021-02-27;2054;1353;186796;87410;5.4;2.5
FR;74;2021-02-28;537;294;187333;87704;5.4;2.5
FR;74;2021-03-01;5146;3326;192479;91030;5.5;2.6
FR;74;2021-03-02;7538;4242;200017;95272;5.8;2.7
FR;74;2021-03-03;9822;4190;209839;99462;6.0;2.9
FR;74;2021-03-04;15279;4878;225118;104340;6.5;3.0
FR;74;2021-03-05;21887;4731;247005;109071;7.1;3.1
FR;74;2021-03-06;31640;1774;278645;110845;8.0;3.2
FR;74;2021-03-07;21094;791;299739;111636;8.6;3.2
FR;74;2021-03-08;14381;3741;314120;115377;9.0;3.3
FR;74;2021-03-09;24280;4390;338400;119767;9.7;3.4
FR;74;2021-03-10;26546;4608;364946;124375;10.5;3.6
FR;74;2021-03-11;38605;5678;403551;130053;11.6;3.7
FR;74;2021-03-12;50998;5234;454549;135287;13.1;3.9
FR;74;2021-03-13;48291;2110;502840;137397;14.5;4.0
FR;74;2021-03-14;12023;608;514863;138005;14.8;4.0
FR;74;2021-03-15;25736;3337;540599;141342;15.5;4.1
FR;74;2021-03-16;20144;3952;560743;145294;16.1;4.2
FR;74;2021-03-17;21906;4011;582649;149305;16.8;4.3
FR;74;2021-03-18;24573;4648;607222;153953;17.5;4.4
FR;74;2021-03-19;41631;4267;648853;158220;18.7;4.5
FR;74;2021-03-20;35558;1852;684411;160072;19.7;4.6
FR;74;2021-03-21;9500;502;693911;160574;19.9;4.6
FR;74;2021-03-22;31672;4086;725583;164660;20.9;4.7
FR;74;2021-03-23;50410;5159;775993;169819;22.3;4.9
FR;74;2021-03-24;52389;5514;828382;175333;23.8;5.0
FR;74;2021-03-25;75207;6084;903589;181417;26.0;5.2
FR;74;2021-03-26;81137;5811;984726;187228;28.3;5.4
FR;74;2021-03-27;51260;2784;1035986;190012;29.8;5.5
FR;74;2021-03-28;17858;888;1053844;190900;30.3;5.5
FR;74;2021-03-29;56269;7218;1110113;198118;31.9;5.7
FR;74;2021-03-30;76765;9175;1186878;207293;34.1;6.0
FR;74;2021-03-31;68182;9802;1255060;217095;36.1;6.2
FR;74;2021-04-01;78678;12211;1333738;229306;38.3;6.6
FR;74;2021-04-02;70222;12737;1403960;242043;40.4;7.0
FR;74;2021-04-03;37282;8676;1441242;250719;41.4;7.2
FR;74;2021-04-04;12534;2871;1453776;253590;41.8;7.3
FR;74;2021-04-05;19250;2000;1473026;255590;42.3;7.3
FR;74;2021-04-06;64651;15412;1537677;271002;44.2;7.8
FR;74;2021-04-07;72827;16313;1610504;287315;46.3;8.3
FR;74;2021-04-08;87901;18355;1698405;305670;48.8;8.8
FR;74;2021-04-09;97645;18264;1796050;323934;51.6;9.3
FR;74;2021-04-10;48794;14330;1844844;338264;53.0;9.7
FR;74;2021-04-11;12724;6887;1857568;345151;53.4;9.9
FR;74;2021-04-12;61046;17983;1918614;363134;55.2;10.4
FR;74;2021-04-13;68928;22523;1987542;385657;57.1;11.1
FR;74;2021-04-14;60310;22075;2047852;407732;58.9;11.7
FR;74;2021-04-15;62166;24039;2110018;431771;60.7;12.4
FR;74;2021-04-16;52456;24534;2162474;456305;62.2;13.1
FR;74;2021-04-17;25842;16925;2188316;473230;62.9;13.6
FR;74;2021-04-18;5770;6981;2194086;480211;63.1;13.8
FR;74;2021-04-19;31813;24394;2225899;504605;64.0;14.5
FR;74;2021-04-20;36386;29674;2262285;534279;65.0;15.4
FR;74;2021-04-21;33477;30341;2295762;564620;66.0;16.2
FR;74;2021-04-22;38227;35387;2333989;600007;67.1;17.2
FR;74;2021-04-23;35006;38966;2368995;638973;68.1;18.4
FR;74;2021-04-24;18715;30808;2387710;669781;68.6;19.3
FR;74;2021-04-25;6160;12567;2393870;682348;68.8;19.6
FR;74;2021-04-26;26816;46926;2420686;729274;69.6;21.0
FR;74;2021-04-27;33148;56186;2453834;785460;70.5;22.6
FR;74;2021-04-28;32706;53028;2486540;838488;71.5;24.1
FR;74;2021-04-29;38811;54219;2525351;892707;72.6;25.7
FR;74;2021-04-30;35130;49321;2560481;942028;73.6;27.1
FR;74;2021-05-01;11128;15210;2571609;957238;73.9;27.5
FR;74;2021-05-02;5191;11415;2576800;968653;74.1;27.8
FR;74;2021-05-03;24222;52217;2601022;1020870;74.8;29.3
FR;74;2021-05-04;25121;69348;2626143;1090218;75.5;31.3
FR;74;2021-05-05;22747;65015;2648890;1155233;76.2;33.2
FR;74;2021-05-06;27444;63433;2676334;1218666;76.9;35.0
FR;74;2021-05-07;23313;66067;2699647;1284733;77.6;36.9
FR;74;2021-05-08;8284;14366;2707931;1299099;77.9;37.3
FR;74;2021-05-09;3697;10473;2711628;1309572;78.0;37.6
FR;74;2021-05-10;16127;63157;2727755;1372729;78.4;39.5
FR;74;2021-05-11;21041;64205;2748796;1436934;79.0;41.3
FR;74;2021-05-12;18568;53286;2767364;1490220;79.6;42.8
FR;74;2021-05-13;9125;12138;2776489;1502358;79.8;43.2
FR;74;2021-05-14;17034;37807;2793523;1540165;80.3;44.3
FR;74;2021-05-15;8431;17618;2801954;1557783;80.6;44.8
FR;74;2021-05-16;3012;3508;2804966;1561291;80.6;44.9
FR;74;2021-05-17;12304;30893;2817270;1592184;81.0;45.8
FR;74;2021-05-18;15636;30640;2832906;1622824;81.4;46.7
FR;74;2021-05-19;14127;25602;2847033;1648426;81.9;47.4
FR;74;2021-05-20;16173;27900;2863206;1676326;82.3;48.2
FR;74;2021-05-21;13479;30848;2876685;1707174;82.7;49.1
FR;74;2021-05-22;5814;14276;2882499;1721450;82.9;49.5
FR;74;2021-05-23;1857;2397;2884356;1723847;82.9;49.6
FR;74;2021-05-24;4681;5786;2889037;1729633;83.1;49.7
FR;74;2021-05-25;10680;35351;2899717;1764984;83.4;50.7
FR;74;2021-05-26;10160;33102;2909877;1798086;83.7;51.7
FR;74;2021-05-27;11937;39590;2921814;1837676;84.0;52.8
FR;74;2021-05-28;11323;45158;2933137;1882834;84.3;54.1
FR;74;2021-05-29;4779;24329;2937916;1907163;84.5;54.8
FR;74;2021-05-30;1050;4254;2938966;1911417;84.5;55.0
FR;74;2021-05-31;7627;29908;2946593;1941325;84.7;55.8
FR;74;2021-06-01;10393;40285;2956986;1981610;85.0;57.0
FR;74;2021-06-02;8611;34183;2965597;2015793;85.3;58.0
FR;74;2021-06-03;10645;42360;2976242;2058153;85.6;59.2
FR;74;2021-06-04;9823;48074;2986065;2106227;85.8;60.6
FR;74;2021-06-05;4100;25127;2990165;2131354;86.0;61.3
FR;74;2021-06-06;944;4684;2991109;2136038;86.0;61.4
FR;74;2021-06-07;6184;31679;2997293;2167717;86.2;62.3
FR;74;2021-06-08;8814;38215;3006107;2205932;86.4;63.4
FR;74;2021-06-09;7712;32607;3013819;2238539;86.6;64.4
FR;74;2021-06-10;9130;38008;3022949;2276547;86.9;65.4
FR;74;2021-06-11;8314;46621;3031263;2323168;87.1;66.8
FR;74;2021-06-12;3686;20566;3034949;2343734;87.3;67.4
FR;74;2021-06-13;860;4156;3035809;2347890;87.3;67.5
FR;74;2021-06-14;5074;34111;3040883;2382001;87.4;68.5
FR;74;2021-06-15;7005;42680;3047888;2424681;87.6;69.7
FR;74;2021-06-16;5722;33326;3053610;2458007;87.8;70.7
FR;74;2021-06-17;7068;40801;3060678;2498808;88.0;71.8
FR;74;2021-06-18;5982;43634;3066660;2542442;88.2;73.1
FR;74;2021-06-19;2554;15752;3069214;2558194;88.2;73.5
FR;74;2021-06-20;482;2809;3069696;2561003;88.3;73.6
FR;74;2021-06-21;3627;25136;3073323;2586139;88.4;74.4
FR;74;2021-06-22;4858;32950;3078181;2619089;88.5;75.3
FR;74;2021-06-23;4356;23725;3082537;2642814;88.6;76.0
FR;74;2021-06-24;5384;26350;3087921;2669164;88.8;76.7
FR;74;2021-06-25;4784;30662;3092705;2699826;88.9;77.6
FR;74;2021-06-26;2119;12228;3094824;2712054;89.0;78.0
FR;74;2021-06-27;484;2644;3095308;2714698;89.0;78.0
FR;74;2021-06-28;2949;18639;3098257;2733337;89.1;78.6
FR;74;2021-06-29;4146;24292;3102403;2757629;89.2;79.3
FR;74;2021-06-30;4006;19111;3106409;2776740;89.3;79.8
FR;74;2021-07-01;5185;22176;3111594;2798916;89.5;80.5
FR;74;2021-07-02;4788;25454;3116382;2824370;89.6;81.2
FR;74;2021-07-03;1976;9987;3118358;2834357;89.7;81.5
FR;74;2021-07-04;500;2055;3118858;2836412;89.7;81.5
FR;74;2021-07-05;3439;14998;3122297;2851410;89.8;82.0
FR;74;2021-07-06;4654;19901;3126951;2871311;89.9;82.5
FR;74;2021-07-07;4468;14902;3131419;2886213;90.0;83.0
FR;74;2021-07-08;5487;16803;3136906;2903016;90.2;83.5
FR;74;2021-07-09;5015;17745;3141921;2920761;90.3;84.0
FR;74;2021-07-10;2166;7041;3144087;2927802;90.4;84.2
FR;74;2021-07-11;554;1372;3144641;2929174;90.4;84.2
FR;74;2021-07-12;3400;11966;3148041;2941140;90.5;84.6
FR;74;2021-07-13;5655;15137;3153696;2956277;90.7;85.0
FR;74;2021-07-14;1428;2123;3155124;2958400;90.7;85.1
FR;74;2021-07-15;6760;15160;3161884;2973560;90.9;85.5
FR;74;2021-07-16;7061;14961;3168945;2988521;91.1;85.9
FR;74;2021-07-17;3352;5749;3172297;2994270;91.2;86.1
FR;74;2021-07-18;770;1210;3173067;2995480;91.2;86.1
FR;74;2021-07-19;4634;10249;3177701;3005729;91.4;86.4
FR;74;2021-07-20;6450;13257;3184151;3018986;91.5;86.8
FR;74;2021-07-21;6360;11074;3190511;3030060;91.7;87.1
FR;74;2021-07-22;7330;12583;3197841;3042643;91.9;87.5
FR;74;2021-07-23;7416;12430;3205257;3055073;92.1;87.8
FR;74;2021-07-24;3424;4407;3208681;3059480;92.2;88.0
FR;74;2021-07-25;852;889;3209533;3060369;92.3;88.0
FR;74;2021-07-26;5216;8140;3214749;3068509;92.4;88.2
FR;74;2021-07-27;7750;10290;3222499;3078799;92.6;88.5
FR;74;2021-07-28;7226;8824;3229725;3087623;92.9;88.8
FR;74;2021-07-29;8387;9723;3238112;3097346;93.1;89.0
FR;74;2021-07-30;7746;9558;3245858;3106904;93.3;89.3
FR;74;2021-07-31;3568;3449;3249426;3110353;93.4;89.4
FR;74;2021-08-01;972;690;3250398;3111043;93.4;89.4
FR;74;2021-08-02;5337;5877;3255735;3116920;93.6;89.6
FR;74;2021-08-03;7246;7670;3262981;3124590;93.8;89.8
FR;74;2021-08-04;6747;6102;3269728;3130692;94.0;90.0
FR;74;2021-08-05;7038;6887;3276766;3137579;94.2;90.2
FR;74;2021-08-06;6924;7137;3283690;3144716;94.4;90.4
FR;74;2021-08-07;2840;2986;3286530;3147702;94.5;90.5
FR;74;2021-08-08;674;692;3287204;3148394;94.5;90.5
FR;74;2021-08-09;4387;5536;3291591;3153930;94.6;90.7
FR;74;2021-08-10;5981;7012;3297572;3160942;94.8;90.9
FR;74;2021-08-11;5472;5888;3303044;3166830;95.0;91.0
FR;74;2021-08-12;5789;6646;3308833;3173476;95.1;91.2
FR;74;2021-08-13;4989;5984;3313822;3179460;95.3;91.4
FR;74;2021-08-14;1953;2693;3315775;3182153;95.3;91.5
FR;74;2021-08-15;419;473;3316194;3182626;95.3;91.5
FR;74;2021-08-16;3079;5202;3319273;3187828;95.4;91.6
FR;74;2021-08-17;4348;6688;3323621;3194516;95.6;91.8
FR;74;2021-08-18;3824;6193;3327445;3200709;95.7;92.0
FR;74;2021-08-19;3931;6607;3331376;3207316;95.8;92.2
FR;74;2021-08-20;3540;6563;3334916;3213879;95.9;92.4
FR;74;2021-08-21;1369;2815;3336285;3216694;95.9;92.5
FR;74;2021-08-22;266;770;3336551;3217464;95.9;92.5
FR;74;2021-08-23;2295;5429;3338846;3222893;96.0;92.7
FR;79;2020-12-27;22;0;22;0;0.0;0.0
FR;79;2020-12-28;16;0;38;0;0.0;0.0
FR;79;2020-12-29;20;0;58;0;0.0;0.0
FR;79;2020-12-30;25;1;83;1;0.0;0.0
FR;79;2020-12-31;15;0;98;1;0.0;0.0
FR;79;2021-01-01;18;0;116;1;0.0;0.0
FR;79;2021-01-02;7;0;123;1;0.0;0.0
FR;79;2021-01-03;6;0;129;1;0.0;0.0
FR;79;2021-01-04;64;0;193;1;0.0;0.0
FR;79;2021-01-05;188;0;381;1;0.0;0.0
FR;79;2021-01-06;353;1;734;2;0.0;0.0
FR;79;2021-01-07;930;2;1664;4;0.1;0.0
FR;79;2021-01-08;1100;1;2764;5;0.1;0.0
FR;79;2021-01-09;374;1;3138;6;0.1;0.0
FR;79;2021-01-10;199;0;3337;6;0.2;0.0
FR;79;2021-01-11;1189;6;4526;12;0.2;0.0
FR;79;2021-01-12;2240;3;6766;15;0.3;0.0
FR;79;2021-01-13;2809;3;9575;18;0.4;0.0
FR;79;2021-01-14;4560;40;14135;58;0.6;0.0
FR;79;2021-01-15;5364;23;19499;81;0.9;0.0
FR;79;2021-01-16;2868;15;22367;96;1.0;0.0
FR;79;2021-01-17;1334;4;23701;100;1.1;0.0
FR;79;2021-01-18;19824;48;43525;148;2.0;0.0
FR;79;2021-01-19;26221;55;69746;203;3.1;0.0
FR;79;2021-01-20;28265;59;98011;262;4.4;0.0
FR;79;2021-01-21;30284;75;128295;337;5.8;0.0
FR;79;2021-01-22;28260;62;156555;399;7.1;0.0
FR;79;2021-01-23;11737;23;168292;422;7.6;0.0
FR;79;2021-01-24;2185;5;170477;427;7.7;0.0
FR;79;2021-01-25;22710;75;193187;502;8.7;0.0
FR;79;2021-01-26;25905;144;219092;646;9.9;0.0
FR;79;2021-01-27;25175;225;244267;871;11.0;0.0
FR;79;2021-01-28;25355;591;269622;1462;12.2;0.1
FR;79;2021-01-29;22674;590;292296;2052;13.2;0.1
FR;79;2021-01-30;8824;147;301120;2199;13.6;0.1
FR;79;2021-01-31;1241;54;302361;2253;13.6;0.1
FR;79;2021-02-01;16296;655;318657;2908;14.4;0.1
FR;79;2021-02-02;19419;1289;338076;4197;15.2;0.2
FR;79;2021-02-03;18412;1603;356488;5800;16.1;0.3
FR;79;2021-02-04;19288;2537;375776;8337;16.9;0.4
FR;79;2021-02-05;18137;2679;393913;11016;17.8;0.5
FR;79;2021-02-06;6531;1011;400444;12027;18.1;0.5
FR;79;2021-02-07;878;392;401322;12419;18.1;0.6
FR;79;2021-02-08;13183;5787;414505;18206;18.7;0.8
FR;79;2021-02-09;15638;7634;430143;25840;19.4;1.2
FR;79;2021-02-10;15548;7982;445691;33822;20.1;1.5
FR;79;2021-02-11;16609;9559;462300;43381;20.8;2.0
FR;79;2021-02-12;15764;9352;478064;52733;21.6;2.4
FR;79;2021-02-13;5044;4107;483108;56840;21.8;2.6
FR;79;2021-02-14;912;1038;484020;57878;21.8;2.6
FR;79;2021-02-15;7157;19686;491177;77564;22.2;3.5
FR;79;2021-02-16;8386;23490;499563;101054;22.5;4.6
FR;79;2021-02-17;8287;23855;507850;124909;22.9;5.6
FR;79;2021-02-18;10376;24291;518226;149200;23.4;6.7
FR;79;2021-02-19;10381;20635;528607;169835;23.8;7.7
FR;79;2021-02-20;3789;8276;532396;178111;24.0;8.0
FR;79;2021-02-21;556;1553;532952;179664;24.0;8.1
FR;79;2021-02-22;7014;21762;539966;201426;24.4;9.1
FR;79;2021-02-23;9692;23462;549658;224888;24.8;10.1
FR;79;2021-02-24;10119;22119;559777;247007;25.2;11.1
FR;79;2021-02-25;11758;21996;571535;269003;25.8;12.1
FR;79;2021-02-26;12135;19098;583670;288101;26.3;13.0
FR;79;2021-02-27;4440;6740;588110;294841;26.5;13.3
FR;79;2021-02-28;884;1038;588994;295879;26.6;13.3
FR;79;2021-03-01;12184;16473;601178;312352;27.1;14.1
FR;79;2021-03-02;16396;19312;617574;331664;27.9;15.0
FR;79;2021-03-03;17843;18555;635417;350219;28.7;15.8
FR;79;2021-03-04;21090;17799;656507;368018;29.6;16.6
FR;79;2021-03-05;22576;16608;679083;384626;30.6;17.3
FR;79;2021-03-06;29184;5736;708267;390362;31.9;17.6
FR;79;2021-03-07;21148;1358;729415;391720;32.9;17.7
FR;79;2021-03-08;17472;15458;746887;407178;33.7;18.4
FR;79;2021-03-09;25879;16657;772766;423835;34.9;19.1
FR;79;2021-03-10;27034;15847;799800;439682;36.1;19.8
FR;79;2021-03-11;32003;15427;831803;455109;37.5;20.5
FR;79;2021-03-12;33537;13281;865340;468390;39.0;21.1
FR;79;2021-03-13;25492;4581;890832;472971;40.2;21.3
FR;79;2021-03-14;9516;924;900348;473895;40.6;21.4
FR;79;2021-03-15;28625;8977;928973;482872;41.9;21.8
FR;79;2021-03-16;32937;9566;961910;492438;43.4;22.2
FR;79;2021-03-17;33933;9566;995843;502004;44.9;22.6
FR;79;2021-03-18;36817;10013;1032660;512017;46.6;23.1
FR;79;2021-03-19;36877;9178;1069537;521195;48.2;23.5
FR;79;2021-03-20;20757;3523;1090294;524718;49.2;23.7
FR;79;2021-03-21;5894;673;1096188;525391;49.4;23.7
FR;79;2021-03-22;28674;9405;1124862;534796;50.7;24.1
FR;79;2021-03-23;37193;11070;1162055;545866;52.4;24.6
FR;79;2021-03-24;35647;11562;1197702;557428;54.0;25.1
FR;79;2021-03-25;42088;11441;1239790;568869;55.9;25.7
FR;79;2021-03-26;39521;10740;1279311;579609;57.7;26.1
FR;79;2021-03-27;17700;4562;1297011;584171;58.5;26.3
FR;79;2021-03-28;4809;956;1301820;585127;58.7;26.4
FR;79;2021-03-29;22339;15141;1324159;600268;59.7;27.1
FR;79;2021-03-30;28102;19067;1352261;619335;61.0;27.9
FR;79;2021-03-31;24717;19861;1376978;639196;62.1;28.8
FR;79;2021-04-01;27262;23318;1404240;662514;63.3;29.9
FR;79;2021-04-02;23153;24558;1427393;687072;64.4;31.0
FR;79;2021-04-03;10023;17406;1437416;704478;64.8;31.8
FR;79;2021-04-04;2807;5083;1440223;709561;65.0;32.0
FR;79;2021-04-05;4206;2766;1444429;712327;65.1;32.1
FR;79;2021-04-06;19041;29004;1463470;741331;66.0;33.4
FR;79;2021-04-07;21104;29925;1484574;771256;67.0;34.8
FR;79;2021-04-08;25056;30023;1509630;801279;68.1;36.1
FR;79;2021-04-09;26922;28252;1536552;829531;69.3;37.4
FR;79;2021-04-10;13599;19008;1550151;848539;69.9;38.3
FR;79;2021-04-11;3493;6465;1553644;855004;70.1;38.6
FR;79;2021-04-12;16753;28967;1570397;883971;70.8;39.9
FR;79;2021-04-13;19156;35060;1589553;919031;71.7;41.4
FR;79;2021-04-14;18241;33192;1607794;952223;72.5;42.9
FR;79;2021-04-15;19145;33403;1626939;985626;73.4;44.5
FR;79;2021-04-16;16278;31115;1643217;1016741;74.1;45.9
FR;79;2021-04-17;8168;16725;1651385;1033466;74.5;46.6
FR;79;2021-04-18;1774;4826;1653159;1038292;74.6;46.8
FR;79;2021-04-19;9850;29204;1663009;1067496;75.0;48.1
FR;79;2021-04-20;11720;34487;1674729;1101983;75.5;49.7
FR;79;2021-04-21;11307;31259;1686036;1133242;76.0;51.1
FR;79;2021-04-22;12881;31168;1698917;1164410;76.6;52.5
FR;79;2021-04-23;11938;27741;1710855;1192151;77.2;53.8
FR;79;2021-04-24;6182;13752;1717037;1205903;77.4;54.4
FR;79;2021-04-25;1915;3433;1718952;1209336;77.5;54.5
FR;79;2021-04-26;8974;20637;1727926;1229973;77.9;55.5
FR;79;2021-04-27;11117;23742;1739043;1253715;78.4;56.5
FR;79;2021-04-28;11621;21060;1750664;1274775;79.0;57.5
FR;79;2021-04-29;13689;20836;1764353;1295611;79.6;58.4
FR;79;2021-04-30;12856;17705;1777209;1313316;80.2;59.2
FR;79;2021-05-01;3831;3955;1781040;1317271;80.3;59.4
FR;79;2021-05-02;1751;2635;1782791;1319906;80.4;59.5
FR;79;2021-05-03;8619;15185;1791410;1335091;80.8;60.2
FR;79;2021-05-04;8951;20229;1800361;1355320;81.2;61.1
FR;79;2021-05-05;8450;19055;1808811;1374375;81.6;62.0
FR;79;2021-05-06;10296;18907;1819107;1393282;82.0;62.8
FR;79;2021-05-07;8990;19529;1828097;1412811;82.4;63.7
FR;79;2021-05-08;3115;4314;1831212;1417125;82.6;63.9
FR;79;2021-05-09;1391;3004;1832603;1420129;82.6;64.0
FR;79;2021-05-10;6198;17534;1838801;1437663;82.9;64.8
FR;79;2021-05-11;8042;18643;1846843;1456306;83.3;65.7
FR;79;2021-05-12;7326;15861;1854169;1472167;83.6;66.4
FR;79;2021-05-13;3516;3821;1857685;1475988;83.8;66.6
FR;79;2021-05-14;6793;11416;1864478;1487404;84.1;67.1
FR;79;2021-05-15;3319;5113;1867797;1492517;84.2;67.3
FR;79;2021-05-16;1149;1163;1868946;1493680;84.3;67.4
FR;79;2021-05-17;4959;9096;1873905;1502776;84.5;67.8
FR;79;2021-05-18;6167;9243;1880072;1512019;84.8;68.2
FR;79;2021-05-19;5749;8086;1885821;1520105;85.0;68.6
FR;79;2021-05-20;6664;8240;1892485;1528345;85.4;68.9
FR;79;2021-05-21;5642;8835;1898127;1537180;85.6;69.3
FR;79;2021-05-22;2425;3829;1900552;1541009;85.7;69.5
FR;79;2021-05-23;729;807;1901281;1541816;85.7;69.5
FR;79;2021-05-24;1845;1639;1903126;1543455;85.8;69.6
FR;79;2021-05-25;4385;10282;1907511;1553737;86.0;70.1
FR;79;2021-05-26;4355;9616;1911866;1563353;86.2;70.5
FR;79;2021-05-27;5238;11087;1917104;1574440;86.5;71.0
FR;79;2021-05-28;4763;12469;1921867;1586909;86.7;71.6
FR;79;2021-05-29;2060;6686;1923927;1593595;86.8;71.9
FR;79;2021-05-30;439;1260;1924366;1594855;86.8;71.9
FR;79;2021-05-31;3211;9077;1927577;1603932;86.9;72.3
FR;79;2021-06-01;4456;11215;1932033;1615147;87.1;72.8
FR;79;2021-06-02;3928;9816;1935961;1624963;87.3;73.3
FR;79;2021-06-03;4834;11302;1940795;1636265;87.5;73.8
FR;79;2021-06-04;4337;12743;1945132;1649008;87.7;74.4
FR;79;2021-06-05;1937;6486;1947069;1655494;87.8;74.7
FR;79;2021-06-06;438;1440;1947507;1656934;87.8;74.7
FR;79;2021-06-07;2710;10069;1950217;1667003;88.0;75.2
FR;79;2021-06-08;3820;11749;1954037;1678752;88.1;75.7
FR;79;2021-06-09;3359;10183;1957396;1688935;88.3;76.2
FR;79;2021-06-10;3967;11183;1961363;1700118;88.5;76.7
FR;79;2021-06-11;3691;13208;1965054;1713326;88.6;77.3
FR;79;2021-06-12;1675;5630;1966729;1718956;88.7;77.5
FR;79;2021-06-13;319;1321;1967048;1720277;88.7;77.6
FR;79;2021-06-14;2061;11109;1969109;1731386;88.8;78.1
FR;79;2021-06-15;2940;12709;1972049;1744095;88.9;78.7
FR;79;2021-06-16;2509;10013;1974558;1754108;89.1;79.1
FR;79;2021-06-17;2916;11276;1977474;1765384;89.2;79.6
FR;79;2021-06-18;2753;12350;1980227;1777734;89.3;80.2
FR;79;2021-06-19;1191;4483;1981418;1782217;89.4;80.4
FR;79;2021-06-20;205;933;1981623;1783150;89.4;80.4
FR;79;2021-06-21;1576;8181;1983199;1791331;89.4;80.8
FR;79;2021-06-22;2160;10207;1985359;1801538;89.5;81.2
FR;79;2021-06-23;1982;7680;1987341;1809218;89.6;81.6
FR;79;2021-06-24;2475;7743;1989816;1816961;89.7;81.9
FR;79;2021-06-25;2368;9294;1992184;1826255;89.8;82.4
FR;79;2021-06-26;996;3860;1993180;1830115;89.9;82.5
FR;79;2021-06-27;198;967;1993378;1831082;89.9;82.6
FR;79;2021-06-28;1361;6830;1994739;1837912;90.0;82.9
FR;79;2021-06-29;1949;8105;1996688;1846017;90.0;83.3
FR;79;2021-06-30;1946;6892;1998634;1852909;90.1;83.6
FR;79;2021-07-01;2397;7433;2001031;1860342;90.2;83.9
FR;79;2021-07-02;2390;8323;2003421;1868665;90.4;84.3
FR;79;2021-07-03;948;3370;2004369;1872035;90.4;84.4
FR;79;2021-07-04;240;856;2004609;1872891;90.4;84.5
FR;79;2021-07-05;1532;5630;2006141;1878521;90.5;84.7
FR;79;2021-07-06;2132;7030;2008273;1885551;90.6;85.0
FR;79;2021-07-07;2019;5587;2010292;1891138;90.7;85.3
FR;79;2021-07-08;2603;6219;2012895;1897357;90.8;85.6
FR;79;2021-07-09;2373;6521;2015268;1903878;90.9;85.9
FR;79;2021-07-10;1040;2718;2016308;1906596;90.9;86.0
FR;79;2021-07-11;256;542;2016564;1907138;90.9;86.0
FR;79;2021-07-12;1668;4838;2018232;1911976;91.0;86.2
FR;79;2021-07-13;2646;6228;2020878;1918204;91.1;86.5
FR;79;2021-07-14;649;918;2021527;1919122;91.2;86.6
FR;79;2021-07-15;3161;6291;2024688;1925413;91.3;86.8
FR;79;2021-07-16;3481;6296;2028169;1931709;91.5;87.1
FR;79;2021-07-17;1615;2508;2029784;1934217;91.5;87.2
FR;79;2021-07-18;389;523;2030173;1934740;91.6;87.3
FR;79;2021-07-19;2315;4431;2032488;1939171;91.7;87.5
FR;79;2021-07-20;3280;5726;2035768;1944897;91.8;87.7
FR;79;2021-07-21;3146;4907;2038914;1949804;92.0;87.9
FR;79;2021-07-22;3577;5610;2042491;1955414;92.1;88.2
FR;79;2021-07-23;3651;5538;2046142;1960952;92.3;88.4
FR;79;2021-07-24;1706;2081;2047848;1963033;92.4;88.5
FR;79;2021-07-25;460;404;2048308;1963437;92.4;88.6
FR;79;2021-07-26;2561;3746;2050869;1967183;92.5;88.7
FR;79;2021-07-27;3792;4824;2054661;1972007;92.7;88.9
FR;79;2021-07-28;3650;4073;2058311;1976080;92.8;89.1
FR;79;2021-07-29;4267;4591;2062578;1980671;93.0;89.3
FR;79;2021-07-30;4149;4523;2066727;1985194;93.2;89.5
FR;79;2021-07-31;1669;1606;2068396;1986800;93.3;89.6
FR;79;2021-08-01;436;342;2068832;1987142;93.3;89.6
FR;79;2021-08-02;2618;2801;2071450;1989943;93.4;89.7
FR;79;2021-08-03;3639;3682;2075089;1993625;93.6;89.9
FR;79;2021-08-04;3474;3011;2078563;1996636;93.7;90.0
FR;79;2021-08-05;3658;3557;2082221;2000193;93.9;90.2
FR;79;2021-08-06;3409;3496;2085630;2003689;94.1;90.4
FR;79;2021-08-07;1533;1451;2087163;2005140;94.1;90.4
FR;79;2021-08-08;353;357;2087516;2005497;94.1;90.4
FR;79;2021-08-09;2239;2837;2089755;2008334;94.2;90.6
FR;79;2021-08-10;3180;3825;2092935;2012159;94.4;90.7
FR;79;2021-08-11;2943;3209;2095878;2015368;94.5;90.9
FR;79;2021-08-12;3135;3518;2099013;2018886;94.7;91.1
FR;79;2021-08-13;2688;3103;2101701;2021989;94.8;91.2
FR;79;2021-08-14;1067;1393;2102768;2023382;94.8;91.3
FR;79;2021-08-15;204;280;2102972;2023662;94.8;91.3
FR;79;2021-08-16;1713;2633;2104685;2026295;94.9;91.4
FR;79;2021-08-17;2488;3606;2107173;2029901;95.0;91.5
FR;79;2021-08-18;2180;3166;2109353;2033067;95.1;91.7
FR;79;2021-08-19;2312;3562;2111665;2036629;95.2;91.9
FR;79;2021-08-20;2179;3753;2113844;2040382;95.3;92.0
FR;79;2021-08-21;806;1440;2114650;2041822;95.4;92.1
FR;79;2021-08-22;168;348;2114818;2042170;95.4;92.1
FR;79;2021-08-23;1371;2887;2116189;2045057;95.4;92.2
FR;80;2020-12-27;30;2;30;2;0.0;0.0
FR;80;2020-12-28;53;0;83;2;0.0;0.0
FR;80;2020-12-29;83;0;166;2;0.0;0.0
FR;80;2020-12-30;105;0;271;2;0.0;0.0
FR;80;2020-12-31;59;0;330;2;0.0;0.0
FR;80;2021-01-01;23;0;353;2;0.0;0.0
FR;80;2021-01-02;16;1;369;3;0.0;0.0
FR;80;2021-01-03;5;0;374;3;0.0;0.0
FR;80;2021-01-04;319;1;693;4;0.0;0.0
FR;80;2021-01-05;956;2;1649;6;0.0;0.0
FR;80;2021-01-06;1702;5;3351;11;0.1;0.0
FR;80;2021-01-07;6434;8;9785;19;0.2;0.0
FR;80;2021-01-08;5858;16;15643;35;0.4;0.0
FR;80;2021-01-09;987;0;16630;35;0.4;0.0
FR;80;2021-01-10;327;0;16957;35;0.4;0.0
FR;80;2021-01-11;4565;12;21522;47;0.5;0.0
FR;80;2021-01-12;12911;29;34433;76;0.8;0.0
FR;80;2021-01-13;12628;41;47061;117;1.1;0.0
FR;80;2021-01-14;18588;130;65649;247;1.6;0.0
FR;80;2021-01-15;12411;42;78060;289;1.9;0.0
FR;80;2021-01-16;4113;31;82173;320;2.0;0.0
FR;80;2021-01-17;3778;23;85951;343;2.1;0.0
FR;80;2021-01-18;28957;102;114908;445;2.8;0.0
FR;80;2021-01-19;54244;159;169152;604;4.1;0.0
FR;80;2021-01-20;60029;209;229181;813;5.5;0.0
FR;80;2021-01-21;70767;186;299948;999;7.2;0.0
FR;80;2021-01-22;48917;113;348865;1112;8.4;0.0
FR;80;2021-01-23;16298;33;365163;1145;8.8;0.0
FR;80;2021-01-24;4330;6;369493;1151;8.9;0.0
FR;80;2021-01-25;32703;153;402196;1304;9.7;0.0
FR;80;2021-01-26;45494;588;447690;1892;10.8;0.0
FR;80;2021-01-27;51307;1027;498997;2919;12.0;0.1
FR;80;2021-01-28;60584;4059;559581;6978;13.5;0.2
FR;80;2021-01-29;39545;3314;599126;10292;14.4;0.2
FR;80;2021-01-30;13282;609;612408;10901;14.7;0.3
FR;80;2021-01-31;2354;291;614762;11192;14.8;0.3
FR;80;2021-02-01;23167;2832;637929;14024;15.3;0.3
FR;80;2021-02-02;33802;7492;671731;21516;16.2;0.5
FR;80;2021-02-03;34653;7900;706384;29416;17.0;0.7
FR;80;2021-02-04;38322;12639;744706;42055;17.9;1.0
FR;80;2021-02-05;29918;9554;774624;51609;18.6;1.2
FR;80;2021-02-06;9779;2135;784403;53744;18.9;1.3
FR;80;2021-02-07;1456;1868;785859;55612;18.9;1.3
FR;80;2021-02-08;19453;11136;805312;66748;19.4;1.6
FR;80;2021-02-09;26086;25546;831398;92294;20.0;2.2
FR;80;2021-02-10;26484;28890;857882;121184;20.6;2.9
FR;80;2021-02-11;30766;38044;888648;159228;21.4;3.8
FR;80;2021-02-12;26871;24665;915519;183893;22.0;4.4
FR;80;2021-02-13;7972;6503;923491;190396;22.2;4.6
FR;80;2021-02-14;1517;3089;925008;193485;22.2;4.7
FR;80;2021-02-15;11176;28199;936184;221684;22.5;5.3
FR;80;2021-02-16;15610;38788;951794;260472;22.9;6.3
FR;80;2021-02-17;16031;44300;967825;304772;23.3;7.3
FR;80;2021-02-18;21747;52290;989572;357062;23.8;8.6
FR;80;2021-02-19;19129;37326;1008701;394388;24.3;9.5
FR;80;2021-02-20;6341;12311;1015042;406699;24.4;9.8
FR;80;2021-02-21;912;2967;1015954;409666;24.4;9.9
FR;80;2021-02-22;11193;30535;1027147;440201;24.7;10.6
FR;80;2021-02-23;17154;37184;1044301;477385;25.1;11.5
FR;80;2021-02-24;18113;37003;1062414;514388;25.6;12.4
FR;80;2021-02-25;22463;40746;1084877;555134;26.1;13.4
FR;80;2021-02-26;20663;30906;1105540;586040;26.6;14.1
FR;80;2021-02-27;7203;10274;1112743;596314;26.8;14.3
FR;80;2021-02-28;1263;2119;1114006;598433;26.8;14.4
FR;80;2021-03-01;18869;23228;1132875;621661;27.2;15.0
FR;80;2021-03-02;27032;29170;1159907;650831;27.9;15.7
FR;80;2021-03-03;28880;29333;1188787;680164;28.6;16.4
FR;80;2021-03-04;35193;29886;1223980;710050;29.4;17.1
FR;80;2021-03-05;36026;27696;1260006;737746;30.3;17.7
FR;80;2021-03-06;41541;8736;1301547;746482;31.3;18.0
FR;80;2021-03-07;29776;2378;1331323;748860;32.0;18.0
FR;80;2021-03-08;27279;22660;1358602;771520;32.7;18.6
FR;80;2021-03-09;40891;24909;1399493;796429;33.7;19.2
FR;80;2021-03-10;43287;25690;1442780;822119;34.7;19.8
FR;80;2021-03-11;51874;27282;1494654;849401;35.9;20.4
FR;80;2021-03-12;52334;23361;1546988;872762;37.2;21.0
FR;80;2021-03-13;37686;7356;1584674;880118;38.1;21.2
FR;80;2021-03-14;13938;1680;1598612;881798;38.4;21.2
FR;80;2021-03-15;44263;14283;1642875;896081;39.5;21.6
FR;80;2021-03-16;51971;17389;1694846;913470;40.8;22.0
FR;80;2021-03-17;54827;16993;1749673;930463;42.1;22.4
FR;80;2021-03-18;58696;19157;1808369;949620;43.5;22.8
FR;80;2021-03-19;57536;16116;1865905;965736;44.9;23.2
FR;80;2021-03-20;31098;5579;1897003;971315;45.6;23.4
FR;80;2021-03-21;8714;1153;1905717;972468;45.8;23.4
FR;80;2021-03-22;43000;14799;1948717;987267;46.9;23.7
FR;80;2021-03-23;55767;18345;2004484;1005612;48.2;24.2
FR;80;2021-03-24;54628;19288;2059112;1024900;49.5;24.6
FR;80;2021-03-25;64249;19965;2123361;1044865;51.1;25.1
FR;80;2021-03-26;60346;18551;2183707;1063416;52.5;25.6
FR;80;2021-03-27;26629;7542;2210336;1070958;53.2;25.8
FR;80;2021-03-28;6936;1496;2217272;1072454;53.3;25.8
FR;80;2021-03-29;32907;23553;2250179;1096007;54.1;26.4
FR;80;2021-03-30;43385;30919;2293564;1126926;55.2;27.1
FR;80;2021-03-31;40645;32300;2334209;1159226;56.1;27.9
FR;80;2021-04-01;46408;38014;2380617;1197240;57.3;28.8
FR;80;2021-04-02;37242;39904;2417859;1237144;58.2;29.8
FR;80;2021-04-03;14531;26158;2432390;1263302;58.5;30.4
FR;80;2021-04-04;3870;7570;2436260;1270872;58.6;30.6
FR;80;2021-04-05;5635;4106;2441895;1274978;58.7;30.7
FR;80;2021-04-06;27729;45074;2469624;1320052;59.4;31.7
FR;80;2021-04-07;33635;48503;2503259;1368555;60.2;32.9
FR;80;2021-04-08;40326;49651;2543585;1418206;61.2;34.1
FR;80;2021-04-09;43674;46605;2587259;1464811;62.2;35.2
FR;80;2021-04-10;19831;28985;2607090;1493796;62.7;35.9
FR;80;2021-04-11;4829;9376;2611919;1503172;62.8;36.2
FR;80;2021-04-12;23541;45219;2635460;1548391;63.4;37.2
FR;80;2021-04-13;30295;54707;2665755;1603098;64.1;38.6
FR;80;2021-04-14;29193;52256;2694948;1655354;64.8;39.8
FR;80;2021-04-15;31663;52805;2726611;1708159;65.6;41.1
FR;80;2021-04-16;26535;49121;2753146;1757280;66.2;42.3
FR;80;2021-04-17;12393;25640;2765539;1782920;66.5;42.9
FR;80;2021-04-18;2534;7625;2768073;1790545;66.6;43.1
FR;80;2021-04-19;14264;43727;2782337;1834272;66.9;44.1
FR;80;2021-04-20;17966;53166;2800303;1887438;67.3;45.4
FR;80;2021-04-21;17997;49884;2818300;1937322;67.8;46.6
FR;80;2021-04-22;20816;51429;2839116;1988751;68.3;47.8
FR;80;2021-04-23;19176;44778;2858292;2033529;68.7;48.9
FR;80;2021-04-24;9470;21245;2867762;2054774;69.0;49.4
FR;80;2021-04-25;2688;5162;2870450;2059936;69.0;49.5
FR;80;2021-04-26;12409;30662;2882859;2090598;69.3;50.3
FR;80;2021-04-27;16914;36588;2899773;2127186;69.7;51.2
FR;80;2021-04-28;18058;34824;2917831;2162010;70.2;52.0
FR;80;2021-04-29;21915;35973;2939746;2197983;70.7;52.9
FR;80;2021-04-30;20542;29780;2960288;2227763;71.2;53.6
FR;80;2021-05-01;5832;5851;2966120;2233614;71.3;53.7
FR;80;2021-05-02;2619;3869;2968739;2237483;71.4;53.8
FR;80;2021-05-03;12535;21489;2981274;2258972;71.7;54.3
FR;80;2021-05-04;13983;30160;2995257;2289132;72.0;55.1
FR;80;2021-05-05;13692;29469;3008949;2318601;72.4;55.8
FR;80;2021-05-06;16103;29831;3025052;2348432;72.8;56.5
FR;80;2021-05-07;14691;29914;3039743;2378346;73.1;57.2
FR;80;2021-05-08;4718;6067;3044461;2384413;73.2;57.3
FR;80;2021-05-09;1933;4155;3046394;2388568;73.3;57.4
FR;80;2021-05-10;9303;24437;3055697;2413005;73.5;58.0
FR;80;2021-05-11;12742;27386;3068439;2440391;73.8;58.7
FR;80;2021-05-12;11708;23724;3080147;2464115;74.1;59.3
FR;80;2021-05-13;4936;5455;3085083;2469570;74.2;59.4
FR;80;2021-05-14;10513;16455;3095596;2486025;74.5;59.8
FR;80;2021-05-15;4873;7367;3100469;2493392;74.6;60.0
FR;80;2021-05-16;1558;1532;3102027;2494924;74.6;60.0
FR;80;2021-05-17;7131;13221;3109158;2508145;74.8;60.3
FR;80;2021-05-18;9733;13730;3118891;2521875;75.0;60.7
FR;80;2021-05-19;9150;12286;3128041;2534161;75.2;60.9
FR;80;2021-05-20;10955;12836;3138996;2546997;75.5;61.3
FR;80;2021-05-21;8956;13223;3147952;2560220;75.7;61.6
FR;80;2021-05-22;3874;5227;3151826;2565447;75.8;61.7
FR;80;2021-05-23;1018;1147;3152844;2566594;75.8;61.7
FR;80;2021-05-24;2595;2257;3155439;2568851;75.9;61.8
FR;80;2021-05-25;6677;14319;3162116;2583170;76.1;62.1
FR;80;2021-05-26;6943;14356;3169059;2597526;76.2;62.5
FR;80;2021-05-27;8800;17006;3177859;2614532;76.4;62.9
FR;80;2021-05-28;8368;18221;3186227;2632753;76.6;63.3
FR;80;2021-05-29;3474;8863;3189701;2641616;76.7;63.5
FR;80;2021-05-30;642;1596;3190343;2643212;76.7;63.6
FR;80;2021-05-31;5022;12768;3195365;2655980;76.9;63.9
FR;80;2021-06-01;7440;16812;3202805;2672792;77.0;64.3
FR;80;2021-06-02;6529;15018;3209334;2687810;77.2;64.6
FR;80;2021-06-03;8623;17034;3217957;2704844;77.4;65.1
FR;80;2021-06-04;7738;19022;3225695;2723866;77.6;65.5
FR;80;2021-06-05;3408;9233;3229103;2733099;77.7;65.7
FR;80;2021-06-06;647;2050;3229750;2735149;77.7;65.8
FR;80;2021-06-07;4346;14152;3234096;2749301;77.8;66.1
FR;80;2021-06-08;6430;17492;3240526;2766793;77.9;66.5
FR;80;2021-06-09;5883;15520;3246409;2782313;78.1;66.9
FR;80;2021-06-10;7228;17170;3253637;2799483;78.3;67.3
FR;80;2021-06-11;6592;19853;3260229;2819336;78.4;67.8
FR;80;2021-06-12;2815;8293;3263044;2827629;78.5;68.0
FR;80;2021-06-13;507;2038;3263551;2829667;78.5;68.1
FR;80;2021-06-14;3260;15386;3266811;2845053;78.6;68.4
FR;80;2021-06-15;4935;18535;3271746;2863588;78.7;68.9
FR;80;2021-06-16;4489;15209;3276235;2878797;78.8;69.2
FR;80;2021-06-17;5559;17327;3281794;2896124;78.9;69.7
FR;80;2021-06-18;4986;18103;3286780;2914227;79.0;70.1
FR;80;2021-06-19;2107;6648;3288887;2920875;79.1;70.2
FR;80;2021-06-20;323;1312;3289210;2922187;79.1;70.3
FR;80;2021-06-21;2537;12052;3291747;2934239;79.2;70.6
FR;80;2021-06-22;3766;14974;3295513;2949213;79.3;70.9
FR;80;2021-06-23;3510;12068;3299023;2961281;79.3;71.2
FR;80;2021-06-24;4248;12784;3303271;2974065;79.4;71.5
FR;80;2021-06-25;4131;14707;3307402;2988772;79.5;71.9
FR;80;2021-06-26;1747;6030;3309149;2994802;79.6;72.0
FR;80;2021-06-27;302;1448;3309451;2996250;79.6;72.1
FR;80;2021-06-28;2143;9954;3311594;3006204;79.6;72.3
FR;80;2021-06-29;3311;12369;3314905;3018573;79.7;72.6
FR;80;2021-06-30;3233;10778;3318138;3029351;79.8;72.9
FR;80;2021-07-01;4131;12180;3322269;3041531;79.9;73.2
FR;80;2021-07-02;3947;13464;3326216;3054995;80.0;73.5
FR;80;2021-07-03;1680;5447;3327896;3060442;80.0;73.6
FR;80;2021-07-04;337;1289;3328233;3061731;80.0;73.6
FR;80;2021-07-05;2374;8275;3330607;3070006;80.1;73.8
FR;80;2021-07-06;3566;11264;3334173;3081270;80.2;74.1
FR;80;2021-07-07;3449;9254;3337622;3090524;80.3;74.3
FR;80;2021-07-08;4472;10670;3342094;3101194;80.4;74.6
FR;80;2021-07-09;4148;11097;3346242;3112291;80.5;74.9
FR;80;2021-07-10;1777;4436;3348019;3116727;80.5;75.0
FR;80;2021-07-11;377;895;3348396;3117622;80.5;75.0
FR;80;2021-07-12;2575;7266;3350971;3124888;80.6;75.2
FR;80;2021-07-13;4211;9870;3355182;3134758;80.7;75.4
FR;80;2021-07-14;924;1604;3356106;3136362;80.7;75.4
FR;80;2021-07-15;4875;10196;3360981;3146558;80.8;75.7
FR;80;2021-07-16;5357;10491;3366338;3157049;81.0;75.9
FR;80;2021-07-17;2403;3838;3368741;3160887;81.0;76.0
FR;80;2021-07-18;448;842;3369189;3161729;81.0;76.0
FR;80;2021-07-19;3204;7056;3372393;3168785;81.1;76.2
FR;80;2021-07-20;4865;9341;3377258;3178126;81.2;76.4
FR;80;2021-07-21;4698;8264;3381956;3186390;81.3;76.6
FR;80;2021-07-22;5720;9835;3387676;3196225;81.5;76.9
FR;80;2021-07-23;5738;9774;3393414;3205999;81.6;77.1
FR;80;2021-07-24;2584;3423;3395998;3209422;81.7;77.2
FR;80;2021-07-25;547;669;3396545;3210091;81.7;77.2
FR;80;2021-07-26;3725;5965;3400270;3216056;81.8;77.3
FR;80;2021-07-27;5865;8146;3406135;3224202;81.9;77.5
FR;80;2021-07-28;5676;7039;3411811;3231241;82.1;77.7
FR;80;2021-07-29;6788;8250;3418599;3239491;82.2;77.9
FR;80;2021-07-30;6463;7994;3425062;3247485;82.4;78.1
FR;80;2021-07-31;2962;2845;3428024;3250330;82.4;78.2
FR;80;2021-08-01;614;554;3428638;3250884;82.5;78.2
FR;80;2021-08-02;3821;4497;3432459;3255381;82.6;78.3
FR;80;2021-08-03;5811;6388;3438270;3261769;82.7;78.4
FR;80;2021-08-04;5543;5325;3443813;3267094;82.8;78.6
FR;80;2021-08-05;6168;6116;3449981;3273210;83.0;78.7
FR;80;2021-08-06;5880;6213;3455861;3279423;83.1;78.9
FR;80;2021-08-07;2471;2374;3458332;3281797;83.2;78.9
FR;80;2021-08-08;498;580;3458830;3282377;83.2;78.9
FR;80;2021-08-09;3510;4793;3462340;3287170;83.3;79.1
FR;80;2021-08-10;5286;6480;3467626;3293650;83.4;79.2
FR;80;2021-08-11;4782;5589;3472408;3299239;83.5;79.3
FR;80;2021-08-12;5558;6320;3477966;3305559;83.6;79.5
FR;80;2021-08-13;4829;5437;3482795;3310996;83.8;79.6
FR;80;2021-08-14;1929;2174;3484724;3313170;83.8;79.7
FR;80;2021-08-15;356;427;3485080;3313597;83.8;79.7
FR;80;2021-08-16;2953;4341;3488033;3317938;83.9;79.8
FR;80;2021-08-17;4401;6127;3492434;3324065;84.0;79.9
FR;80;2021-08-18;3969;5477;3496403;3329542;84.1;80.1
FR;80;2021-08-19;4460;6120;3500863;3335662;84.2;80.2
FR;80;2021-08-20;3907;6101;3504770;3341763;84.3;80.4
FR;80;2021-08-21;1619;2339;3506389;3344102;84.3;80.4
FR;80;2021-08-22;248;549;3506637;3344651;84.3;80.4
FR;80;2021-08-23;2242;4477;3508879;3349128;84.4;80.5
FR;0;2020-12-27;261;4;261;4;0.0;0.0
FR;0;2020-12-28;282;1;543;5;0.0;0.0
FR;0;2020-12-29;208;0;751;5;0.0;0.0
FR;0;2020-12-30;252;1;1003;6;0.0;0.0
FR;0;2020-12-31;189;0;1192;6;0.0;0.0
FR;0;2021-01-01;208;3;1400;9;0.0;0.0
FR;0;2021-01-02;164;5;1564;14;0.0;0.0
FR;0;2021-01-03;195;1;1759;15;0.0;0.0
FR;0;2021-01-04;1655;9;3414;24;0.0;0.0
FR;0;2021-01-05;5609;25;9023;49;0.0;0.0
FR;0;2021-01-06;11507;53;20530;102;0.0;0.0
FR;0;2021-01-07;28953;92;49483;194;0.1;0.0
FR;0;2021-01-08;36625;130;86108;324;0.1;0.0
FR;0;2021-01-09;11037;25;97145;349;0.1;0.0
FR;0;2021-01-10;5733;13;102878;362;0.2;0.0
FR;0;2021-01-11;39504;136;142382;498;0.2;0.0
FR;0;2021-01-12;61521;221;203903;719;0.3;0.0
FR;0;2021-01-13;64467;296;268370;1015;0.4;0.0
FR;0;2021-01-14;81394;839;349764;1854;0.5;0.0
FR;0;2021-01-15;68321;431;418085;2285;0.6;0.0
FR;0;2021-01-16;19955;155;438040;2440;0.7;0.0
FR;0;2021-01-17;10678;82;448718;2522;0.7;0.0
FR;0;2021-01-18;85175;474;533893;2996;0.8;0.0
FR;0;2021-01-19;129724;585;663617;3581;1.0;0.0
FR;0;2021-01-20;136590;597;800207;4178;1.2;0.0
FR;0;2021-01-21;157149;646;957356;4824;1.4;0.0
FR;0;2021-01-22;120086;565;1077442;5389;1.6;0.0
FR;0;2021-01-23;38119;133;1115561;5522;1.7;0.0
FR;0;2021-01-24;9509;52;1125070;5574;1.7;0.0
FR;0;2021-01-25;77564;1419;1202634;6993;1.8;0.0
FR;0;2021-01-26;99702;3405;1302336;10398;1.9;0.0
FR;0;2021-01-27;106559;6008;1408895;16406;2.1;0.0
FR;0;2021-01-28;123539;14832;1532434;31238;2.3;0.0
FR;0;2021-01-29;91515;17621;1623949;48859;2.4;0.1
FR;0;2021-01-30;28875;4269;1652824;53128;2.5;0.1
FR;0;2021-01-31;5023;1682;1657847;54810;2.5;0.1
FR;0;2021-02-01;52091;21154;1709938;75964;2.5;0.1
FR;0;2021-02-02;71392;34717;1781330;110681;2.7;0.2
FR;0;2021-02-03;71592;37077;1852922;147758;2.8;0.2
FR;0;2021-02-04;81251;50250;1934173;198008;2.9;0.3
FR;0;2021-02-05;67624;45419;2001797;243427;3.0;0.4
FR;0;2021-02-06;21848;10423;2023645;253850;3.0;0.4
FR;0;2021-02-07;4956;5106;2028601;258956;3.0;0.4
FR;0;2021-02-08;46254;46115;2074855;305071;3.1;0.5
FR;0;2021-02-09;65382;72872;2140237;377943;3.2;0.6
FR;0;2021-02-10;70000;77217;2210237;455160;3.3;0.7
FR;0;2021-02-11;86412;100062;2296649;555222;3.4;0.8
FR;0;2021-02-12;78397;75212;2375046;630434;3.5;0.9
FR;0;2021-02-13;21906;19627;2396952;650061;3.6;1.0
FR;0;2021-02-14;4738;7224;2401690;657285;3.6;1.0
FR;0;2021-02-15;37428;76697;2439118;733982;3.6;1.1
FR;0;2021-02-16;49639;101075;2488757;835057;3.7;1.2
FR;0;2021-02-17;49755;103208;2538512;938265;3.8;1.4
FR;0;2021-02-18;68834;119208;2607346;1057473;3.9;1.6
FR;0;2021-02-19;64382;91485;2671728;1148958;4.0;1.7
FR;0;2021-02-20;18216;28495;2689944;1177453;4.0;1.8
FR;0;2021-02-21;3033;6402;2692977;1183855;4.0;1.8
FR;0;2021-02-22;36879;73212;2729856;1257067;4.1;1.9
FR;0;2021-02-23;53076;84608;2782932;1341675;4.1;2.0
FR;0;2021-02-24;59010;81724;2841942;1423399;4.2;2.1
FR;0;2021-02-25;99642;93123;2941584;1516522;4.4;2.3
FR;0;2021-02-26;112579;73185;3054163;1589707;4.6;2.4
FR;0;2021-02-27;51595;22921;3105758;1612628;4.6;2.4
FR;0;2021-02-28;5870;4545;3111628;1617173;4.6;2.4
FR;0;2021-03-01;64442;53899;3176070;1671072;4.7;2.5
FR;0;2021-03-02;100254;68322;3276324;1739394;4.9;2.6
FR;0;2021-03-03;114984;67985;3391308;1807379;5.1;2.7
FR;0;2021-03-04;162221;73091;3553529;1880470;5.3;2.8
FR;0;2021-03-05;199477;68805;3753006;1949275;5.6;2.9
FR;0;2021-03-06;206878;22332;3959884;1971607;5.9;2.9
FR;0;2021-03-07;120612;8297;4080496;1979904;6.1;3.0
FR;0;2021-03-08;105963;53325;4186459;2033229;6.2;3.0
FR;0;2021-03-09;171199;60981;4357658;2094210;6.5;3.1
FR;0;2021-03-10;177293;61585;4534951;2155795;6.8;3.2
FR;0;2021-03-11;241259;69685;4776210;2225480;7.1;3.3
FR;0;2021-03-12;293263;61492;5069473;2286972;7.6;3.4
FR;0;2021-03-13;230167;20464;5299640;2307436;7.9;3.4
FR;0;2021-03-14;62771;5203;5362411;2312639;8.0;3.4
FR;0;2021-03-15;157241;36470;5519652;2349109;8.2;3.5
FR;0;2021-03-16;140434;42770;5660086;2391879;8.4;3.6
FR;0;2021-03-17;149334;42557;5809420;2434436;8.7;3.6
FR;0;2021-03-18;166466;49092;5975886;2483528;8.9;3.7
FR;0;2021-03-19;228638;43642;6204524;2527170;9.2;3.8
FR;0;2021-03-20;165761;15880;6370285;2543050;9.5;3.8
FR;0;2021-03-21;49282;4186;6419567;2547236;9.6;3.8
FR;0;2021-03-22;168655;38944;6588222;2586180;9.8;3.9
FR;0;2021-03-23;248778;49050;6837000;2635230;10.2;3.9
FR;0;2021-03-24;255332;50575;7092332;2685805;10.6;4.0
FR;0;2021-03-25;340229;54334;7432561;2740139;11.1;4.1
FR;0;2021-03-26;357337;52311;7789898;2792450;11.6;4.2
FR;0;2021-03-27;194355;22489;7984253;2814939;11.9;4.2
FR;0;2021-03-28;58840;5585;8043093;2820524;12.0;4.2
FR;0;2021-03-29;201870;60074;8244963;2880598;12.3;4.3
FR;0;2021-03-30;283913;78672;8528876;2959270;12.7;4.4
FR;0;2021-03-31;261492;82094;8790368;3041364;13.1;4.5
FR;0;2021-04-01;312798;99649;9103166;3141013;13.6;4.7
FR;0;2021-04-02;279825;102432;9382991;3243445;14.0;4.8
FR;0;2021-04-03;140081;66349;9523072;3309794;14.2;4.9
FR;0;2021-04-04;45310;20450;9568382;3330244;14.3;5.0
FR;0;2021-04-05;59526;13357;9627908;3343601;14.3;5.0
FR;0;2021-04-06;215352;115269;9843260;3458870;14.7;5.2
FR;0;2021-04-07;258177;125204;10101437;3584074;15.1;5.3
FR;0;2021-04-08;335442;135116;10436879;3719190;15.6;5.5
FR;0;2021-04-09;407977;132035;10844856;3851225;16.2;5.7
FR;0;2021-04-10;211467;90194;11056323;3941419;16.5;5.9
FR;0;2021-04-11;55423;36823;11111746;3978242;16.6;5.9
FR;0;2021-04-12;235430;123497;11347176;4101739;16.9;6.1
FR;0;2021-04-13;307506;156343;11654682;4258082;17.4;6.3
FR;0;2021-04-14;292010;151279;11946692;4409361;17.8;6.6
FR;0;2021-04-15;334281;161769;12280973;4571130;18.3;6.8
FR;0;2021-04-16;337574;159036;12618547;4730166;18.8;7.0
FR;0;2021-04-17;187631;97188;12806178;4827354;19.1;7.2
FR;0;2021-04-18;50922;37617;12857100;4864971;19.2;7.2
FR;0;2021-04-19;204022;146628;13061122;5011599;19.5;7.5
FR;0;2021-04-20;252321;181357;13313443;5192956;19.8;7.7
FR;0;2021-04-21;251203;179850;13564646;5372806;20.2;8.0
FR;0;2021-04-22;285504;201819;13850150;5574625;20.6;8.3
FR;0;2021-04-23;294615;199749;14144765;5774374;21.1;8.6
FR;0;2021-04-24;189242;121367;14334007;5895741;21.4;8.8
FR;0;2021-04-25;68842;42346;14402849;5938087;21.5;8.8
FR;0;2021-04-26;219397;168565;14622246;6106652;21.8;9.1
FR;0;2021-04-27;282687;209955;14904933;6316607;22.2;9.4
FR;0;2021-04-28;297643;207816;15202576;6524423;22.7;9.7
FR;0;2021-04-29;354956;230499;15557532;6754922;23.2;10.1
FR;0;2021-04-30;370156;223466;15927688;6978388;23.7;10.4
FR;0;2021-05-01;165057;63321;16092745;7041709;24.0;10.5
FR;0;2021-05-02;90707;43257;16183452;7084966;24.1;10.6
FR;0;2021-05-03;285804;189383;16469256;7274349;24.5;10.8
FR;0;2021-05-04;312647;249816;16781903;7524165;25.0;11.2
FR;0;2021-05-05;323014;248909;17104917;7773074;25.5;11.6
FR;0;2021-05-06;375902;272894;17480819;8045968;26.0;12.0
FR;0;2021-05-07;369902;297623;17850721;8343591;26.6;12.4
FR;0;2021-05-08;220526;81627;18071247;8425218;26.9;12.6
FR;0;2021-05-09;128818;55162;18200065;8480380;27.1;12.6
FR;0;2021-05-10;308857;254155;18508922;8734535;27.6;13.0
FR;0;2021-05-11;400715;296089;18909637;9030624;28.2;13.5
FR;0;2021-05-12;430230;268986;19339867;9299610;28.8;13.9
FR;0;2021-05-13;335573;78064;19675440;9377674;29.3;14.0
FR;0;2021-05-14;450516;202733;20125956;9580407;30.0;14.3
FR;0;2021-05-15;371532;120068;20497488;9700475;30.5;14.5
FR;0;2021-05-16;201374;34067;20698862;9734542;30.8;14.5
FR;0;2021-05-17;373164;178883;21072026;9913425;31.4;14.8
FR;0;2021-05-18;455927;192319;21527953;10105744;32.1;15.1
FR;0;2021-05-19;464077;182855;21992030;10288599;32.8;15.3
FR;0;2021-05-20;503553;204380;22495583;10492979;33.5;15.6
FR;0;2021-05-21;486246;221056;22981829;10714035;34.2;16.0
FR;0;2021-05-22;345164;108061;23326993;10822096;34.8;16.1
FR;0;2021-05-23;160665;26824;23487658;10848920;35.0;16.2
FR;0;2021-05-24;261291;52946;23748949;10901866;35.4;16.2
FR;0;2021-05-25;396993;225938;24145942;11127804;36.0;16.6
FR;0;2021-05-26;410352;226248;24556294;11354052;36.6;16.9
FR;0;2021-05-27;446663;265858;25002957;11619910;37.3;17.3
FR;0;2021-05-28;426716;317510;25429673;11937420;37.9;17.8
FR;0;2021-05-29;297429;181949;25727102;12119369;38.3;18.1
FR;0;2021-05-30;106098;42035;25833200;12161404;38.5;18.1
FR;0;2021-05-31;355541;241595;26188741;12402999;39.0;18.5
FR;0;2021-06-01;422037;302736;26610778;12705735;39.6;18.9
FR;0;2021-06-02;412203;277885;27022981;12983620;40.3;19.3
FR;0;2021-06-03;458046;312789;27481027;13296409;40.9;19.8
FR;0;2021-06-04;451204;361487;27932231;13657896;41.6;20.3
FR;0;2021-06-05;302169;221711;28234400;13879607;42.1;20.7
FR;0;2021-06-06;131305;60985;28365705;13940592;42.3;20.8
FR;0;2021-06-07;334292;299037;28699997;14239629;42.8;21.2
FR;0;2021-06-08;389605;337455;29089602;14577084;43.3;21.7
FR;0;2021-06-09;380185;319853;29469787;14896937;43.9;22.2
FR;0;2021-06-10;397921;338300;29867708;15235237;44.5;22.7
FR;0;2021-06-11;383505;407130;30251213;15642367;45.1;23.3
FR;0;2021-06-12;281100;242979;30532313;15885346;45.5;23.7
FR;0;2021-06-13;103726;84844;30636039;15970190;45.6;23.8
FR;0;2021-06-14;237828;384649;30873867;16354839;46.0;24.4
FR;0;2021-06-15;304320;424136;31178187;16778975;46.5;25.0
FR;0;2021-06-16;310341;395017;31488528;17173992;46.9;25.6
FR;0;2021-06-17;314113;412757;31802641;17586749;47.4;26.2
FR;0;2021-06-18;318954;485383;32121595;18072132;47.9;26.9
FR;0;2021-06-19;222933;300633;32344528;18372765;48.2;27.4
FR;0;2021-06-20;72269;111454;32416797;18484219;48.3;27.5
FR;0;2021-06-21;193005;427457;32609802;18911676;48.6;28.2
FR;0;2021-06-22;220413;499400;32830215;19411076;48.9;28.9
FR;0;2021-06-23;231027;473626;33061242;19884702;49.3;29.6
FR;0;2021-06-24;239071;446389;33300313;20331091;49.6;30.3
FR;0;2021-06-25;224301;560859;33524614;20891950;50.0;31.1
FR;0;2021-06-26;151765;395183;33676379;21287133;50.2;31.7
FR;0;2021-06-27;55045;165028;33731424;21452161;50.3;32.0
FR;0;2021-06-28;152522;478422;33883946;21930583;50.5;32.7
FR;0;2021-06-29;180593;537447;34064539;22468030;50.8;33.5
FR;0;2021-06-30;201449;515837;34265988;22983867;51.1;34.2
FR;0;2021-07-01;221316;498062;34487304;23481929;51.4;35.0
FR;0;2021-07-02;221311;563308;34708615;24045237;51.7;35.8
FR;0;2021-07-03;139879;395433;34848494;24440670;51.9;36.4
FR;0;2021-07-04;55743;150944;34904237;24591614;52.0;36.6
FR;0;2021-07-05;163418;449876;35067655;25041490;52.3;37.3
FR;0;2021-07-06;192376;512099;35260031;25553589;52.5;38.1
FR;0;2021-07-07;207275;478061;35467306;26031650;52.8;38.8
FR;0;2021-07-08;227314;468464;35694620;26500114;53.2;39.5
FR;0;2021-07-09;224508;556583;35919128;27056697;53.5;40.3
FR;0;2021-07-10;146535;368694;36065663;27425391;53.7;40.9
FR;0;2021-07-11;59203;120960;36124866;27546351;53.8;41.0
FR;0;2021-07-12;165148;513386;36290014;28059737;54.1;41.8
FR;0;2021-07-13;283274;587049;36573288;28646786;54.5;42.7
FR;0;2021-07-14;177885;186758;36751173;28833544;54.8;43.0
FR;0;2021-07-15;342278;572553;37093451;29406097;55.3;43.8
FR;0;2021-07-16;374757;575295;37468208;29981392;55.8;44.7
FR;0;2021-07-17;256904;368702;37725112;30350094;56.2;45.2
FR;0;2021-07-18;108728;133304;37833840;30483398;56.4;45.4
FR;0;2021-07-19;281426;480342;38115266;30963740;56.8;46.1
FR;0;2021-07-20;372628;525080;38487894;31488820;57.3;46.9
FR;0;2021-07-21;391561;482730;38879455;31971550;57.9;47.6
FR;0;2021-07-22;436654;472288;39316109;32443838;58.6;48.3
FR;0;2021-07-23;434139;510308;39750248;32954146;59.2;49.1
FR;0;2021-07-24;283119;322090;40033367;33276236;59.6;49.6
FR;0;2021-07-25;119861;100140;40153228;33376376;59.8;49.7
FR;0;2021-07-26;343548;385964;40496776;33762340;60.3;50.3
FR;0;2021-07-27;458383;400956;40955159;34163296;61.0;50.9
FR;0;2021-07-28;452218;366919;41407377;34530215;61.7;51.4
FR;0;2021-07-29;484325;356661;41891702;34886876;62.4;52.0
FR;0;2021-07-30;453885;380376;42345587;35267252;63.1;52.5
FR;0;2021-07-31;282502;230794;42628089;35498046;63.5;52.9
FR;0;2021-08-01;107933;65342;42736022;35563388;63.7;53.0
FR;0;2021-08-02;320321;283759;43056343;35847147;64.2;53.4
FR;0;2021-08-03;386018;304089;43442361;36151236;64.7;53.9
FR;0;2021-08-04;373270;264824;43815631;36416060;65.3;54.3
FR;0;2021-08-05;356808;280730;44172439;36696790;65.8;54.7
FR;0;2021-08-06;350091;326463;44522530;37023253;66.3;55.2
FR;0;2021-08-07;208404;209323;44730934;37232576;66.6;55.5
FR;0;2021-08-08;71147;73021;44802081;37305597;66.8;55.6
FR;0;2021-08-09;250386;297841;45052467;37603438;67.1;56.0
FR;0;2021-08-10;297948;323993;45350415;37927431;67.6;56.5
FR;0;2021-08-11;272103;301964;45622518;38229395;68.0;57.0
FR;0;2021-08-12;263965;319673;45886483;38549068;68.4;57.4
FR;0;2021-08-13;243429;313062;46129912;38862130;68.7;57.9
FR;0;2021-08-14;139927;219368;46269839;39081498;68.9;58.2
FR;0;2021-08-15;36427;55279;46306266;39136777;69.0;58.3
FR;0;2021-08-16;178107;345950;46484373;39482727;69.3;58.8
FR;0;2021-08-17;209614;369357;46693987;39852084;69.6;59.4
FR;0;2021-08-18;193369;354285;46887356;40206369;69.9;59.9
FR;0;2021-08-19;186437;355309;47073793;40561678;70.1;60.4
FR;0;2021-08-20;178848;394544;47252641;40956222;70.4;61.0
FR;0;2021-08-21;101646;253588;47354287;41209810;70.6;61.4
FR;0;2021-08-22;30775;91849;47385062;41301659;70.6;61.5
FR;0;2021-08-23;134796;378564;47519858;41680223;70.8;62.1
