reg;jour;n_dose1;n_complet;n_cum_dose1;n_cum_complet;couv_dose1;couv_complet
01;2020-12-27;0;0;0;0;0.0;0.0
01;2020-12-28;0;0;0;0;0.0;0.0
01;2020-12-29;0;0;0;0;0.0;0.0
01;2020-12-30;0;0;0;0;0.0;0.0
01;2020-12-31;0;0;0;0;0.0;0.0
01;2021-01-01;1;0;1;0;0.0;0.0
01;2021-01-02;0;0;1;0;0.0;0.0
01;2021-01-03;0;0;1;0;0.0;0.0
01;2021-01-04;1;0;2;0;0.0;0.0
01;2021-01-05;0;0;2;0;0.0;0.0
01;2021-01-06;1;0;3;0;0.0;0.0
01;2021-01-07;0;0;3;0;0.0;0.0
01;2021-01-08;48;0;51;0;0.0;0.0
01;2021-01-09;18;0;69;0;0.0;0.0
01;2021-01-10;0;0;69;0;0.0;0.0
01;2021-01-11;54;0;123;0;0.0;0.0
01;2021-01-12;40;0;163;0;0.0;0.0
01;2021-01-13;45;0;208;0;0.1;0.0
01;2021-01-14;60;0;268;0;0.1;0.0
01;2021-01-15;76;0;344;0;0.1;0.0
01;2021-01-16;0;0;344;0;0.1;0.0
01;2021-01-17;0;0;344;0;0.1;0.0
01;2021-01-18;75;0;419;0;0.1;0.0
01;2021-01-19;137;0;556;0;0.1;0.0
01;2021-01-20;134;0;690;0;0.2;0.0
01;2021-01-21;146;1;836;1;0.2;0.0
01;2021-01-22;131;0;967;1;0.3;0.0
01;2021-01-23;1;0;968;1;0.3;0.0
01;2021-01-24;0;0;968;1;0.3;0.0
01;2021-01-25;203;0;1171;1;0.3;0.0
01;2021-01-26;208;1;1379;2;0.4;0.0
01;2021-01-27;233;0;1612;2;0.4;0.0
01;2021-01-28;228;3;1840;5;0.5;0.0
01;2021-01-29;197;1;2037;6;0.5;0.0
01;2021-01-30;16;0;2053;6;0.5;0.0
01;2021-01-31;1;0;2054;6;0.5;0.0
01;2021-02-01;220;4;2274;10;0.6;0.0
01;2021-02-02;240;26;2514;36;0.7;0.0
01;2021-02-03;210;2;2724;38;0.7;0.0
01;2021-02-04;299;20;3023;58;0.8;0.0
01;2021-02-05;245;32;3268;90;0.9;0.0
01;2021-02-06;47;1;3315;91;0.9;0.0
01;2021-02-07;0;0;3315;91;0.9;0.0
01;2021-02-08;217;23;3532;114;0.9;0.0
01;2021-02-09;284;29;3816;143;1.0;0.0
01;2021-02-10;215;29;4031;172;1.1;0.0
01;2021-02-11;291;109;4322;281;1.1;0.1
01;2021-02-12;284;25;4606;306;1.2;0.1
01;2021-02-13;49;7;4655;313;1.2;0.1
01;2021-02-14;19;36;4674;349;1.2;0.1
01;2021-02-15;69;46;4743;395;1.3;0.1
01;2021-02-16;16;1;4759;396;1.3;0.1
01;2021-02-17;17;1;4776;397;1.3;0.1
01;2021-02-18;212;18;4988;415;1.3;0.1
01;2021-02-19;225;20;5213;435;1.4;0.1
01;2021-02-20;47;0;5260;435;1.4;0.1
01;2021-02-21;1;0;5261;435;1.4;0.1
01;2021-02-22;150;63;5411;498;1.4;0.1
01;2021-02-23;188;73;5599;571;1.5;0.2
01;2021-02-24;304;126;5903;697;1.6;0.2
01;2021-02-25;366;79;6269;776;1.7;0.2
01;2021-02-26;182;84;6451;860;1.7;0.2
01;2021-02-27;63;0;6514;860;1.7;0.2
01;2021-02-28;1;0;6515;860;1.7;0.2
01;2021-03-01;132;81;6647;941;1.8;0.2
01;2021-03-02;235;131;6882;1072;1.8;0.3
01;2021-03-03;206;119;7088;1191;1.9;0.3
01;2021-03-04;296;84;7384;1275;2.0;0.3
01;2021-03-05;319;143;7703;1418;2.0;0.4
01;2021-03-06;583;3;8286;1421;2.2;0.4
01;2021-03-07;1;0;8287;1421;2.2;0.4
01;2021-03-08;274;138;8561;1559;2.3;0.4
01;2021-03-09;351;150;8912;1709;2.4;0.5
01;2021-03-10;358;163;9270;1872;2.5;0.5
01;2021-03-11;119;45;9389;1917;2.5;0.5
01;2021-03-12;372;212;9761;2129;2.6;0.6
01;2021-03-13;130;2;9891;2131;2.6;0.6
01;2021-03-14;13;24;9904;2155;2.6;0.6
01;2021-03-15;403;44;10307;2199;2.7;0.6
01;2021-03-16;447;78;10754;2277;2.9;0.6
01;2021-03-17;413;83;11167;2360;3.0;0.6
01;2021-03-18;537;111;11704;2471;3.1;0.7
01;2021-03-19;517;99;12221;2570;3.2;0.7
01;2021-03-20;173;44;12394;2614;3.3;0.7
01;2021-03-21;8;0;12402;2614;3.3;0.7
01;2021-03-22;332;87;12734;2701;3.4;0.7
01;2021-03-23;481;156;13215;2857;3.5;0.8
01;2021-03-24;453;108;13668;2965;3.6;0.8
01;2021-03-25;726;178;14394;3143;3.8;0.8
01;2021-03-26;633;120;15027;3263;4.0;0.9
01;2021-03-27;264;48;15291;3311;4.1;0.9
01;2021-03-28;7;0;15298;3311;4.1;0.9
01;2021-03-29;358;82;15656;3393;4.2;0.9
01;2021-03-30;595;162;16251;3555;4.3;0.9
01;2021-03-31;514;129;16765;3684;4.4;1.0
01;2021-04-01;618;199;17383;3883;4.6;1.0
01;2021-04-02;38;35;17421;3918;4.6;1.0
01;2021-04-03;42;2;17463;3920;4.6;1.0
01;2021-04-04;4;18;17467;3938;4.6;1.0
01;2021-04-05;4;0;17471;3938;4.6;1.0
01;2021-04-06;425;189;17896;4127;4.7;1.1
01;2021-04-07;566;115;18462;4242;4.9;1.1
01;2021-04-08;481;159;18943;4401;5.0;1.2
01;2021-04-09;466;209;19409;4610;5.1;1.2
01;2021-04-10;97;4;19506;4614;5.2;1.2
01;2021-04-11;2;25;19508;4639;5.2;1.2
01;2021-04-12;281;257;19789;4896;5.3;1.3
01;2021-04-13;544;318;20333;5214;5.4;1.4
01;2021-04-14;416;221;20749;5435;5.5;1.4
01;2021-04-15;544;316;21293;5751;5.6;1.5
01;2021-04-16;545;266;21838;6017;5.8;1.6
01;2021-04-17;186;2;22024;6019;5.8;1.6
01;2021-04-18;4;14;22028;6033;5.8;1.6
01;2021-04-19;385;238;22413;6271;5.9;1.7
01;2021-04-20;709;343;23122;6614;6.1;1.8
01;2021-04-21;608;311;23730;6925;6.3;1.8
01;2021-04-22;797;330;24527;7255;6.5;1.9
01;2021-04-23;836;248;25363;7503;6.7;2.0
01;2021-04-24;336;75;25699;7578;6.8;2.0
01;2021-04-25;594;64;26293;7642;7.0;2.0
01;2021-04-26;935;212;27228;7854;7.2;2.1
01;2021-04-27;628;228;27856;8082;7.4;2.1
01;2021-04-28;831;264;28687;8346;7.6;2.2
01;2021-04-29;1192;190;29879;8536;7.9;2.3
01;2021-04-30;1257;170;31136;8706;8.3;2.3
01;2021-05-01;593;38;31729;8744;8.4;2.3
01;2021-05-02;342;17;32071;8761;8.5;2.3
01;2021-05-03;916;171;32987;8932;8.8;2.4
01;2021-05-04;944;196;33931;9128;9.0;2.4
01;2021-05-05;964;242;34895;9370;9.3;2.5
01;2021-05-06;1109;166;36004;9536;9.6;2.5
01;2021-05-07;1214;257;37218;9793;9.9;2.6
01;2021-05-08;314;33;37532;9826;10.0;2.6
01;2021-05-09;178;9;37710;9835;10.0;2.6
01;2021-05-10;829;209;38539;10044;10.2;2.7
01;2021-05-11;929;309;39468;10353;10.5;2.7
01;2021-05-12;891;321;40359;10674;10.7;2.8
01;2021-05-13;210;80;40569;10754;10.8;2.9
01;2021-05-14;856;270;41425;11024;11.0;2.9
01;2021-05-15;449;14;41874;11038;11.1;2.9
01;2021-05-16;182;35;42056;11073;11.2;2.9
01;2021-05-17;694;268;42750;11341;11.3;3.0
01;2021-05-18;689;388;43439;11729;11.5;3.1
01;2021-05-19;675;520;44114;12249;11.7;3.3
01;2021-05-20;755;365;44869;12614;11.9;3.3
01;2021-05-21;791;400;45660;13014;12.1;3.5
01;2021-05-22;475;217;46135;13231;12.2;3.5
01;2021-05-23;199;115;46334;13346;12.3;3.5
01;2021-05-24;197;176;46531;13522;12.3;3.6
01;2021-05-25;518;664;47049;14186;12.5;3.8
01;2021-05-26;556;493;47605;14679;12.6;3.9
01;2021-05-27;127;185;47732;14864;12.7;3.9
01;2021-05-28;506;524;48238;15388;12.8;4.1
01;2021-05-29;221;138;48459;15526;12.9;4.1
01;2021-05-30;72;111;48531;15637;12.9;4.1
01;2021-05-31;410;536;48941;16173;13.0;4.3
01;2021-06-01;517;715;49458;16888;13.1;4.5
01;2021-06-02;528;709;49986;17597;13.3;4.7
01;2021-06-03;474;561;50460;18158;13.4;4.8
01;2021-06-04;664;799;51124;18957;13.6;5.0
01;2021-06-05;264;641;51388;19598;13.6;5.2
01;2021-06-06;122;530;51510;20128;13.7;5.3
01;2021-06-07;319;783;51829;20911;13.8;5.5
01;2021-06-08;442;888;52271;21799;13.9;5.8
01;2021-06-09;389;858;52660;22657;14.0;6.0
01;2021-06-10;464;850;53124;23507;14.1;6.2
01;2021-06-11;443;1230;53567;24737;14.2;6.6
01;2021-06-12;289;660;53856;25397;14.3;6.7
01;2021-06-13;129;314;53985;25711;14.3;6.8
01;2021-06-14;350;3808;54335;29519;14.4;7.8
01;2021-06-15;446;2011;54781;31530;14.5;8.4
01;2021-06-16;445;1490;55226;33020;14.7;8.8
01;2021-06-17;413;1012;55639;34032;14.8;9.0
01;2021-06-18;451;1016;56090;35048;14.9;9.3
01;2021-06-19;294;507;56384;35555;15.0;9.4
01;2021-06-20;108;232;56492;35787;15.0;9.5
01;2021-06-21;312;682;56804;36469;15.1;9.7
01;2021-06-22;313;867;57117;37336;15.2;9.9
01;2021-06-23;343;891;57460;38227;15.2;10.1
01;2021-06-24;378;730;57838;38957;15.3;10.3
01;2021-06-25;401;763;58239;39720;15.5;10.5
01;2021-06-26;288;513;58527;40233;15.5;10.7
01;2021-06-27;106;169;58633;40402;15.6;10.7
02;2020-12-27;0;0;0;0;0.0;0.0
02;2020-12-28;0;0;0;0;0.0;0.0
02;2020-12-29;0;0;0;0;0.0;0.0
02;2020-12-30;0;0;0;0;0.0;0.0
02;2020-12-31;0;0;0;0;0.0;0.0
02;2021-01-01;0;0;0;0;0.0;0.0
02;2021-01-02;0;0;0;0;0.0;0.0
02;2021-01-03;0;0;0;0;0.0;0.0
02;2021-01-04;0;0;0;0;0.0;0.0
02;2021-01-05;0;0;0;0;0.0;0.0
02;2021-01-06;5;0;5;0;0.0;0.0
02;2021-01-07;31;0;36;0;0.0;0.0
02;2021-01-08;80;1;116;1;0.0;0.0
02;2021-01-09;20;0;136;1;0.0;0.0
02;2021-01-10;0;0;136;1;0.0;0.0
02;2021-01-11;122;0;258;1;0.1;0.0
02;2021-01-12;78;0;336;1;0.1;0.0
02;2021-01-13;64;0;400;1;0.1;0.0
02;2021-01-14;88;1;488;2;0.1;0.0
02;2021-01-15;136;0;624;2;0.2;0.0
02;2021-01-16;51;0;675;2;0.2;0.0
02;2021-01-17;0;0;675;2;0.2;0.0
02;2021-01-18;157;0;832;2;0.2;0.0
02;2021-01-19;168;1;1000;3;0.3;0.0
02;2021-01-20;163;0;1163;3;0.3;0.0
02;2021-01-21;181;1;1344;4;0.4;0.0
02;2021-01-22;156;0;1500;4;0.4;0.0
02;2021-01-23;58;0;1558;4;0.4;0.0
02;2021-01-24;0;0;1558;4;0.4;0.0
02;2021-01-25;159;0;1717;4;0.5;0.0
02;2021-01-26;137;0;1854;4;0.5;0.0
02;2021-01-27;161;5;2015;9;0.6;0.0
02;2021-01-28;143;12;2158;21;0.6;0.0
02;2021-01-29;142;41;2300;62;0.6;0.0
02;2021-01-30;96;16;2396;78;0.7;0.0
02;2021-01-31;0;0;2396;78;0.7;0.0
02;2021-02-01;119;74;2515;152;0.7;0.0
02;2021-02-02;184;95;2699;247;0.8;0.1
02;2021-02-03;130;80;2829;327;0.8;0.1
02;2021-02-04;158;73;2987;400;0.8;0.1
02;2021-02-05;120;97;3107;497;0.9;0.1
02;2021-02-06;62;26;3169;523;0.9;0.1
02;2021-02-07;1;0;3170;523;0.9;0.1
02;2021-02-08;137;80;3307;603;0.9;0.2
02;2021-02-09;175;78;3482;681;1.0;0.2
02;2021-02-10;138;90;3620;771;1.0;0.2
02;2021-02-11;150;103;3770;874;1.1;0.2
02;2021-02-12;124;130;3894;1004;1.1;0.3
02;2021-02-13;38;37;3932;1041;1.1;0.3
02;2021-02-14;0;0;3932;1041;1.1;0.3
02;2021-02-15;51;67;3983;1108;1.1;0.3
02;2021-02-16;0;1;3983;1109;1.1;0.3
02;2021-02-17;1;3;3984;1112;1.1;0.3
02;2021-02-18;68;128;4052;1240;1.1;0.3
02;2021-02-19;69;131;4121;1371;1.1;0.4
02;2021-02-20;48;69;4169;1440;1.2;0.4
02;2021-02-21;0;0;4169;1440;1.2;0.4
02;2021-02-22;100;60;4269;1500;1.2;0.4
02;2021-02-23;113;238;4382;1738;1.2;0.5
02;2021-02-24;106;223;4488;1961;1.3;0.5
02;2021-02-25;89;151;4577;2112;1.3;0.6
02;2021-02-26;126;169;4703;2281;1.3;0.6
02;2021-02-27;69;52;4772;2333;1.3;0.7
02;2021-02-28;0;0;4772;2333;1.3;0.7
02;2021-03-01;138;144;4910;2477;1.4;0.7
02;2021-03-02;158;78;5068;2555;1.4;0.7
02;2021-03-03;178;145;5246;2700;1.5;0.8
02;2021-03-04;145;135;5391;2835;1.5;0.8
02;2021-03-05;238;129;5629;2964;1.6;0.8
02;2021-03-06;119;59;5748;3023;1.6;0.8
02;2021-03-07;100;1;5848;3024;1.6;0.8
02;2021-03-08;196;133;6044;3157;1.7;0.9
02;2021-03-09;269;102;6313;3259;1.8;0.9
02;2021-03-10;324;134;6637;3393;1.9;0.9
02;2021-03-11;331;83;6968;3476;1.9;1.0
02;2021-03-12;398;53;7366;3529;2.1;1.0
02;2021-03-13;155;21;7521;3550;2.1;1.0
02;2021-03-14;4;1;7525;3551;2.1;1.0
02;2021-03-15;276;92;7801;3643;2.2;1.0
02;2021-03-16;305;55;8106;3698;2.3;1.0
02;2021-03-17;387;49;8493;3747;2.4;1.0
02;2021-03-18;435;44;8928;3791;2.5;1.1
02;2021-03-19;396;62;9324;3853;2.6;1.1
02;2021-03-20;149;48;9473;3901;2.6;1.1
02;2021-03-21;25;1;9498;3902;2.6;1.1
02;2021-03-22;362;117;9860;4019;2.7;1.1
02;2021-03-23;401;123;10261;4142;2.9;1.2
02;2021-03-24;427;104;10688;4246;3.0;1.2
02;2021-03-25;470;99;11158;4345;3.1;1.2
02;2021-03-26;632;100;11790;4445;3.3;1.2
02;2021-03-27;152;71;11942;4516;3.3;1.3
02;2021-03-28;81;2;12023;4518;3.4;1.3
02;2021-03-29;421;165;12444;4683;3.5;1.3
02;2021-03-30;468;244;12912;4927;3.6;1.4
02;2021-03-31;1143;187;14055;5114;3.9;1.4
02;2021-04-01;951;170;15006;5284;4.2;1.5
02;2021-04-02;895;8;15901;5292;4.4;1.5
02;2021-04-03;788;50;16689;5342;4.7;1.5
02;2021-04-04;750;10;17439;5352;4.9;1.5
02;2021-04-05;828;40;18267;5392;5.1;1.5
02;2021-04-06;883;133;19150;5525;5.3;1.5
02;2021-04-07;1431;326;20581;5851;5.7;1.6
02;2021-04-08;1303;268;21884;6119;6.1;1.7
02;2021-04-09;1239;317;23123;6436;6.4;1.8
02;2021-04-10;837;164;23960;6600;6.7;1.8
02;2021-04-11;621;12;24581;6612;6.9;1.8
02;2021-04-12;868;314;25449;6926;7.1;1.9
02;2021-04-13;867;326;26316;7252;7.3;2.0
02;2021-04-14;957;324;27273;7576;7.6;2.1
02;2021-04-15;958;294;28231;7870;7.9;2.2
02;2021-04-16;991;298;29222;8168;8.1;2.3
02;2021-04-17;528;161;29750;8329;8.3;2.3
02;2021-04-18;339;56;30089;8385;8.4;2.3
02;2021-04-19;668;347;30757;8732;8.6;2.4
02;2021-04-20;868;310;31625;9042;8.8;2.5
02;2021-04-21;999;358;32624;9400;9.1;2.6
02;2021-04-22;602;313;33226;9713;9.3;2.7
02;2021-04-23;605;466;33831;10179;9.4;2.8
02;2021-04-24;360;197;34191;10376;9.5;2.9
02;2021-04-25;168;200;34359;10576;9.6;2.9
02;2021-04-26;515;543;34874;11119;9.7;3.1
02;2021-04-27;559;609;35433;11728;9.9;3.3
02;2021-04-28;449;693;35882;12421;10.0;3.5
02;2021-04-29;651;643;36533;13064;10.2;3.6
02;2021-04-30;770;688;37303;13752;10.4;3.8
02;2021-05-01;243;246;37546;13998;10.5;3.9
02;2021-05-02;226;513;37772;14511;10.5;4.0
02;2021-05-03;569;772;38341;15283;10.7;4.3
02;2021-05-04;524;677;38865;15960;10.8;4.4
02;2021-05-05;541;898;39406;16858;11.0;4.7
02;2021-05-06;546;783;39952;17641;11.1;4.9
02;2021-05-07;629;1016;40581;18657;11.3;5.2
02;2021-05-08;224;526;40805;19183;11.4;5.3
02;2021-05-09;174;506;40979;19689;11.4;5.5
02;2021-05-10;520;861;41499;20550;11.6;5.7
02;2021-05-11;477;875;41976;21425;11.7;6.0
02;2021-05-12;556;914;42532;22339;11.9;6.2
02;2021-05-13;271;534;42803;22873;11.9;6.4
02;2021-05-14;387;753;43190;23626;12.0;6.6
02;2021-05-15;233;582;43423;24208;12.1;6.7
02;2021-05-16;155;442;43578;24650;12.1;6.9
02;2021-05-17;472;756;44050;25406;12.3;7.1
02;2021-05-18;443;678;44493;26084;12.4;7.3
02;2021-05-19;440;742;44933;26826;12.5;7.5
02;2021-05-20;589;501;45522;27327;12.7;7.6
02;2021-05-21;545;705;46067;28032;12.8;7.8
02;2021-05-22;184;365;46251;28397;12.9;7.9
02;2021-05-23;110;181;46361;28578;12.9;8.0
02;2021-05-24;134;242;46495;28820;13.0;8.0
02;2021-05-25;348;706;46843;29526;13.1;8.2
02;2021-05-26;376;713;47219;30239;13.2;8.4
02;2021-05-27;262;648;47481;30887;13.2;8.6
02;2021-05-28;268;820;47749;31707;13.3;8.8
02;2021-05-29;148;512;47897;32219;13.4;9.0
02;2021-05-30;16;33;47913;32252;13.4;9.0
02;2021-05-31;342;686;48255;32938;13.5;9.2
02;2021-06-01;289;548;48544;33486;13.5;9.3
02;2021-06-02;315;574;48859;34060;13.6;9.5
02;2021-06-03;246;431;49105;34491;13.7;9.6
02;2021-06-04;348;651;49453;35142;13.8;9.8
02;2021-06-05;234;362;49687;35504;13.9;9.9
02;2021-06-06;21;31;49708;35535;13.9;9.9
02;2021-06-07;257;741;49965;36276;13.9;10.1
02;2021-06-08;249;591;50214;36867;14.0;10.3
02;2021-06-09;293;704;50507;37571;14.1;10.5
02;2021-06-10;299;454;50806;38025;14.2;10.6
02;2021-06-11;334;543;51140;38568;14.3;10.8
02;2021-06-12;243;323;51383;38891;14.3;10.8
02;2021-06-13;32;29;51415;38920;14.3;10.8
02;2021-06-14;363;553;51778;39473;14.4;11.0
02;2021-06-15;407;494;52185;39967;14.5;11.1
02;2021-06-16;411;444;52596;40411;14.7;11.3
02;2021-06-17;346;578;52942;40989;14.8;11.4
02;2021-06-18;420;542;53362;41531;14.9;11.6
02;2021-06-19;225;196;53587;41727;14.9;11.6
02;2021-06-20;25;17;53612;41744;14.9;11.6
02;2021-06-21;317;578;53929;42322;15.0;11.8
02;2021-06-22;288;464;54217;42786;15.1;11.9
02;2021-06-23;406;562;54623;43348;15.2;12.1
02;2021-06-24;304;432;54927;43780;15.3;12.2
02;2021-06-25;295;388;55222;44168;15.4;12.3
02;2021-06-26;195;199;55417;44367;15.4;12.4
02;2021-06-27;14;23;55431;44390;15.5;12.4
03;2020-12-27;0;0;0;0;0.0;0.0
03;2020-12-28;0;0;0;0;0.0;0.0
03;2020-12-29;0;0;0;0;0.0;0.0
03;2020-12-30;0;0;0;0;0.0;0.0
03;2020-12-31;0;0;0;0;0.0;0.0
03;2021-01-01;0;0;0;0;0.0;0.0
03;2021-01-02;2;2;2;2;0.0;0.0
03;2021-01-03;0;0;2;2;0.0;0.0
03;2021-01-04;0;0;2;2;0.0;0.0
03;2021-01-05;0;0;2;2;0.0;0.0
03;2021-01-06;0;0;2;2;0.0;0.0
03;2021-01-07;0;0;2;2;0.0;0.0
03;2021-01-08;0;0;2;2;0.0;0.0
03;2021-01-09;0;0;2;2;0.0;0.0
03;2021-01-10;0;0;2;2;0.0;0.0
03;2021-01-11;0;0;2;2;0.0;0.0
03;2021-01-12;0;0;2;2;0.0;0.0
03;2021-01-13;30;0;32;2;0.0;0.0
03;2021-01-14;46;0;78;2;0.0;0.0
03;2021-01-15;34;0;112;2;0.0;0.0
03;2021-01-16;18;0;130;2;0.0;0.0
03;2021-01-17;0;0;130;2;0.0;0.0
03;2021-01-18;63;0;193;2;0.1;0.0
03;2021-01-19;149;1;342;3;0.1;0.0
03;2021-01-20;132;0;474;3;0.2;0.0
03;2021-01-21;118;0;592;3;0.2;0.0
03;2021-01-22;76;0;668;3;0.2;0.0
03;2021-01-23;0;0;668;3;0.2;0.0
03;2021-01-24;0;0;668;3;0.2;0.0
03;2021-01-25;56;0;724;3;0.2;0.0
03;2021-01-26;100;0;824;3;0.3;0.0
03;2021-01-27;109;1;933;4;0.3;0.0
03;2021-01-28;96;2;1029;6;0.4;0.0
03;2021-01-29;104;3;1133;9;0.4;0.0
03;2021-01-30;0;0;1133;9;0.4;0.0
03;2021-01-31;0;0;1133;9;0.4;0.0
03;2021-02-01;54;0;1187;9;0.4;0.0
03;2021-02-02;122;4;1309;13;0.5;0.0
03;2021-02-03;116;7;1425;20;0.5;0.0
03;2021-02-04;79;26;1504;46;0.5;0.0
03;2021-02-05;65;8;1569;54;0.5;0.0
03;2021-02-06;0;0;1569;54;0.5;0.0
03;2021-02-07;0;0;1569;54;0.5;0.0
03;2021-02-08;51;13;1620;67;0.6;0.0
03;2021-02-09;92;39;1712;106;0.6;0.0
03;2021-02-10;101;42;1813;148;0.6;0.1
03;2021-02-11;104;93;1917;241;0.7;0.1
03;2021-02-12;87;65;2004;306;0.7;0.1
03;2021-02-13;0;0;2004;306;0.7;0.1
03;2021-02-14;0;0;2004;306;0.7;0.1
03;2021-02-15;27;65;2031;371;0.7;0.1
03;2021-02-16;123;53;2154;424;0.7;0.1
03;2021-02-17;145;119;2299;543;0.8;0.2
03;2021-02-18;102;143;2401;686;0.8;0.2
03;2021-02-19;121;72;2522;758;0.9;0.3
03;2021-02-20;0;0;2522;758;0.9;0.3
03;2021-02-21;0;0;2522;758;0.9;0.3
03;2021-02-22;78;49;2600;807;0.9;0.3
03;2021-02-23;158;100;2758;907;0.9;0.3
03;2021-02-24;190;120;2948;1027;1.0;0.4
03;2021-02-25;258;87;3206;1114;1.1;0.4
03;2021-02-26;264;69;3470;1183;1.2;0.4
03;2021-02-27;121;1;3591;1184;1.2;0.4
03;2021-02-28;0;0;3591;1184;1.2;0.4
03;2021-03-01;180;85;3771;1269;1.3;0.4
03;2021-03-02;255;108;4026;1377;1.4;0.5
03;2021-03-03;255;130;4281;1507;1.5;0.5
03;2021-03-04;281;81;4562;1588;1.6;0.5
03;2021-03-05;270;44;4832;1632;1.7;0.6
03;2021-03-06;116;1;4948;1633;1.7;0.6
03;2021-03-07;0;0;4948;1633;1.7;0.6
03;2021-03-08;187;41;5135;1674;1.8;0.6
03;2021-03-09;349;91;5484;1765;1.9;0.6
03;2021-03-10;357;100;5841;1865;2.0;0.6
03;2021-03-11;270;120;6111;1985;2.1;0.7
03;2021-03-12;286;92;6397;2077;2.2;0.7
03;2021-03-13;110;2;6507;2079;2.2;0.7
03;2021-03-14;0;0;6507;2079;2.2;0.7
03;2021-03-15;180;26;6687;2105;2.3;0.7
03;2021-03-16;241;139;6928;2244;2.4;0.8
03;2021-03-17;273;128;7201;2372;2.5;0.8
03;2021-03-18;250;153;7451;2525;2.6;0.9
03;2021-03-19;284;126;7735;2651;2.7;0.9
03;2021-03-20;255;14;7990;2665;2.7;0.9
03;2021-03-21;119;0;8109;2665;2.8;0.9
03;2021-03-22;219;112;8328;2777;2.9;1.0
03;2021-03-23;261;186;8589;2963;3.0;1.0
03;2021-03-24;225;209;8814;3172;3.0;1.1
03;2021-03-25;167;176;8981;3348;3.1;1.2
03;2021-03-26;189;307;9170;3655;3.2;1.3
03;2021-03-27;56;93;9226;3748;3.2;1.3
03;2021-03-28;0;0;9226;3748;3.2;1.3
03;2021-03-29;174;244;9400;3992;3.2;1.4
03;2021-03-30;446;235;9846;4227;3.4;1.5
03;2021-03-31;318;291;10164;4518;3.5;1.6
03;2021-04-01;445;261;10609;4779;3.6;1.6
03;2021-04-02;306;279;10915;5058;3.8;1.7
03;2021-04-03;151;122;11066;5180;3.8;1.8
03;2021-04-04;0;0;11066;5180;3.8;1.8
03;2021-04-05;118;14;11184;5194;3.8;1.8
03;2021-04-06;439;331;11623;5525;4.0;1.9
03;2021-04-07;501;341;12124;5866;4.2;2.0
03;2021-04-08;510;263;12634;6129;4.3;2.1
03;2021-04-09;493;225;13127;6354;4.5;2.2
03;2021-04-10;146;91;13273;6445;4.6;2.2
03;2021-04-11;2;0;13275;6445;4.6;2.2
03;2021-04-12;551;269;13826;6714;4.8;2.3
03;2021-04-13;671;240;14497;6954;5.0;2.4
03;2021-04-14;717;310;15214;7264;5.2;2.5
03;2021-04-15;766;243;15980;7507;5.5;2.6
03;2021-04-16;747;297;16727;7804;5.8;2.7
03;2021-04-17;485;128;17212;7932;5.9;2.7
03;2021-04-18;489;37;17701;7969;6.1;2.7
03;2021-04-19;682;248;18383;8217;6.3;2.8
03;2021-04-20;550;268;18933;8485;6.5;2.9
03;2021-04-21;794;238;19727;8723;6.8;3.0
03;2021-04-22;656;216;20383;8939;7.0;3.1
03;2021-04-23;663;220;21046;9159;7.2;3.2
03;2021-04-24;523;95;21569;9254;7.4;3.2
03;2021-04-25;602;42;22171;9296;7.6;3.2
03;2021-04-26;735;223;22906;9519;7.9;3.3
03;2021-04-27;766;338;23672;9857;8.1;3.4
03;2021-04-28;676;324;24348;10181;8.4;3.5
03;2021-04-29;615;277;24963;10458;8.6;3.6
03;2021-04-30;672;252;25635;10710;8.8;3.7
03;2021-05-01;209;26;25844;10736;8.9;3.7
03;2021-05-02;594;76;26438;10812;9.1;3.7
03;2021-05-03;554;390;26992;11202;9.3;3.9
03;2021-05-04;614;311;27606;11513;9.5;4.0
03;2021-05-05;647;445;28253;11958;9.7;4.1
03;2021-05-06;624;461;28877;12419;9.9;4.3
03;2021-05-07;539;462;29416;12881;10.1;4.4
03;2021-05-08;341;57;29757;12938;10.2;4.5
03;2021-05-09;262;73;30019;13011;10.3;4.5
03;2021-05-10;418;612;30437;13623;10.5;4.7
03;2021-05-11;375;491;30812;14114;10.6;4.9
03;2021-05-12;469;639;31281;14753;10.8;5.1
03;2021-05-13;332;98;31613;14851;10.9;5.1
03;2021-05-14;471;548;32084;15399;11.0;5.3
03;2021-05-15;253;345;32337;15744;11.1;5.4
03;2021-05-16;207;210;32544;15954;11.2;5.5
03;2021-05-17;443;600;32987;16554;11.3;5.7
03;2021-05-18;558;563;33545;17117;11.5;5.9
03;2021-05-19;510;547;34055;17664;11.7;6.1
03;2021-05-20;611;444;34666;18108;11.9;6.2
03;2021-05-21;483;601;35149;18709;12.1;6.4
03;2021-05-22;167;501;35316;19210;12.1;6.6
03;2021-05-23;267;473;35583;19683;12.2;6.8
03;2021-05-24;559;244;36142;19927;12.4;6.9
03;2021-05-25;496;740;36638;20667;12.6;7.1
03;2021-05-26;412;681;37050;21348;12.7;7.3
03;2021-05-27;662;515;37712;21863;13.0;7.5
03;2021-05-28;486;549;38198;22412;13.1;7.7
03;2021-05-29;235;361;38433;22773;13.2;7.8
03;2021-05-30;149;401;38582;23174;13.3;8.0
03;2021-05-31;337;573;38919;23747;13.4;8.2
03;2021-06-01;382;466;39301;24213;13.5;8.3
03;2021-06-02;501;549;39802;24762;13.7;8.5
03;2021-06-03;413;466;40215;25228;13.8;8.7
03;2021-06-04;519;489;40734;25717;14.0;8.8
03;2021-06-05;269;293;41003;26010;14.1;8.9
03;2021-06-06;208;299;41211;26309;14.2;9.1
03;2021-06-07;458;448;41669;26757;14.3;9.2
03;2021-06-08;508;312;42177;27069;14.5;9.3
03;2021-06-09;480;379;42657;27448;14.7;9.4
03;2021-06-10;345;290;43002;27738;14.8;9.5
03;2021-06-11;389;468;43391;28206;14.9;9.7
03;2021-06-12;162;285;43553;28491;15.0;9.8
03;2021-06-13;200;267;43753;28758;15.1;9.9
03;2021-06-14;350;547;44103;29305;15.2;10.1
03;2021-06-15;355;439;44458;29744;15.3;10.2
03;2021-06-16;389;450;44847;30194;15.4;10.4
03;2021-06-17;364;575;45211;30769;15.6;10.6
03;2021-06-18;336;561;45547;31330;15.7;10.8
03;2021-06-19;230;259;45777;31589;15.7;10.9
03;2021-06-20;123;272;45900;31861;15.8;11.0
03;2021-06-21;264;597;46164;32458;15.9;11.2
03;2021-06-22;307;456;46471;32914;16.0;11.3
03;2021-06-23;270;530;46741;33444;16.1;11.5
03;2021-06-24;342;494;47083;33938;16.2;11.7
03;2021-06-25;316;544;47399;34482;16.3;11.9
03;2021-06-26;164;321;47563;34803;16.4;12.0
03;2021-06-27;117;169;47680;34972;16.4;12.0
04;2020-12-27;0;0;0;0;0.0;0.0
04;2020-12-28;0;0;0;0;0.0;0.0
04;2020-12-29;0;0;0;0;0.0;0.0
04;2020-12-30;0;0;0;0;0.0;0.0
04;2020-12-31;0;0;0;0;0.0;0.0
04;2021-01-01;1;0;1;0;0.0;0.0
04;2021-01-02;0;0;1;0;0.0;0.0
04;2021-01-03;0;0;1;0;0.0;0.0
04;2021-01-04;0;0;1;0;0.0;0.0
04;2021-01-05;2;0;3;0;0.0;0.0
04;2021-01-06;0;0;3;0;0.0;0.0
04;2021-01-07;0;0;3;0;0.0;0.0
04;2021-01-08;0;0;3;0;0.0;0.0
04;2021-01-09;1;0;4;0;0.0;0.0
04;2021-01-10;0;0;4;0;0.0;0.0
04;2021-01-11;0;0;4;0;0.0;0.0
04;2021-01-12;0;0;4;0;0.0;0.0
04;2021-01-13;0;0;4;0;0.0;0.0
04;2021-01-14;0;0;4;0;0.0;0.0
04;2021-01-15;332;0;336;0;0.0;0.0
04;2021-01-16;27;0;363;0;0.0;0.0
04;2021-01-17;0;0;363;0;0.0;0.0
04;2021-01-18;49;1;412;1;0.0;0.0
04;2021-01-19;393;0;805;1;0.1;0.0
04;2021-01-20;482;1;1287;2;0.1;0.0
04;2021-01-21;614;1;1901;3;0.2;0.0
04;2021-01-22;409;1;2310;4;0.3;0.0
04;2021-01-23;75;0;2385;4;0.3;0.0
04;2021-01-24;0;0;2385;4;0.3;0.0
04;2021-01-25;272;0;2657;4;0.3;0.0
04;2021-01-26;429;0;3086;4;0.4;0.0
04;2021-01-27;317;0;3403;4;0.4;0.0
04;2021-01-28;406;0;3809;4;0.4;0.0
04;2021-01-29;421;3;4230;7;0.5;0.0
04;2021-01-30;419;0;4649;7;0.5;0.0
04;2021-01-31;0;0;4649;7;0.5;0.0
04;2021-02-01;372;3;5021;10;0.6;0.0
04;2021-02-02;498;4;5519;14;0.6;0.0
04;2021-02-03;602;14;6121;28;0.7;0.0
04;2021-02-04;626;22;6747;50;0.8;0.0
04;2021-02-05;564;98;7311;148;0.9;0.0
04;2021-02-06;501;4;7812;152;0.9;0.0
04;2021-02-07;0;8;7812;160;0.9;0.0
04;2021-02-08;472;34;8284;194;1.0;0.0
04;2021-02-09;783;90;9067;284;1.1;0.0
04;2021-02-10;820;85;9887;369;1.1;0.0
04;2021-02-11;796;86;10683;455;1.2;0.1
04;2021-02-12;637;95;11320;550;1.3;0.1
04;2021-02-13;651;74;11971;624;1.4;0.1
04;2021-02-14;1;0;11972;624;1.4;0.1
04;2021-02-15;524;126;12496;750;1.5;0.1
04;2021-02-16;650;535;13146;1285;1.5;0.1
04;2021-02-17;592;329;13738;1614;1.6;0.2
04;2021-02-18;493;414;14231;2028;1.7;0.2
04;2021-02-19;496;321;14727;2349;1.7;0.3
04;2021-02-20;576;117;15303;2466;1.8;0.3
04;2021-02-21;0;0;15303;2466;1.8;0.3
04;2021-02-22;401;238;15704;2704;1.8;0.3
04;2021-02-23;607;238;16311;2942;1.9;0.3
04;2021-02-24;583;255;16894;3197;2.0;0.4
04;2021-02-25;645;298;17539;3495;2.0;0.4
04;2021-02-26;483;473;18022;3968;2.1;0.5
04;2021-02-27;386;472;18408;4440;2.1;0.5
04;2021-02-28;0;0;18408;4440;2.1;0.5
04;2021-03-01;289;392;18697;4832;2.2;0.6
04;2021-03-02;487;504;19184;5336;2.2;0.6
04;2021-03-03;755;559;19939;5895;2.3;0.7
04;2021-03-04;775;543;20714;6438;2.4;0.7
04;2021-03-05;727;542;21441;6980;2.5;0.8
04;2021-03-06;812;530;22253;7510;2.6;0.9
04;2021-03-07;0;0;22253;7510;2.6;0.9
04;2021-03-08;436;591;22689;8101;2.6;0.9
04;2021-03-09;670;777;23359;8878;2.7;1.0
04;2021-03-10;644;849;24003;9727;2.8;1.1
04;2021-03-11;699;649;24702;10376;2.9;1.2
04;2021-03-12;729;666;25431;11042;3.0;1.3
04;2021-03-13;668;611;26099;11653;3.0;1.4
04;2021-03-14;2;0;26101;11653;3.0;1.4
04;2021-03-15;504;507;26605;12160;3.1;1.4
04;2021-03-16;680;711;27285;12871;3.2;1.5
04;2021-03-17;847;538;28132;13409;3.3;1.6
04;2021-03-18;1021;556;29153;13965;3.4;1.6
04;2021-03-19;784;543;29937;14508;3.5;1.7
04;2021-03-20;576;600;30513;15108;3.5;1.8
04;2021-03-21;0;0;30513;15108;3.5;1.8
04;2021-03-22;565;482;31078;15590;3.6;1.8
04;2021-03-23;780;640;31858;16230;3.7;1.9
04;2021-03-24;792;671;32650;16901;3.8;2.0
04;2021-03-25;929;555;33579;17456;3.9;2.0
04;2021-03-26;921;450;34500;17906;4.0;2.1
04;2021-03-27;782;340;35282;18246;4.1;2.1
04;2021-03-28;1;0;35283;18246;4.1;2.1
04;2021-03-29;960;272;36243;18518;4.2;2.2
04;2021-03-30;883;503;37126;19021;4.3;2.2
04;2021-03-31;740;674;37866;19695;4.4;2.3
04;2021-04-01;716;709;38582;20404;4.5;2.4
04;2021-04-02;688;761;39270;21165;4.6;2.5
04;2021-04-03;699;707;39969;21872;4.6;2.5
04;2021-04-04;0;0;39969;21872;4.6;2.5
04;2021-04-05;0;2;39969;21874;4.6;2.5
04;2021-04-06;796;642;40765;22516;4.7;2.6
04;2021-04-07;1369;789;42134;23305;4.9;2.7
04;2021-04-08;1792;780;43926;24085;5.1;2.8
04;2021-04-09;1506;786;45432;24871;5.3;2.9
04;2021-04-10;1137;651;46569;25522;5.4;3.0
04;2021-04-11;2;0;46571;25522;5.4;3.0
04;2021-04-12;1239;553;47810;26075;5.6;3.0
04;2021-04-13;1438;754;49248;26829;5.7;3.1
04;2021-04-14;2069;778;51317;27607;6.0;3.2
04;2021-04-15;2502;956;53819;28563;6.3;3.3
04;2021-04-16;1932;786;55751;29349;6.5;3.4
04;2021-04-17;1289;604;57040;29953;6.6;3.5
04;2021-04-18;0;0;57040;29953;6.6;3.5
04;2021-04-19;1377;565;58417;30518;6.8;3.5
04;2021-04-20;1649;807;60066;31325;7.0;3.6
04;2021-04-21;2128;607;62194;31932;7.2;3.7
04;2021-04-22;2946;805;65140;32737;7.6;3.8
04;2021-04-23;2309;815;67449;33552;7.8;3.9
04;2021-04-24;1102;797;68551;34349;8.0;4.0
04;2021-04-25;2;0;68553;34349;8.0;4.0
04;2021-04-26;1165;922;69718;35271;8.1;4.1
04;2021-04-27;1679;1027;71397;36298;8.3;4.2
04;2021-04-28;2896;753;74293;37051;8.6;4.3
04;2021-04-29;3944;813;78237;37864;9.1;4.4
04;2021-04-30;3433;906;81670;38770;9.5;4.5
04;2021-05-01;2106;220;83776;38990;9.7;4.5
04;2021-05-02;2;0;83778;38990;9.7;4.5
04;2021-05-03;1865;572;85643;39562;10.0;4.6
04;2021-05-04;2127;1096;87770;40658;10.2;4.7
04;2021-05-05;3118;1641;90888;42299;10.6;4.9
04;2021-05-06;4005;1589;94893;43888;11.0;5.1
04;2021-05-07;3229;1527;98122;45415;11.4;5.3
04;2021-05-08;1566;503;99688;45918;11.6;5.3
04;2021-05-09;1;0;99689;45918;11.6;5.3
04;2021-05-10;2412;994;102101;46912;11.9;5.5
04;2021-05-11;3649;1642;105750;48554;12.3;5.6
04;2021-05-12;4719;2397;110469;50951;12.8;5.9
04;2021-05-13;3554;585;114023;51536;13.3;6.0
04;2021-05-14;5264;2515;119287;54051;13.9;6.3
04;2021-05-15;3160;1538;122447;55589;14.2;6.5
04;2021-05-16;15;18;122462;55607;14.2;6.5
04;2021-05-17;2997;1480;125459;57087;14.6;6.6
04;2021-05-18;3749;1781;129208;58868;15.0;6.8
04;2021-05-19;4678;2335;133886;61203;15.6;7.1
04;2021-05-20;5140;2808;139026;64011;16.2;7.4
04;2021-05-21;4987;2639;144013;66650;16.7;7.8
04;2021-05-22;3365;1253;147378;67903;17.1;7.9
04;2021-05-23;5;3;147383;67906;17.1;7.9
04;2021-05-24;3636;1079;151019;68985;17.6;8.0
04;2021-05-25;4246;1915;155265;70900;18.1;8.2
04;2021-05-26;4973;2965;160238;73865;18.6;8.6
04;2021-05-27;4602;4094;164840;77959;19.2;9.1
04;2021-05-28;4369;3826;169209;81785;19.7;9.5
04;2021-05-29;2547;2462;171756;84247;20.0;9.8
04;2021-05-30;6;14;171762;84261;20.0;9.8
04;2021-05-31;2343;2251;174105;86512;20.2;10.1
04;2021-06-01;3274;2721;177379;89233;20.6;10.4
04;2021-06-02;3914;3353;181293;92586;21.1;10.8
04;2021-06-03;4013;3664;185306;96250;21.5;11.2
04;2021-06-04;3817;3752;189123;100002;22.0;11.6
04;2021-06-05;2192;1923;191315;101925;22.2;11.9
04;2021-06-06;1060;128;192375;102053;22.4;11.9
04;2021-06-07;1999;2530;194374;104583;22.6;12.2
04;2021-06-08;2513;3321;196887;107904;22.9;12.5
04;2021-06-09;2942;4771;199829;112675;23.2;13.1
04;2021-06-10;3342;4446;203171;117121;23.6;13.6
04;2021-06-11;2827;4619;205998;121740;24.0;14.2
04;2021-06-12;1710;3378;207708;125118;24.2;14.5
04;2021-06-13;1312;243;209020;125361;24.3;14.6
04;2021-06-14;1479;3179;210499;128540;24.5;14.9
04;2021-06-15;2035;3616;212534;132156;24.7;15.4
04;2021-06-16;2710;4646;215244;136802;25.0;15.9
04;2021-06-17;2496;4900;217740;141702;25.3;16.5
04;2021-06-18;2557;4899;220297;146601;25.6;17.0
04;2021-06-19;1292;3515;221589;150116;25.8;17.5
04;2021-06-20;626;287;222215;150403;25.8;17.5
04;2021-06-21;1250;3233;223465;153636;26.0;17.9
04;2021-06-22;1590;3743;225055;157379;26.2;18.3
04;2021-06-23;2215;4960;227270;162339;26.4;18.9
04;2021-06-24;2261;4062;229531;166401;26.7;19.3
04;2021-06-25;2131;4097;231662;170498;26.9;19.8
04;2021-06-26;1377;2701;233039;173199;27.1;20.1
04;2021-06-27;648;256;233687;173455;27.2;20.2
05;2020-12-27;0;0;0;0;0.0;0.0
05;2020-12-28;0;0;0;0;0.0;0.0
05;2020-12-29;0;0;0;0;0.0;0.0
05;2020-12-30;0;0;0;0;0.0;0.0
05;2020-12-31;0;0;0;0;0.0;0.0
05;2021-01-01;0;0;0;0;0.0;0.0
05;2021-01-02;0;0;0;0;0.0;0.0
05;2021-01-03;0;0;0;0;0.0;0.0
05;2021-01-04;0;0;0;0;0.0;0.0
05;2021-01-05;0;0;0;0;0.0;0.0
05;2021-01-06;0;0;0;0;0.0;0.0
05;2021-01-07;0;0;0;0;0.0;0.0
05;2021-01-08;0;0;0;0;0.0;0.0
05;2021-01-09;0;0;0;0;0.0;0.0
05;2021-01-10;0;0;0;0;0.0;0.0
05;2021-01-11;0;0;0;0;0.0;0.0
05;2021-01-12;0;0;0;0;0.0;0.0
05;2021-01-13;0;0;0;0;0.0;0.0
05;2021-01-14;0;0;0;0;0.0;0.0
05;2021-01-15;0;0;0;0;0.0;0.0
05;2021-01-16;0;0;0;0;0.0;0.0
05;2021-01-17;0;0;0;0;0.0;0.0
05;2021-01-18;0;0;0;0;0.0;0.0
05;2021-01-19;0;0;0;0;0.0;0.0
05;2021-01-20;0;0;0;0;0.0;0.0
05;2021-01-21;0;0;0;0;0.0;0.0
05;2021-01-22;0;0;0;0;0.0;0.0
05;2021-01-23;0;0;0;0;0.0;0.0
05;2021-01-24;0;0;0;0;0.0;0.0
05;2021-01-25;0;0;0;0;0.0;0.0
05;2021-01-26;0;0;0;0;0.0;0.0
05;2021-01-27;0;0;0;0;0.0;0.0
05;2021-01-28;0;0;0;0;0.0;0.0
05;2021-01-29;0;0;0;0;0.0;0.0
05;2021-01-30;0;0;0;0;0.0;0.0
05;2021-01-31;0;0;0;0;0.0;0.0
05;2021-02-01;0;0;0;0;0.0;0.0
05;2021-02-02;0;0;0;0;0.0;0.0
05;2021-02-03;0;0;0;0;0.0;0.0
05;2021-02-04;0;0;0;0;0.0;0.0
05;2021-02-05;0;0;0;0;0.0;0.0
05;2021-02-06;0;0;0;0;0.0;0.0
05;2021-02-07;0;0;0;0;0.0;0.0
05;2021-02-08;0;0;0;0;0.0;0.0
05;2021-02-09;0;0;0;0;0.0;0.0
05;2021-02-10;0;0;0;0;0.0;0.0
05;2021-02-11;0;0;0;0;0.0;0.0
05;2021-02-12;0;0;0;0;0.0;0.0
05;2021-02-13;0;0;0;0;0.0;0.0
05;2021-02-14;0;0;0;0;0.0;0.0
05;2021-02-15;0;0;0;0;0.0;0.0
05;2021-02-16;0;0;0;0;0.0;0.0
05;2021-02-17;0;0;0;0;0.0;0.0
05;2021-02-18;0;0;0;0;0.0;0.0
05;2021-02-19;0;0;0;0;0.0;0.0
05;2021-02-20;0;0;0;0;0.0;0.0
05;2021-02-21;0;0;0;0;0.0;0.0
05;2021-02-22;0;0;0;0;0.0;0.0
05;2021-02-23;0;0;0;0;0.0;0.0
05;2021-02-24;0;0;0;0;0.0;0.0
05;2021-02-25;0;0;0;0;0.0;0.0
05;2021-02-26;0;0;0;0;0.0;0.0
05;2021-02-27;0;0;0;0;0.0;0.0
05;2021-02-28;0;0;0;0;0.0;0.0
05;2021-03-01;0;0;0;0;0.0;0.0
05;2021-03-02;0;0;0;0;0.0;0.0
05;2021-03-03;0;0;0;0;0.0;0.0
05;2021-03-04;0;0;0;0;0.0;0.0
05;2021-03-05;0;0;0;0;0.0;0.0
05;2021-03-06;0;0;0;0;0.0;0.0
05;2021-03-07;0;0;0;0;0.0;0.0
05;2021-03-08;0;0;0;0;0.0;0.0
05;2021-03-09;0;0;0;0;0.0;0.0
05;2021-03-10;0;0;0;0;0.0;0.0
05;2021-03-11;0;0;0;0;0.0;0.0
05;2021-03-12;0;0;0;0;0.0;0.0
05;2021-03-13;0;0;0;0;0.0;0.0
05;2021-03-14;0;0;0;0;0.0;0.0
05;2021-03-15;0;0;0;0;0.0;0.0
05;2021-03-16;0;0;0;0;0.0;0.0
05;2021-03-17;0;0;0;0;0.0;0.0
05;2021-03-18;0;0;0;0;0.0;0.0
05;2021-03-19;0;0;0;0;0.0;0.0
05;2021-03-20;0;0;0;0;0.0;0.0
05;2021-03-21;0;0;0;0;0.0;0.0
05;2021-03-22;0;0;0;0;0.0;0.0
05;2021-03-23;0;0;0;0;0.0;0.0
05;2021-03-24;0;0;0;0;0.0;0.0
05;2021-03-25;0;0;0;0;0.0;0.0
05;2021-03-26;0;0;0;0;0.0;0.0
05;2021-03-27;0;0;0;0;0.0;0.0
05;2021-03-28;0;0;0;0;0.0;0.0
05;2021-03-29;2;0;2;0;0.0;0.0
05;2021-03-30;0;0;2;0;0.0;0.0
05;2021-03-31;0;0;2;0;0.0;0.0
05;2021-04-01;0;0;2;0;0.0;0.0
05;2021-04-02;0;0;2;0;0.0;0.0
05;2021-04-03;0;0;2;0;0.0;0.0
05;2021-04-04;0;0;2;0;0.0;0.0
05;2021-04-05;0;0;2;0;0.0;0.0
05;2021-04-06;0;0;2;0;0.0;0.0
05;2021-04-07;0;0;2;0;0.0;0.0
05;2021-04-08;1;0;3;0;0.1;0.0
05;2021-04-09;0;0;3;0;0.1;0.0
05;2021-04-10;0;0;3;0;0.1;0.0
05;2021-04-11;0;0;3;0;0.1;0.0
05;2021-04-12;0;0;3;0;0.1;0.0
05;2021-04-13;0;0;3;0;0.1;0.0
05;2021-04-14;0;0;3;0;0.1;0.0
05;2021-04-15;0;0;3;0;0.1;0.0
05;2021-04-16;0;0;3;0;0.1;0.0
05;2021-04-17;0;0;3;0;0.1;0.0
05;2021-04-18;0;0;3;0;0.1;0.0
05;2021-04-19;0;0;3;0;0.1;0.0
05;2021-04-20;0;0;3;0;0.1;0.0
05;2021-04-21;0;0;3;0;0.1;0.0
05;2021-04-22;0;0;3;0;0.1;0.0
05;2021-04-23;0;0;3;0;0.1;0.0
05;2021-04-24;0;0;3;0;0.1;0.0
05;2021-04-25;0;0;3;0;0.1;0.0
05;2021-04-26;0;0;3;0;0.1;0.0
05;2021-04-27;0;0;3;0;0.1;0.0
05;2021-04-28;0;0;3;0;0.1;0.0
05;2021-04-29;0;0;3;0;0.1;0.0
05;2021-04-30;0;0;3;0;0.1;0.0
05;2021-05-01;0;0;3;0;0.1;0.0
05;2021-05-02;0;0;3;0;0.1;0.0
05;2021-05-03;0;0;3;0;0.1;0.0
05;2021-05-04;0;0;3;0;0.1;0.0
05;2021-05-05;0;0;3;0;0.1;0.0
05;2021-05-06;0;0;3;0;0.1;0.0
05;2021-05-07;0;0;3;0;0.1;0.0
05;2021-05-08;0;0;3;0;0.1;0.0
05;2021-05-09;0;0;3;0;0.1;0.0
05;2021-05-10;0;0;3;0;0.1;0.0
05;2021-05-11;0;0;3;0;0.1;0.0
05;2021-05-12;0;0;3;0;0.1;0.0
05;2021-05-13;0;0;3;0;0.1;0.0
05;2021-05-14;0;0;3;0;0.1;0.0
05;2021-05-15;0;0;3;0;0.1;0.0
05;2021-05-16;0;0;3;0;0.1;0.0
05;2021-05-17;0;0;3;0;0.1;0.0
05;2021-05-18;0;0;3;0;0.1;0.0
05;2021-05-19;0;0;3;0;0.1;0.0
05;2021-05-20;0;0;3;0;0.1;0.0
05;2021-05-21;0;0;3;0;0.1;0.0
05;2021-05-22;0;0;3;0;0.1;0.0
05;2021-05-23;0;0;3;0;0.1;0.0
05;2021-05-24;0;0;3;0;0.1;0.0
05;2021-05-25;0;0;3;0;0.1;0.0
05;2021-05-26;0;0;3;0;0.1;0.0
05;2021-05-27;0;0;3;0;0.1;0.0
05;2021-05-28;0;0;3;0;0.1;0.0
05;2021-05-29;0;2;3;2;0.1;0.0
05;2021-05-30;0;0;3;2;0.1;0.0
05;2021-05-31;0;0;3;2;0.1;0.0
05;2021-06-01;0;0;3;2;0.1;0.0
05;2021-06-02;0;0;3;2;0.1;0.0
05;2021-06-03;0;0;3;2;0.1;0.0
05;2021-06-04;0;0;3;2;0.1;0.0
05;2021-06-05;0;0;3;2;0.1;0.0
05;2021-06-06;0;0;3;2;0.1;0.0
05;2021-06-07;0;0;3;2;0.1;0.0
05;2021-06-08;0;0;3;2;0.1;0.0
05;2021-06-09;0;0;3;2;0.1;0.0
05;2021-06-10;0;0;3;2;0.1;0.0
05;2021-06-11;0;0;3;2;0.1;0.0
05;2021-06-12;0;0;3;2;0.1;0.0
05;2021-06-13;0;0;3;2;0.1;0.0
05;2021-06-14;0;0;3;2;0.1;0.0
05;2021-06-15;0;0;3;2;0.1;0.0
05;2021-06-16;0;0;3;2;0.1;0.0
05;2021-06-17;0;0;3;2;0.1;0.0
05;2021-06-18;0;0;3;2;0.1;0.0
05;2021-06-19;0;0;3;2;0.1;0.0
05;2021-06-20;0;0;3;2;0.1;0.0
05;2021-06-21;0;0;3;2;0.1;0.0
05;2021-06-22;0;0;3;2;0.1;0.0
05;2021-06-23;0;0;3;2;0.1;0.0
05;2021-06-24;0;0;3;2;0.1;0.0
05;2021-06-25;0;0;3;2;0.1;0.0
05;2021-06-26;0;0;3;2;0.1;0.0
05;2021-06-27;0;0;3;2;0.1;0.0
06;2020-12-27;0;0;0;0;0.0;0.0
06;2020-12-28;0;0;0;0;0.0;0.0
06;2020-12-29;0;0;0;0;0.0;0.0
06;2020-12-30;0;0;0;0;0.0;0.0
06;2020-12-31;0;0;0;0;0.0;0.0
06;2021-01-01;0;0;0;0;0.0;0.0
06;2021-01-02;0;0;0;0;0.0;0.0
06;2021-01-03;0;0;0;0;0.0;0.0
06;2021-01-04;0;0;0;0;0.0;0.0
06;2021-01-05;0;0;0;0;0.0;0.0
06;2021-01-06;0;0;0;0;0.0;0.0
06;2021-01-07;0;0;0;0;0.0;0.0
06;2021-01-08;0;0;0;0;0.0;0.0
06;2021-01-09;0;0;0;0;0.0;0.0
06;2021-01-10;0;0;0;0;0.0;0.0
06;2021-01-11;9;0;9;0;0.0;0.0
06;2021-01-12;0;0;9;0;0.0;0.0
06;2021-01-13;0;0;9;0;0.0;0.0
06;2021-01-14;0;0;9;0;0.0;0.0
06;2021-01-15;1;0;10;0;0.0;0.0
06;2021-01-16;1;0;11;0;0.0;0.0
06;2021-01-17;0;0;11;0;0.0;0.0
06;2021-01-18;1;0;12;0;0.0;0.0
06;2021-01-19;0;0;12;0;0.0;0.0
06;2021-01-20;0;0;12;0;0.0;0.0
06;2021-01-21;0;0;12;0;0.0;0.0
06;2021-01-22;0;0;12;0;0.0;0.0
06;2021-01-23;1;0;13;0;0.0;0.0
06;2021-01-24;0;0;13;0;0.0;0.0
06;2021-01-25;140;1;153;1;0.1;0.0
06;2021-01-26;166;4;319;5;0.1;0.0
06;2021-01-27;250;2;569;7;0.2;0.0
06;2021-01-28;101;5;670;12;0.2;0.0
06;2021-01-29;230;2;900;14;0.3;0.0
06;2021-01-30;286;9;1186;23;0.4;0.0
06;2021-01-31;1;0;1187;23;0.4;0.0
06;2021-02-01;160;0;1347;23;0.5;0.0
06;2021-02-02;329;6;1676;29;0.6;0.0
06;2021-02-03;228;2;1904;31;0.7;0.0
06;2021-02-04;215;7;2119;38;0.8;0.0
06;2021-02-05;214;1;2333;39;0.8;0.0
06;2021-02-06;83;10;2416;49;0.9;0.0
06;2021-02-07;0;0;2416;49;0.9;0.0
06;2021-02-08;82;3;2498;52;0.9;0.0
06;2021-02-09;193;0;2691;52;1.0;0.0
06;2021-02-10;187;2;2878;54;1.0;0.0
06;2021-02-11;235;2;3113;56;1.1;0.0
06;2021-02-12;287;4;3400;60;1.2;0.0
06;2021-02-13;56;0;3456;60;1.2;0.0
06;2021-02-14;1;0;3457;60;1.2;0.0
06;2021-02-15;359;4;3816;64;1.4;0.0
06;2021-02-16;266;6;4082;70;1.5;0.0
06;2021-02-17;167;5;4249;75;1.5;0.0
06;2021-02-18;217;11;4466;86;1.6;0.0
06;2021-02-19;235;21;4701;107;1.7;0.0
06;2021-02-20;138;7;4839;114;1.7;0.0
06;2021-02-21;0;0;4839;114;1.7;0.0
06;2021-02-22;131;122;4970;236;1.8;0.1
06;2021-02-23;186;151;5156;387;1.8;0.1
06;2021-02-24;176;145;5332;532;1.9;0.2
06;2021-02-25;227;285;5559;817;2.0;0.3
06;2021-02-26;242;259;5801;1076;2.1;0.4
06;2021-02-27;0;0;5801;1076;2.1;0.4
06;2021-02-28;0;0;5801;1076;2.1;0.4
06;2021-03-01;144;259;5945;1335;2.1;0.5
06;2021-03-02;228;257;6173;1592;2.2;0.6
06;2021-03-03;202;189;6375;1781;2.3;0.6
06;2021-03-04;205;140;6580;1921;2.4;0.7
06;2021-03-05;224;114;6804;2035;2.4;0.7
06;2021-03-06;1;0;6805;2035;2.4;0.7
06;2021-03-07;0;0;6805;2035;2.4;0.7
06;2021-03-08;189;125;6994;2160;2.5;0.8
06;2021-03-09;390;155;7384;2315;2.6;0.8
06;2021-03-10;180;178;7564;2493;2.7;0.9
06;2021-03-11;167;207;7731;2700;2.8;1.0
06;2021-03-12;238;288;7969;2988;2.9;1.1
06;2021-03-13;2;0;7971;2988;2.9;1.1
06;2021-03-14;0;0;7971;2988;2.9;1.1
06;2021-03-15;156;292;8127;3280;2.9;1.2
06;2021-03-16;236;223;8363;3503;3.0;1.3
06;2021-03-17;264;140;8627;3643;3.1;1.3
06;2021-03-18;172;232;8799;3875;3.1;1.4
06;2021-03-19;172;298;8971;4173;3.2;1.5
06;2021-03-20;0;0;8971;4173;3.2;1.5
06;2021-03-21;0;0;8971;4173;3.2;1.5
06;2021-03-22;97;136;9068;4309;3.2;1.5
06;2021-03-23;136;240;9204;4549;3.3;1.6
06;2021-03-24;160;146;9364;4695;3.4;1.7
06;2021-03-25;186;206;9550;4901;3.4;1.8
06;2021-03-26;160;212;9710;5113;3.5;1.8
06;2021-03-27;18;0;9728;5113;3.5;1.8
06;2021-03-28;0;0;9728;5113;3.5;1.8
06;2021-03-29;0;2;9728;5115;3.5;1.8
06;2021-03-30;272;334;10000;5449;3.6;1.9
06;2021-03-31;225;125;10225;5574;3.7;2.0
06;2021-04-01;243;104;10468;5678;3.7;2.0
06;2021-04-02;285;263;10753;5941;3.8;2.1
06;2021-04-03;906;307;11659;6248;4.2;2.2
06;2021-04-04;1;0;11660;6248;4.2;2.2
06;2021-04-05;1;0;11661;6248;4.2;2.2
06;2021-04-06;160;282;11821;6530;4.2;2.3
06;2021-04-07;237;265;12058;6795;4.3;2.4
06;2021-04-08;286;140;12344;6935;4.4;2.5
06;2021-04-09;248;171;12592;7106;4.5;2.5
06;2021-04-10;181;114;12773;7220;4.6;2.6
06;2021-04-11;7;0;12780;7220;4.6;2.6
06;2021-04-12;0;19;12780;7239;4.6;2.6
06;2021-04-13;393;343;13173;7582;4.7;2.7
06;2021-04-14;239;205;13412;7787;4.8;2.8
06;2021-04-15;207;117;13619;7904;4.9;2.8
06;2021-04-16;214;127;13833;8031;4.9;2.9
06;2021-04-17;226;132;14059;8163;5.0;2.9
06;2021-04-18;1;0;14060;8163;5.0;2.9
06;2021-04-19;7;1;14067;8164;5.0;2.9
06;2021-04-20;368;224;14435;8388;5.2;3.0
06;2021-04-21;412;150;14847;8538;5.3;3.1
06;2021-04-22;410;150;15257;8688;5.5;3.1
06;2021-04-23;367;166;15624;8854;5.6;3.2
06;2021-04-24;413;127;16037;8981;5.7;3.2
06;2021-04-25;2;0;16039;8981;5.7;3.2
06;2021-04-26;54;8;16093;8989;5.8;3.2
06;2021-04-27;351;293;16444;9282;5.9;3.3
06;2021-04-28;355;515;16799;9797;6.0;3.5
06;2021-04-29;558;345;17357;10142;6.2;3.6
06;2021-04-30;403;238;17760;10380;6.4;3.7
06;2021-05-01;670;285;18430;10665;6.6;3.8
06;2021-05-02;0;0;18430;10665;6.6;3.8
06;2021-05-03;136;6;18566;10671;6.6;3.8
06;2021-05-04;353;426;18919;11097;6.8;4.0
06;2021-05-05;444;317;19363;11414;6.9;4.1
06;2021-05-06;319;200;19682;11614;7.0;4.2
06;2021-05-07;341;134;20023;11748;7.2;4.2
06;2021-05-08;300;140;20323;11888;7.3;4.3
06;2021-05-09;0;0;20323;11888;7.3;4.3
06;2021-05-10;8;9;20331;11897;7.3;4.3
06;2021-05-11;359;489;20690;12386;7.4;4.4
06;2021-05-12;331;310;21021;12696;7.5;4.5
06;2021-05-13;127;97;21148;12793;7.6;4.6
06;2021-05-14;0;0;21148;12793;7.6;4.6
06;2021-05-15;484;283;21632;13076;7.7;4.7
06;2021-05-16;0;0;21632;13076;7.7;4.7
06;2021-05-17;122;51;21754;13127;7.8;4.7
06;2021-05-18;515;430;22269;13557;8.0;4.9
06;2021-05-19;649;663;22918;14220;8.2;5.1
06;2021-05-20;1055;496;23973;14716;8.6;5.3
06;2021-05-21;1046;315;25019;15031;9.0;5.4
06;2021-05-22;1241;300;26260;15331;9.4;5.5
06;2021-05-23;0;0;26260;15331;9.4;5.5
06;2021-05-24;1;0;26261;15331;9.4;5.5
06;2021-05-25;878;624;27139;15955;9.7;5.7
06;2021-05-26;1033;841;28172;16796;10.1;6.0
06;2021-05-27;1307;506;29479;17302;10.5;6.2
06;2021-05-28;952;372;30431;17674;10.9;6.3
06;2021-05-29;1130;390;31561;18064;11.3;6.5
06;2021-05-30;0;1;31561;18065;11.3;6.5
06;2021-05-31;103;6;31664;18071;11.3;6.5
06;2021-06-01;1138;650;32802;18721;11.7;6.7
06;2021-06-02;1151;494;33953;19215;12.1;6.9
06;2021-06-03;792;333;34745;19548;12.4;7.0
06;2021-06-04;977;320;35722;19868;12.8;7.1
06;2021-06-05;655;298;36377;20166;13.0;7.2
06;2021-06-06;0;0;36377;20166;13.0;7.2
06;2021-06-07;84;12;36461;20178;13.0;7.2
06;2021-06-08;917;442;37378;20620;13.4;7.4
06;2021-06-09;951;546;38329;21166;13.7;7.6
06;2021-06-10;650;224;38979;21390;13.9;7.7
06;2021-06-11;825;368;39804;21758;14.2;7.8
06;2021-06-12;563;273;40367;22031;14.4;7.9
06;2021-06-13;0;0;40367;22031;14.4;7.9
06;2021-06-14;178;112;40545;22143;14.5;7.9
06;2021-06-15;399;839;40944;22982;14.7;8.2
06;2021-06-16;880;1437;41824;24419;15.0;8.7
06;2021-06-17;757;650;42581;25069;15.2;9.0
06;2021-06-18;686;617;43267;25686;15.5;9.2
06;2021-06-19;527;639;43794;26325;15.7;9.4
06;2021-06-20;0;0;43794;26325;15.7;9.4
06;2021-06-21;122;128;43916;26453;15.7;9.5
06;2021-06-22;423;1143;44339;27596;15.9;9.9
06;2021-06-23;646;1179;44985;28775;16.1;10.3
06;2021-06-24;453;538;45438;29313;16.3;10.5
06;2021-06-25;522;469;45960;29782;16.4;10.7
06;2021-06-26;380;681;46340;30463;16.6;10.9
06;2021-06-27;0;0;46340;30463;16.6;10.9
07;2020-12-27;0;0;0;0;0.0;0.0
07;2020-12-28;0;0;0;0;0.0;0.0
07;2020-12-29;0;0;0;0;0.0;0.0
07;2020-12-30;0;0;0;0;0.0;0.0
07;2020-12-31;0;0;0;0;0.0;0.0
07;2021-01-01;0;0;0;0;0.0;0.0
07;2021-01-02;0;0;0;0;0.0;0.0
07;2021-01-03;0;0;0;0;0.0;0.0
07;2021-01-04;0;0;0;0;0.0;0.0
07;2021-01-05;0;0;0;0;0.0;0.0
07;2021-01-06;0;0;0;0;0.0;0.0
07;2021-01-07;0;0;0;0;0.0;0.0
07;2021-01-08;0;0;0;0;0.0;0.0
07;2021-01-09;0;0;0;0;0.0;0.0
07;2021-01-10;0;0;0;0;0.0;0.0
07;2021-01-11;0;0;0;0;0.0;0.0
07;2021-01-12;0;0;0;0;0.0;0.0
07;2021-01-13;0;0;0;0;0.0;0.0
07;2021-01-14;0;0;0;0;0.0;0.0
07;2021-01-15;0;0;0;0;0.0;0.0
07;2021-01-16;0;0;0;0;0.0;0.0
07;2021-01-17;0;0;0;0;0.0;0.0
07;2021-01-18;1;0;1;0;0.0;0.0
07;2021-01-19;0;0;1;0;0.0;0.0
07;2021-01-20;0;0;1;0;0.0;0.0
07;2021-01-21;12;0;13;0;0.1;0.0
07;2021-01-22;12;0;25;0;0.3;0.0
07;2021-01-23;0;0;25;0;0.3;0.0
07;2021-01-24;0;0;25;0;0.3;0.0
07;2021-01-25;0;0;25;0;0.3;0.0
07;2021-01-26;0;0;25;0;0.3;0.0
07;2021-01-27;12;0;37;0;0.4;0.0
07;2021-01-28;1;0;38;0;0.4;0.0
07;2021-01-29;6;0;44;0;0.4;0.0
07;2021-01-30;0;0;44;0;0.4;0.0
07;2021-01-31;0;0;44;0;0.4;0.0
07;2021-02-01;0;0;44;0;0.4;0.0
07;2021-02-02;0;0;44;0;0.4;0.0
07;2021-02-03;11;0;55;0;0.6;0.0
07;2021-02-04;12;0;67;0;0.7;0.0
07;2021-02-05;11;0;78;0;0.8;0.0
07;2021-02-06;0;0;78;0;0.8;0.0
07;2021-02-07;0;0;78;0;0.8;0.0
07;2021-02-08;0;0;78;0;0.8;0.0
07;2021-02-09;13;0;91;0;0.9;0.0
07;2021-02-10;0;0;91;0;0.9;0.0
07;2021-02-11;16;0;107;0;1.1;0.0
07;2021-02-12;45;0;152;0;1.5;0.0
07;2021-02-13;0;0;152;0;1.5;0.0
07;2021-02-14;0;0;152;0;1.5;0.0
07;2021-02-15;0;0;152;0;1.5;0.0
07;2021-02-16;0;0;152;0;1.5;0.0
07;2021-02-17;0;0;152;0;1.5;0.0
07;2021-02-18;18;0;170;0;1.7;0.0
07;2021-02-19;34;0;204;0;2.0;0.0
07;2021-02-20;0;0;204;0;2.0;0.0
07;2021-02-21;0;0;204;0;2.0;0.0
07;2021-02-22;0;0;204;0;2.0;0.0
07;2021-02-23;0;22;204;22;2.0;0.2
07;2021-02-24;0;0;204;22;2.0;0.2
07;2021-02-25;15;10;219;32;2.2;0.3
07;2021-02-26;33;21;252;53;2.5;0.5
07;2021-02-27;0;0;252;53;2.5;0.5
07;2021-02-28;0;0;252;53;2.5;0.5
07;2021-03-01;0;0;252;53;2.5;0.5
07;2021-03-02;17;11;269;64;2.7;0.6
07;2021-03-03;0;0;269;64;2.7;0.6
07;2021-03-04;16;11;285;75;2.9;0.8
07;2021-03-05;33;19;318;94;3.2;0.9
07;2021-03-06;0;0;318;94;3.2;0.9
07;2021-03-07;0;0;318;94;3.2;0.9
07;2021-03-08;0;0;318;94;3.2;0.9
07;2021-03-09;1;0;319;94;3.2;0.9
07;2021-03-10;0;0;319;94;3.2;0.9
07;2021-03-11;20;30;339;124;3.4;1.2
07;2021-03-12;62;42;401;166;4.0;1.7
07;2021-03-13;0;0;401;166;4.0;1.7
07;2021-03-14;0;0;401;166;4.0;1.7
07;2021-03-15;0;0;401;166;4.0;1.7
07;2021-03-16;30;9;431;175;4.3;1.8
07;2021-03-17;0;0;431;175;4.3;1.8
07;2021-03-18;29;16;460;191;4.6;1.9
07;2021-03-19;56;31;516;222;5.2;2.2
07;2021-03-20;0;0;516;222;5.2;2.2
07;2021-03-21;0;0;516;222;5.2;2.2
07;2021-03-22;0;0;516;222;5.2;2.2
07;2021-03-23;0;0;516;222;5.2;2.2
07;2021-03-24;0;0;516;222;5.2;2.2
07;2021-03-25;65;17;581;239;5.8;2.4
07;2021-03-26;73;26;654;265;6.6;2.7
07;2021-03-27;0;0;654;265;6.6;2.7
07;2021-03-28;0;0;654;265;6.6;2.7
07;2021-03-29;0;0;654;265;6.6;2.7
07;2021-03-30;40;18;694;283;7.0;2.8
07;2021-03-31;26;15;720;298;7.2;3.0
07;2021-04-01;25;32;745;330;7.5;3.3
07;2021-04-02;0;0;745;330;7.5;3.3
07;2021-04-03;0;0;745;330;7.5;3.3
07;2021-04-04;0;0;745;330;7.5;3.3
07;2021-04-05;9;0;754;330;7.6;3.3
07;2021-04-06;0;0;754;330;7.6;3.3
07;2021-04-07;0;0;754;330;7.6;3.3
07;2021-04-08;57;46;811;376;8.1;3.8
07;2021-04-09;59;31;870;407;8.7;4.1
07;2021-04-10;0;0;870;407;8.7;4.1
07;2021-04-11;0;0;870;407;8.7;4.1
07;2021-04-12;0;0;870;407;8.7;4.1
07;2021-04-13;0;0;870;407;8.7;4.1
07;2021-04-14;5;6;875;413;8.8;4.1
07;2021-04-15;56;71;931;484;9.3;4.9
07;2021-04-16;90;35;1021;519;10.2;5.2
07;2021-04-17;0;1;1021;520;10.2;5.2
07;2021-04-18;0;0;1021;520;10.2;5.2
07;2021-04-19;1;0;1022;520;10.3;5.2
07;2021-04-20;335;66;1357;586;13.6;5.9
07;2021-04-21;337;29;1694;615;17.0;6.2
07;2021-04-22;284;50;1978;665;19.9;6.7
07;2021-04-23;258;41;2236;706;22.4;7.1
07;2021-04-24;231;1;2467;707;24.8;7.1
07;2021-04-25;0;0;2467;707;24.8;7.1
07;2021-04-26;283;20;2750;727;27.6;7.3
07;2021-04-27;224;69;2974;796;29.9;8.0
07;2021-04-28;192;26;3166;822;31.8;8.3
07;2021-04-29;170;22;3336;844;33.5;8.5
07;2021-04-30;172;15;3508;859;35.2;8.6
07;2021-05-01;200;12;3708;871;37.2;8.7
07;2021-05-02;0;0;3708;871;37.2;8.7
07;2021-05-03;134;10;3842;881;38.6;8.8
07;2021-05-04;161;54;4003;935;40.2;9.4
07;2021-05-05;221;30;4224;965;42.4;9.7
07;2021-05-06;175;31;4399;996;44.2;10.0
07;2021-05-07;149;31;4548;1027;45.7;10.3
07;2021-05-08;1;0;4549;1027;45.7;10.3
07;2021-05-09;0;2;4549;1029;45.7;10.3
07;2021-05-10;0;0;4549;1029;45.7;10.3
07;2021-05-11;2;41;4551;1070;45.7;10.7
07;2021-05-12;6;36;4557;1106;45.7;11.1
07;2021-05-13;0;0;4557;1106;45.7;11.1
07;2021-05-14;28;98;4585;1204;46.0;12.1
07;2021-05-15;0;0;4585;1204;46.0;12.1
07;2021-05-16;0;0;4585;1204;46.0;12.1
07;2021-05-17;1;14;4586;1218;46.0;12.2
07;2021-05-18;17;32;4603;1250;46.2;12.5
07;2021-05-19;0;1;4603;1251;46.2;12.6
07;2021-05-20;0;8;4603;1259;46.2;12.6
07;2021-05-21;12;32;4615;1291;46.3;13.0
07;2021-05-22;0;0;4615;1291;46.3;13.0
07;2021-05-23;0;0;4615;1291;46.3;13.0
07;2021-05-24;0;0;4615;1291;46.3;13.0
07;2021-05-25;50;334;4665;1625;46.8;16.3
07;2021-05-26;54;359;4719;1984;47.4;19.9
07;2021-05-27;34;317;4753;2301;47.7;23.1
07;2021-05-28;27;256;4780;2557;48.0;25.7
07;2021-05-29;35;376;4815;2933;48.3;29.4
07;2021-05-30;0;0;4815;2933;48.3;29.4
07;2021-05-31;45;218;4860;3151;48.8;31.6
07;2021-06-01;47;226;4907;3377;49.3;33.9
07;2021-06-02;69;273;4976;3650;50.0;36.6
07;2021-06-03;41;252;5017;3902;50.4;39.2
07;2021-06-04;73;272;5090;4174;51.1;41.9
07;2021-06-05;1;0;5091;4174;51.1;41.9
07;2021-06-06;0;0;5091;4174;51.1;41.9
07;2021-06-07;1;1;5092;4175;51.1;41.9
07;2021-06-08;3;2;5095;4177;51.1;41.9
07;2021-06-09;0;3;5095;4180;51.1;42.0
07;2021-06-10;8;4;5103;4184;51.2;42.0
07;2021-06-11;3;8;5106;4192;51.3;42.1
07;2021-06-12;15;59;5121;4251;51.4;42.7
07;2021-06-13;0;0;5121;4251;51.4;42.7
07;2021-06-14;0;0;5121;4251;51.4;42.7
07;2021-06-15;0;1;5121;4252;51.4;42.7
07;2021-06-16;0;0;5121;4252;51.4;42.7
07;2021-06-17;2;6;5123;4258;51.4;42.7
07;2021-06-18;0;2;5123;4260;51.4;42.8
07;2021-06-19;25;49;5148;4309;51.7;43.3
07;2021-06-20;0;0;5148;4309;51.7;43.3
07;2021-06-21;0;2;5148;4311;51.7;43.3
07;2021-06-22;8;0;5156;4311;51.8;43.3
07;2021-06-23;15;9;5171;4320;51.9;43.4
07;2021-06-24;10;5;5181;4325;52.0;43.4
07;2021-06-25;0;0;5181;4325;52.0;43.4
07;2021-06-26;28;49;5209;4374;52.3;43.9
07;2021-06-27;0;0;5209;4374;52.3;43.9
08;2020-12-27;0;0;0;0;0.0;0.0
08;2020-12-28;0;0;0;0;0.0;0.0
08;2020-12-29;0;0;0;0;0.0;0.0
08;2020-12-30;0;0;0;0;0.0;0.0
08;2020-12-31;0;0;0;0;0.0;0.0
08;2021-01-01;0;0;0;0;0.0;0.0
08;2021-01-02;0;0;0;0;0.0;0.0
08;2021-01-03;0;0;0;0;0.0;0.0
08;2021-01-04;0;0;0;0;0.0;0.0
08;2021-01-05;0;0;0;0;0.0;0.0
08;2021-01-06;0;0;0;0;0.0;0.0
08;2021-01-07;0;0;0;0;0.0;0.0
08;2021-01-08;0;0;0;0;0.0;0.0
08;2021-01-09;0;0;0;0;0.0;0.0
08;2021-01-10;0;0;0;0;0.0;0.0
08;2021-01-11;0;0;0;0;0.0;0.0
08;2021-01-12;0;0;0;0;0.0;0.0
08;2021-01-13;10;0;10;0;0.0;0.0
08;2021-01-14;12;0;22;0;0.1;0.0
08;2021-01-15;7;0;29;0;0.1;0.0
08;2021-01-16;0;0;29;0;0.1;0.0
08;2021-01-17;0;0;29;0;0.1;0.0
08;2021-01-18;0;0;29;0;0.1;0.0
08;2021-01-19;12;0;41;0;0.1;0.0
08;2021-01-20;12;0;53;0;0.1;0.0
08;2021-01-21;6;0;59;0;0.2;0.0
08;2021-01-22;0;0;59;0;0.2;0.0
08;2021-01-23;0;0;59;0;0.2;0.0
08;2021-01-24;0;0;59;0;0.2;0.0
08;2021-01-25;0;0;59;0;0.2;0.0
08;2021-01-26;9;0;68;0;0.2;0.0
08;2021-01-27;10;0;78;0;0.2;0.0
08;2021-01-28;6;0;84;0;0.2;0.0
08;2021-01-29;0;0;84;0;0.2;0.0
08;2021-01-30;0;0;84;0;0.2;0.0
08;2021-01-31;0;0;84;0;0.2;0.0
08;2021-02-01;0;0;84;0;0.2;0.0
08;2021-02-02;38;0;122;0;0.3;0.0
08;2021-02-03;10;0;132;0;0.4;0.0
08;2021-02-04;29;0;161;0;0.5;0.0
08;2021-02-05;7;0;168;0;0.5;0.0
08;2021-02-06;0;0;168;0;0.5;0.0
08;2021-02-07;0;0;168;0;0.5;0.0
08;2021-02-08;0;0;168;0;0.5;0.0
08;2021-02-09;38;0;206;0;0.6;0.0
08;2021-02-10;27;1;233;1;0.7;0.0
08;2021-02-11;0;0;233;1;0.7;0.0
08;2021-02-12;36;0;269;1;0.8;0.0
08;2021-02-13;0;0;269;1;0.8;0.0
08;2021-02-14;0;0;269;1;0.8;0.0
08;2021-02-15;50;0;319;1;0.9;0.0
08;2021-02-16;0;0;319;1;0.9;0.0
08;2021-02-17;0;0;319;1;0.9;0.0
08;2021-02-18;27;0;346;1;1.0;0.0
08;2021-02-19;44;0;390;1;1.1;0.0
08;2021-02-20;0;0;390;1;1.1;0.0
08;2021-02-21;0;0;390;1;1.1;0.0
08;2021-02-22;46;4;436;5;1.2;0.0
08;2021-02-23;41;29;477;34;1.3;0.1
08;2021-02-24;35;1;512;35;1.4;0.1
08;2021-02-25;55;36;567;71;1.6;0.2
08;2021-02-26;39;5;606;76;1.7;0.2
08;2021-02-27;0;0;606;76;1.7;0.2
08;2021-02-28;0;0;606;76;1.7;0.2
08;2021-03-01;48;5;654;81;1.9;0.2
08;2021-03-02;7;27;661;108;1.9;0.3
08;2021-03-03;38;27;699;135;2.0;0.4
08;2021-03-04;30;26;729;161;2.1;0.5
08;2021-03-05;46;11;775;172;2.2;0.5
08;2021-03-06;0;0;775;172;2.2;0.5
08;2021-03-07;0;0;775;172;2.2;0.5
08;2021-03-08;30;7;805;179;2.3;0.5
08;2021-03-09;19;27;824;206;2.3;0.6
08;2021-03-10;32;28;856;234;2.4;0.7
08;2021-03-11;2;0;858;234;2.4;0.7
08;2021-03-12;52;21;910;255;2.6;0.7
08;2021-03-13;11;0;921;255;2.6;0.7
08;2021-03-14;0;0;921;255;2.6;0.7
08;2021-03-15;31;43;952;298;2.7;0.8
08;2021-03-16;73;6;1025;304;2.9;0.9
08;2021-03-17;67;13;1092;317;3.1;0.9
08;2021-03-18;82;39;1174;356;3.3;1.0
08;2021-03-19;30;51;1204;407;3.4;1.2
08;2021-03-20;0;0;1204;407;3.4;1.2
08;2021-03-21;0;0;1204;407;3.4;1.2
08;2021-03-22;34;45;1238;452;3.5;1.3
08;2021-03-23;30;43;1268;495;3.6;1.4
08;2021-03-24;38;42;1306;537;3.7;1.5
08;2021-03-25;91;34;1397;571;4.0;1.6
08;2021-03-26;45;33;1442;604;4.1;1.7
08;2021-03-27;93;3;1535;607;4.3;1.7
08;2021-03-28;0;0;1535;607;4.3;1.7
08;2021-03-29;69;49;1604;656;4.5;1.9
08;2021-03-30;98;24;1702;680;4.8;1.9
08;2021-03-31;89;47;1791;727;5.1;2.1
08;2021-04-01;56;48;1847;775;5.2;2.2
08;2021-04-02;0;0;1847;775;5.2;2.2
08;2021-04-03;0;0;1847;775;5.2;2.2
08;2021-04-04;0;0;1847;775;5.2;2.2
08;2021-04-05;0;0;1847;775;5.2;2.2
08;2021-04-06;49;63;1896;838;5.4;2.4
08;2021-04-07;91;32;1987;870;5.6;2.5
08;2021-04-08;120;7;2107;877;6.0;2.5
08;2021-04-09;89;39;2196;916;6.2;2.6
08;2021-04-10;162;8;2358;924;6.7;2.6
08;2021-04-11;0;0;2358;924;6.7;2.6
08;2021-04-12;41;76;2399;1000;6.8;2.8
08;2021-04-13;48;71;2447;1071;6.9;3.0
08;2021-04-14;81;45;2528;1116;7.2;3.2
08;2021-04-15;92;25;2620;1141;7.4;3.2
08;2021-04-16;77;42;2697;1183;7.6;3.3
08;2021-04-17;165;4;2862;1187;8.1;3.4
08;2021-04-18;0;0;2862;1187;8.1;3.4
08;2021-04-19;52;67;2914;1254;8.2;3.5
08;2021-04-20;83;27;2997;1281;8.5;3.6
08;2021-04-21;91;29;3088;1310;8.7;3.7
08;2021-04-22;101;20;3189;1330;9.0;3.8
08;2021-04-23;44;66;3233;1396;9.1;4.0
08;2021-04-24;99;78;3332;1474;9.4;4.2
08;2021-04-25;0;0;3332;1474;9.4;4.2
08;2021-04-26;28;93;3360;1567;9.5;4.4
08;2021-04-27;58;63;3418;1630;9.7;4.6
08;2021-04-28;88;39;3506;1669;9.9;4.7
08;2021-04-29;90;34;3596;1703;10.2;4.8
08;2021-04-30;104;15;3700;1718;10.5;4.9
08;2021-05-01;0;8;3700;1726;10.5;4.9
08;2021-05-02;0;0;3700;1726;10.5;4.9
08;2021-05-03;24;102;3724;1828;10.5;5.2
08;2021-05-04;157;103;3881;1931;11.0;5.5
08;2021-05-05;141;59;4022;1990;11.4;5.6
08;2021-05-06;199;49;4221;2039;11.9;5.8
08;2021-05-07;127;71;4348;2110;12.3;6.0
08;2021-05-08;69;122;4417;2232;12.5;6.3
08;2021-05-09;0;0;4417;2232;12.5;6.3
08;2021-05-10;123;102;4540;2334;12.8;6.6
08;2021-05-11;132;77;4672;2411;13.2;6.8
08;2021-05-12;156;76;4828;2487;13.7;7.0
08;2021-05-13;82;6;4910;2493;13.9;7.1
08;2021-05-14;129;62;5039;2555;14.3;7.2
08;2021-05-15;85;4;5124;2559;14.5;7.2
08;2021-05-16;0;0;5124;2559;14.5;7.2
08;2021-05-17;145;112;5269;2671;14.9;7.6
08;2021-05-18;150;95;5419;2766;15.3;7.8
08;2021-05-19;84;70;5503;2836;15.6;8.0
08;2021-05-20;103;26;5606;2862;15.9;8.1
08;2021-05-21;97;52;5703;2914;16.1;8.2
08;2021-05-22;99;11;5802;2925;16.4;8.3
08;2021-05-23;0;0;5802;2925;16.4;8.3
08;2021-05-24;33;7;5835;2932;16.5;8.3
08;2021-05-25;119;78;5954;3010;16.9;8.5
08;2021-05-26;106;51;6060;3061;17.2;8.7
08;2021-05-27;109;42;6169;3103;17.5;8.8
08;2021-05-28;33;1;6202;3104;17.6;8.8
08;2021-05-29;59;215;6261;3319;17.7;9.4
08;2021-05-30;0;0;6261;3319;17.7;9.4
08;2021-05-31;108;64;6369;3383;18.0;9.6
08;2021-06-01;112;63;6481;3446;18.3;9.8
08;2021-06-02;130;33;6611;3479;18.7;9.8
08;2021-06-03;100;38;6711;3517;19.0;10.0
08;2021-06-04;128;71;6839;3588;19.4;10.2
08;2021-06-05;82;21;6921;3609;19.6;10.2
08;2021-06-06;0;0;6921;3609;19.6;10.2
08;2021-06-07;96;95;7017;3704;19.9;10.5
08;2021-06-08;78;89;7095;3793;20.1;10.7
08;2021-06-09;98;74;7193;3867;20.4;10.9
08;2021-06-10;111;66;7304;3933;20.7;11.1
08;2021-06-11;116;108;7420;4041;21.0;11.4
08;2021-06-12;57;30;7477;4071;21.2;11.5
08;2021-06-13;0;0;7477;4071;21.2;11.5
08;2021-06-14;106;128;7583;4199;21.5;11.9
08;2021-06-15;86;118;7669;4317;21.7;12.2
08;2021-06-16;103;148;7772;4465;22.0;12.6
08;2021-06-17;84;72;7856;4537;22.2;12.8
08;2021-06-18;65;99;7921;4636;22.4;13.1
08;2021-06-19;64;80;7985;4716;22.6;13.3
08;2021-06-20;0;0;7985;4716;22.6;13.3
08;2021-06-21;78;149;8063;4865;22.8;13.8
08;2021-06-22;69;100;8132;4965;23.0;14.1
08;2021-06-23;68;113;8200;5078;23.2;14.4
08;2021-06-24;42;73;8242;5151;23.3;14.6
08;2021-06-25;62;99;8304;5250;23.5;14.9
08;2021-06-26;35;61;8339;5311;23.6;15.0
08;2021-06-27;0;0;8339;5311;23.6;15.0
11;2020-12-27;13;2;13;2;0.0;0.0
11;2020-12-28;11;0;24;2;0.0;0.0
11;2020-12-29;56;0;80;2;0.0;0.0
11;2020-12-30;91;0;171;2;0.0;0.0
11;2020-12-31;39;0;210;2;0.0;0.0
11;2021-01-01;30;1;240;3;0.0;0.0
11;2021-01-02;64;1;304;4;0.0;0.0
11;2021-01-03;78;0;382;4;0.0;0.0
11;2021-01-04;553;5;935;9;0.0;0.0
11;2021-01-05;2069;17;3004;26;0.0;0.0
11;2021-01-06;3018;22;6022;48;0.0;0.0
11;2021-01-07;5388;38;11410;86;0.1;0.0
11;2021-01-08;7123;48;18533;134;0.2;0.0
11;2021-01-09;1890;7;20423;141;0.2;0.0
11;2021-01-10;1755;8;22178;149;0.2;0.0
11;2021-01-11;8009;66;30187;215;0.2;0.0
11;2021-01-12;10371;100;40558;315;0.3;0.0
11;2021-01-13;10018;101;50576;416;0.4;0.0
11;2021-01-14;10125;136;60701;552;0.5;0.0
11;2021-01-15;8920;87;69621;639;0.6;0.0
11;2021-01-16;2413;37;72034;676;0.6;0.0
11;2021-01-17;1088;19;73122;695;0.6;0.0
11;2021-01-18;12260;134;85382;829;0.7;0.0
11;2021-01-19;15852;127;101234;956;0.8;0.0
11;2021-01-20;18374;120;119608;1076;1.0;0.0
11;2021-01-21;22287;155;141895;1231;1.2;0.0
11;2021-01-22;17094;167;158989;1398;1.3;0.0
11;2021-01-23;4960;20;163949;1418;1.3;0.0
11;2021-01-24;1280;6;165229;1424;1.3;0.0
11;2021-01-25;8873;192;174102;1616;1.4;0.0
11;2021-01-26;12340;386;186442;2002;1.5;0.0
11;2021-01-27;16228;693;202670;2695;1.7;0.0
11;2021-01-28;20300;1196;222970;3891;1.8;0.0
11;2021-01-29;15394;1387;238364;5278;1.9;0.0
11;2021-01-30;4465;106;242829;5384;2.0;0.0
11;2021-01-31;585;22;243414;5406;2.0;0.0
11;2021-02-01;7387;1959;250801;7365;2.0;0.1
11;2021-02-02;8352;2820;259153;10185;2.1;0.1
11;2021-02-03;8122;3807;267275;13992;2.2;0.1
11;2021-02-04;8784;4597;276059;18589;2.2;0.2
11;2021-02-05;8951;4431;285010;23020;2.3;0.2
11;2021-02-06;3270;751;288280;23771;2.3;0.2
11;2021-02-07;588;542;288868;24313;2.4;0.2
11;2021-02-08;6228;5924;295096;30237;2.4;0.2
11;2021-02-09;8432;9691;303528;39928;2.5;0.3
11;2021-02-10;9955;11226;313483;51154;2.6;0.4
11;2021-02-11;12366;16522;325849;67676;2.7;0.6
11;2021-02-12;11863;10614;337712;78290;2.8;0.6
11;2021-02-13;2592;2590;340304;80880;2.8;0.7
11;2021-02-14;312;560;340616;81440;2.8;0.7
11;2021-02-15;4452;12033;345068;93473;2.8;0.8
11;2021-02-16;5665;18522;350733;111995;2.9;0.9
11;2021-02-17;5674;15631;356407;127626;2.9;1.0
11;2021-02-18;8637;20820;365044;148446;3.0;1.2
11;2021-02-19;9041;15459;374085;163905;3.0;1.3
11;2021-02-20;1691;4847;375776;168752;3.1;1.4
11;2021-02-21;396;831;376172;169583;3.1;1.4
11;2021-02-22;4229;9933;380401;179516;3.1;1.5
11;2021-02-23;4946;10558;385347;190074;3.1;1.5
11;2021-02-24;5404;9894;390751;199968;3.2;1.6
11;2021-02-25;8616;14181;399367;214149;3.3;1.7
11;2021-02-26;11186;10199;410553;224348;3.3;1.8
11;2021-02-27;5068;3340;415621;227688;3.4;1.9
11;2021-02-28;741;662;416362;228350;3.4;1.9
11;2021-03-01;8840;8009;425202;236359;3.5;1.9
11;2021-03-02;14382;9667;439584;246026;3.6;2.0
11;2021-03-03;18670;10153;458254;256179;3.7;2.1
11;2021-03-04;28249;11162;486503;267341;4.0;2.2
11;2021-03-05;36493;11149;522996;278490;4.3;2.3
11;2021-03-06;46416;3595;569412;282085;4.6;2.3
11;2021-03-07;34294;2796;603706;284881;4.9;2.3
11;2021-03-08;17760;7441;621466;292322;5.1;2.4
11;2021-03-09;26849;7762;648315;300084;5.3;2.4
11;2021-03-10;27639;8394;675954;308478;5.5;2.5
11;2021-03-11;37037;9944;712991;318422;5.8;2.6
11;2021-03-12;44774;9487;757765;327909;6.2;2.7
11;2021-03-13;39873;2711;797638;330620;6.5;2.7
11;2021-03-14;14272;819;811910;331439;6.6;2.7
11;2021-03-15;29209;4051;841119;335490;6.9;2.7
11;2021-03-16;23746;3885;864865;339375;7.0;2.8
11;2021-03-17;24418;3694;889283;343069;7.2;2.8
11;2021-03-18;29008;4166;918291;347235;7.5;2.8
11;2021-03-19;39650;4355;957941;351590;7.8;2.9
11;2021-03-20;25850;1619;983791;353209;8.0;2.9
11;2021-03-21;5627;1336;989418;354545;8.1;2.9
11;2021-03-22;32119;4282;1021537;358827;8.3;2.9
11;2021-03-23;43302;5510;1064839;364337;8.7;3.0
11;2021-03-24;42637;5121;1107476;369458;9.0;3.0
11;2021-03-25;57920;5319;1165396;374777;9.5;3.1
11;2021-03-26;57720;6082;1223116;380859;10.0;3.1
11;2021-03-27;34493;2146;1257609;383005;10.2;3.1
11;2021-03-28;10157;498;1267766;383503;10.3;3.1
11;2021-03-29;33039;8231;1300805;391734;10.6;3.2
11;2021-03-30;44861;11673;1345666;403407;11.0;3.3
11;2021-03-31;39877;13996;1385543;417403;11.3;3.4
11;2021-04-01;45364;21907;1430907;439310;11.7;3.6
11;2021-04-02;39353;24206;1470260;463516;12.0;3.8
11;2021-04-03;18375;21190;1488635;484706;12.1;3.9
11;2021-04-04;6110;7364;1494745;492070;12.2;4.0
11;2021-04-05;5955;2168;1500700;494238;12.2;4.0
11;2021-04-06;29960;18512;1530660;512750;12.5;4.2
11;2021-04-07;37525;20097;1568185;532847;12.8;4.3
11;2021-04-08;46657;21217;1614842;554064;13.2;4.5
11;2021-04-09;53784;21708;1668626;575772;13.6;4.7
11;2021-04-10;28960;19776;1697586;595548;13.8;4.9
11;2021-04-11;6548;7236;1704134;602784;13.9;4.9
11;2021-04-12;30297;19342;1734431;622126;14.1;5.1
11;2021-04-13;37294;27666;1771725;649792;14.4;5.3
11;2021-04-14;34996;24427;1806721;674219;14.7;5.5
11;2021-04-15;39155;28596;1845876;702815;15.0;5.7
11;2021-04-16;41024;27908;1886900;730723;15.4;6.0
11;2021-04-17;22785;15039;1909685;745762;15.6;6.1
11;2021-04-18;5297;3745;1914982;749507;15.6;6.1
11;2021-04-19;25082;23262;1940064;772769;15.8;6.3
11;2021-04-20;30575;27979;1970639;800748;16.0;6.5
11;2021-04-21;32229;28291;2002868;829039;16.3;6.8
11;2021-04-22;34486;34831;2037354;863870;16.6;7.0
11;2021-04-23;37938;32420;2075292;896290;16.9;7.3
11;2021-04-24;37954;23253;2113246;919543;17.2;7.5
11;2021-04-25;20515;8035;2133761;927578;17.4;7.6
11;2021-04-26;33866;25308;2167627;952886;17.7;7.8
11;2021-04-27;45732;30193;2213359;983079;18.0;8.0
11;2021-04-28;48408;29930;2261767;1013009;18.4;8.3
11;2021-04-29;57778;32425;2319545;1045434;18.9;8.5
11;2021-04-30;61302;31215;2380847;1076649;19.4;8.8
11;2021-05-01;24095;6067;2404942;1082716;19.6;8.8
11;2021-05-02;14625;5037;2419567;1087753;19.7;8.9
11;2021-05-03;54393;35352;2473960;1123105;20.1;9.1
11;2021-05-04;59710;34026;2533670;1157131;20.6;9.4
11;2021-05-05;60310;34218;2593980;1191349;21.1;9.7
11;2021-05-06;67238;38177;2661218;1229526;21.7;10.0
11;2021-05-07;65557;40118;2726775;1269644;22.2;10.3
11;2021-05-08;51150;16999;2777925;1286643;22.6;10.5
11;2021-05-09;33177;10247;2811102;1296890;22.9;10.6
11;2021-05-10;70769;30685;2881871;1327575;23.5;10.8
11;2021-05-11;81806;38209;2963677;1365784;24.1;11.1
11;2021-05-12;83600;32581;3047277;1398365;24.8;11.4
11;2021-05-13;68172;10083;3115449;1408448;25.4;11.5
11;2021-05-14;84596;22251;3200045;1430699;26.1;11.7
11;2021-05-15;66747;15499;3266792;1446198;26.6;11.8
11;2021-05-16;36659;5218;3303451;1451416;26.9;11.8
11;2021-05-17;82660;16984;3386111;1468400;27.6;12.0
11;2021-05-18;98628;19994;3484739;1488394;28.4;12.1
11;2021-05-19;97890;27917;3582629;1516311;29.2;12.3
11;2021-05-20;106574;28886;3689203;1545197;30.0;12.6
11;2021-05-21;101008;26081;3790211;1571278;30.9;12.8
11;2021-05-22;79494;14923;3869705;1586201;31.5;12.9
11;2021-05-23;41688;6094;3911393;1592295;31.9;13.0
11;2021-05-24;59637;8826;3971030;1601121;32.3;13.0
11;2021-05-25;85351;32296;4056381;1633417;33.0;13.3
11;2021-05-26;83872;32576;4140253;1665993;33.7;13.6
11;2021-05-27;92096;40638;4232349;1706631;34.5;13.9
11;2021-05-28;86717;45687;4319066;1752318;35.2;14.3
11;2021-05-29;68128;27609;4387194;1779927;35.7;14.5
11;2021-05-30;35912;8537;4423106;1788464;36.0;14.6
11;2021-05-31;77828;40026;4500934;1828490;36.7;14.9
11;2021-06-01;86785;51017;4587719;1879507;37.4;15.3
11;2021-06-02;82918;45622;4670637;1925129;38.0;15.7
11;2021-06-03;88706;53767;4759343;1978896;38.8;16.1
11;2021-06-04;84529;58826;4843872;2037722;39.5;16.6
11;2021-06-05;63502;49980;4907374;2087702;40.0;17.0
11;2021-06-06;37869;17601;4945243;2105303;40.3;17.1
11;2021-06-07;68806;53688;5014049;2158991;40.8;17.6
11;2021-06-08;72154;61936;5086203;2220927;41.4;18.1
11;2021-06-09;70404;63152;5156607;2284079;42.0;18.6
11;2021-06-10;70875;80865;5227482;2364944;42.6;19.3
11;2021-06-11;65468;72148;5292950;2437092;43.1;19.8
11;2021-06-12;63647;47701;5356597;2484793;43.6;20.2
11;2021-06-13;29511;22882;5386108;2507675;43.9;20.4
11;2021-06-14;43119;75292;5429227;2582967;44.2;21.0
11;2021-06-15;50996;82965;5480223;2665932;44.6;21.7
11;2021-06-16;52279;78272;5532502;2744204;45.1;22.4
11;2021-06-17;53957;81763;5586459;2825967;45.5;23.0
11;2021-06-18;49861;96009;5636320;2921976;45.9;23.8
11;2021-06-19;43443;69195;5679763;2991171;46.3;24.4
11;2021-06-20;16287;36067;5696050;3027238;46.4;24.7
11;2021-06-21;34298;84355;5730348;3111593;46.7;25.3
11;2021-06-22;38891;101170;5769239;3212763;47.0;26.2
11;2021-06-23;39353;98170;5808592;3310933;47.3;27.0
11;2021-06-24;42094;96047;5850686;3406980;47.7;27.7
11;2021-06-25;38282;110606;5888968;3517586;48.0;28.6
11;2021-06-26;35149;85964;5924117;3603550;48.2;29.3
11;2021-06-27;13254;40331;5937371;3643881;48.4;29.7
24;2020-12-27;0;0;0;0;0.0;0.0
24;2020-12-28;17;0;17;0;0.0;0.0
24;2020-12-29;10;0;27;0;0.0;0.0
24;2020-12-30;1;0;28;0;0.0;0.0
24;2020-12-31;0;0;28;0;0.0;0.0
24;2021-01-01;1;0;29;0;0.0;0.0
24;2021-01-02;0;0;29;0;0.0;0.0
24;2021-01-03;0;0;29;0;0.0;0.0
24;2021-01-04;24;0;53;0;0.0;0.0
24;2021-01-05;163;0;216;0;0.0;0.0
24;2021-01-06;328;0;544;0;0.0;0.0
24;2021-01-07;492;1;1036;1;0.0;0.0
24;2021-01-08;952;2;1988;3;0.1;0.0
24;2021-01-09;504;0;2492;3;0.1;0.0
24;2021-01-10;395;0;2887;3;0.1;0.0
24;2021-01-11;1279;1;4166;4;0.2;0.0
24;2021-01-12;2575;9;6741;13;0.3;0.0
24;2021-01-13;2189;8;8930;21;0.3;0.0
24;2021-01-14;2503;52;11433;73;0.4;0.0
24;2021-01-15;2114;8;13547;81;0.5;0.0
24;2021-01-16;857;5;14404;86;0.6;0.0
24;2021-01-17;322;3;14726;89;0.6;0.0
24;2021-01-18;3214;16;17940;105;0.7;0.0
24;2021-01-19;6325;18;24265;123;0.9;0.0
24;2021-01-20;7166;10;31431;133;1.2;0.0
24;2021-01-21;7418;4;38849;137;1.5;0.0
24;2021-01-22;5118;4;43967;141;1.7;0.0
24;2021-01-23;1275;1;45242;142;1.8;0.0
24;2021-01-24;225;1;45467;143;1.8;0.0
24;2021-01-25;3113;24;48580;167;1.9;0.0
24;2021-01-26;4849;88;53429;255;2.1;0.0
24;2021-01-27;5045;184;58474;439;2.3;0.0
24;2021-01-28;5634;508;64108;947;2.5;0.0
24;2021-01-29;3422;731;67530;1678;2.6;0.1
24;2021-01-30;1207;398;68737;2076;2.7;0.1
24;2021-01-31;251;368;68988;2444;2.7;0.1
24;2021-02-01;2170;928;71158;3372;2.8;0.1
24;2021-02-02;3032;1891;74190;5263;2.9;0.2
24;2021-02-03;3110;1768;77300;7031;3.0;0.3
24;2021-02-04;3234;1618;80534;8649;3.1;0.3
24;2021-02-05;2394;1370;82928;10019;3.2;0.4
24;2021-02-06;707;263;83635;10282;3.3;0.4
24;2021-02-07;134;32;83769;10314;3.3;0.4
24;2021-02-08;1967;1571;85736;11885;3.4;0.5
24;2021-02-09;3412;3320;89148;15205;3.5;0.6
24;2021-02-10;4085;3756;93233;18961;3.6;0.7
24;2021-02-11;4655;4775;97888;23736;3.8;0.9
24;2021-02-12;3481;3272;101369;27008;4.0;1.1
24;2021-02-13;839;770;102208;27778;4.0;1.1
24;2021-02-14;426;256;102634;28034;4.0;1.1
24;2021-02-15;1963;2861;104597;30895;4.1;1.2
24;2021-02-16;2848;4498;107445;35393;4.2;1.4
24;2021-02-17;2690;5106;110135;40499;4.3;1.6
24;2021-02-18;3519;5175;113654;45674;4.4;1.8
24;2021-02-19;3200;3557;116854;49231;4.6;1.9
24;2021-02-20;1288;985;118142;50216;4.6;2.0
24;2021-02-21;433;239;118575;50455;4.6;2.0
24;2021-02-22;1650;3061;120225;53516;4.7;2.1
24;2021-02-23;2340;3139;122565;56655;4.8;2.2
24;2021-02-24;2093;3467;124658;60122;4.9;2.3
24;2021-02-25;3620;3167;128278;63289;5.0;2.5
24;2021-02-26;4466;2622;132744;65911;5.2;2.6
24;2021-02-27;1877;995;134621;66906;5.3;2.6
24;2021-02-28;97;219;134718;67125;5.3;2.6
24;2021-03-01;2172;2024;136890;69149;5.3;2.7
24;2021-03-02;3430;2893;140320;72042;5.5;2.8
24;2021-03-03;3548;3411;143868;75453;5.6;2.9
24;2021-03-04;5336;3720;149204;79173;5.8;3.1
24;2021-03-05;7037;3177;156241;82350;6.1;3.2
24;2021-03-06;7375;751;163616;83101;6.4;3.2
24;2021-03-07;2429;289;166045;83390;6.5;3.3
24;2021-03-08;2689;2624;168734;86014;6.6;3.4
24;2021-03-09;5778;2849;174512;88863;6.8;3.5
24;2021-03-10;6407;3528;180919;92391;7.1;3.6
24;2021-03-11;7802;3514;188721;95905;7.4;3.7
24;2021-03-12;10787;2694;199508;98599;7.8;3.9
24;2021-03-13;7118;722;206626;99321;8.1;3.9
24;2021-03-14;1549;270;208175;99591;8.1;3.9
24;2021-03-15;4559;1976;212734;101567;8.3;4.0
24;2021-03-16;4595;2370;217329;103937;8.5;4.1
24;2021-03-17;4462;1986;221791;105923;8.7;4.1
24;2021-03-18;5063;2093;226854;108016;8.9;4.2
24;2021-03-19;7776;1683;234630;109699;9.2;4.3
24;2021-03-20;4432;882;239062;110581;9.3;4.3
24;2021-03-21;557;349;239619;110930;9.4;4.3
24;2021-03-22;4860;1718;244479;112648;9.6;4.4
24;2021-03-23;8037;2295;252516;114943;9.9;4.5
24;2021-03-24;8815;2014;261331;116957;10.2;4.6
24;2021-03-25;12139;1964;273470;118921;10.7;4.6
24;2021-03-26;13272;1993;286742;120914;11.2;4.7
24;2021-03-27;5778;676;292520;121590;11.4;4.8
24;2021-03-28;520;97;293040;121687;11.5;4.8
24;2021-03-29;6760;1878;299800;123565;11.7;4.8
24;2021-03-30;10173;2795;309973;126360;12.1;4.9
24;2021-03-31;9890;2348;319863;128708;12.5;5.0
24;2021-04-01;12041;3399;331904;132107;13.0;5.2
24;2021-04-02;10621;3346;342525;135453;13.4;5.3
24;2021-04-03;3412;1717;345937;137170;13.5;5.4
24;2021-04-04;394;344;346331;137514;13.5;5.4
24;2021-04-05;396;51;346727;137565;13.5;5.4
24;2021-04-06;8314;3421;355041;140986;13.9;5.5
24;2021-04-07;11062;4555;366103;145541;14.3;5.7
24;2021-04-08;14180;4755;380283;150296;14.9;5.9
24;2021-04-09;17747;3723;398030;154019;15.6;6.0
24;2021-04-10;9383;2084;407413;156103;15.9;6.1
24;2021-04-11;2909;1248;410322;157351;16.0;6.1
24;2021-04-12;10842;3448;421164;160799;16.5;6.3
24;2021-04-13;14989;4824;436153;165623;17.0;6.5
24;2021-04-14;13459;4931;449612;170554;17.6;6.7
24;2021-04-15;15336;5130;464948;175684;18.2;6.9
24;2021-04-16;15669;4342;480617;180026;18.8;7.0
24;2021-04-17;8192;1323;488809;181349;19.1;7.1
24;2021-04-18;1100;286;489909;181635;19.1;7.1
24;2021-04-19;9439;4144;499348;185779;19.5;7.3
24;2021-04-20;12721;5978;512069;191757;20.0;7.5
24;2021-04-21;12326;6001;524395;197758;20.5;7.7
24;2021-04-22;13861;7539;538256;205297;21.0;8.0
24;2021-04-23;13694;7047;551950;212344;21.6;8.3
24;2021-04-24;10238;3253;562188;215597;22.0;8.4
24;2021-04-25;3048;433;565236;216030;22.1;8.4
24;2021-04-26;10202;5428;575438;221458;22.5;8.7
24;2021-04-27;13875;7754;589313;229212;23.0;9.0
24;2021-04-28;13019;8456;602332;237668;23.5;9.3
24;2021-04-29;16580;8590;618912;246258;24.2;9.6
24;2021-04-30;17470;7239;636382;253497;24.9;9.9
24;2021-05-01;2911;671;639293;254168;25.0;9.9
24;2021-05-02;2140;320;641433;254488;25.1;9.9
24;2021-05-03;11285;6115;652718;260603;25.5;10.2
24;2021-05-04;12801;10292;665519;270895;26.0;10.6
24;2021-05-05;13873;9579;679392;280474;26.5;11.0
24;2021-05-06;17476;9670;696868;290144;27.2;11.3
24;2021-05-07;14537;11988;711405;302132;27.8;11.8
24;2021-05-08;3706;2375;715111;304507;27.9;11.9
24;2021-05-09;2326;3730;717437;308237;28.0;12.0
24;2021-05-10;11511;12198;728948;320435;28.5;12.5
24;2021-05-11;16354;14204;745302;334639;29.1;13.1
24;2021-05-12;18219;13155;763521;347794;29.8;13.6
24;2021-05-13;6923;3169;770444;350963;30.1;13.7
24;2021-05-14;14509;9181;784953;360144;30.7;14.1
24;2021-05-15;10468;5054;795421;365198;31.1;14.3
24;2021-05-16;3166;1188;798587;366386;31.2;14.3
24;2021-05-17;13300;7662;811887;374048;31.7;14.6
24;2021-05-18;18397;8209;830284;382257;32.4;14.9
24;2021-05-19;19012;7499;849296;389756;33.2;15.2
24;2021-05-20;21301;8430;870597;398186;34.0;15.6
24;2021-05-21;18371;9086;888968;407272;34.7;15.9
24;2021-05-22;7621;4189;896589;411461;35.0;16.1
24;2021-05-23;2981;942;899570;412403;35.2;16.1
24;2021-05-24;8333;1593;907903;413996;35.5;16.2
24;2021-05-25;17730;8854;925633;422850;36.2;16.5
24;2021-05-26;19244;8293;944877;431143;36.9;16.8
24;2021-05-27;20875;10037;965752;441180;37.7;17.2
24;2021-05-28;20441;12263;986193;453443;38.5;17.7
24;2021-05-29;12413;5902;998606;459345;39.0;17.9
24;2021-05-30;2032;1485;1000638;460830;39.1;18.0
24;2021-05-31;14575;8907;1015213;469737;39.7;18.4
24;2021-06-01;19676;12021;1034889;481758;40.4;18.8
24;2021-06-02;17742;10795;1052631;492553;41.1;19.2
24;2021-06-03;20854;11909;1073485;504462;41.9;19.7
24;2021-06-04;19923;13852;1093408;518314;42.7;20.3
24;2021-06-05;9863;8854;1103271;527168;43.1;20.6
24;2021-06-06;1992;3020;1105263;530188;43.2;20.7
24;2021-06-07;14410;12016;1119673;542204;43.8;21.2
24;2021-06-08;16056;14953;1135729;557157;44.4;21.8
24;2021-06-09;16452;12763;1152181;569920;45.0;22.3
24;2021-06-10;17860;12107;1170041;582027;45.7;22.7
24;2021-06-11;17156;15303;1187197;597330;46.4;23.3
24;2021-06-12;10069;7332;1197266;604662;46.8;23.6
24;2021-06-13;892;1313;1198158;605975;46.8;23.7
24;2021-06-14;10446;15264;1208604;621239;47.2;24.3
24;2021-06-15;12964;17118;1221568;638357;47.7;24.9
24;2021-06-16;13435;16272;1235003;654629;48.3;25.6
24;2021-06-17;13104;17309;1248107;671938;48.8;26.3
24;2021-06-18;14521;19822;1262628;691760;49.3;27.0
24;2021-06-19;7921;6653;1270549;698413;49.6;27.3
24;2021-06-20;554;858;1271103;699271;49.7;27.3
24;2021-06-21;8831;16478;1279934;715749;50.0;28.0
24;2021-06-22;10187;19408;1290121;735157;50.4;28.7
24;2021-06-23;9690;17854;1299811;753011;50.8;29.4
24;2021-06-24;8960;12866;1308771;765877;51.1;29.9
24;2021-06-25;10567;19862;1319338;785739;51.6;30.7
24;2021-06-26;5253;10957;1324591;796696;51.8;31.1
24;2021-06-27;795;2214;1325386;798910;51.8;31.2
27;2020-12-27;4;0;4;0;0.0;0.0
27;2020-12-28;0;0;4;0;0.0;0.0
27;2020-12-29;19;0;23;0;0.0;0.0
27;2020-12-30;20;0;43;0;0.0;0.0
27;2020-12-31;2;0;45;0;0.0;0.0
27;2021-01-01;0;0;45;0;0.0;0.0
27;2021-01-02;1;0;46;0;0.0;0.0
27;2021-01-03;1;0;47;0;0.0;0.0
27;2021-01-04;27;0;74;0;0.0;0.0
27;2021-01-05;263;2;337;2;0.0;0.0
27;2021-01-06;718;1;1055;3;0.0;0.0
27;2021-01-07;1581;3;2636;6;0.1;0.0
27;2021-01-08;1896;4;4532;10;0.2;0.0
27;2021-01-09;689;0;5221;10;0.2;0.0
27;2021-01-10;3;0;5224;10;0.2;0.0
27;2021-01-11;2420;3;7644;13;0.3;0.0
27;2021-01-12;3823;4;11467;17;0.4;0.0
27;2021-01-13;3848;8;15315;25;0.6;0.0
27;2021-01-14;4752;48;20067;73;0.7;0.0
27;2021-01-15;3593;22;23660;95;0.9;0.0
27;2021-01-16;793;11;24453;106;0.9;0.0
27;2021-01-17;116;1;24569;107;0.9;0.0
27;2021-01-18;6251;19;30820;126;1.1;0.0
27;2021-01-19;8398;23;39218;149;1.4;0.0
27;2021-01-20;7906;59;47124;208;1.7;0.0
27;2021-01-21;9454;22;56578;230;2.0;0.0
27;2021-01-22;7707;17;64285;247;2.3;0.0
27;2021-01-23;2986;6;67271;253;2.4;0.0
27;2021-01-24;347;0;67618;253;2.4;0.0
27;2021-01-25;5220;30;72838;283;2.6;0.0
27;2021-01-26;7390;229;80228;512;2.9;0.0
27;2021-01-27;7096;355;87324;867;3.1;0.0
27;2021-01-28;6335;896;93659;1763;3.4;0.1
27;2021-01-29;5930;1267;99589;3030;3.6;0.1
27;2021-01-30;2496;347;102085;3377;3.7;0.1
27;2021-01-31;252;22;102337;3399;3.7;0.1
27;2021-02-01;3359;1403;105696;4802;3.8;0.2
27;2021-02-02;4040;2225;109736;7027;3.9;0.3
27;2021-02-03;3618;2397;113354;9424;4.1;0.3
27;2021-02-04;3703;3152;117057;12576;4.2;0.5
27;2021-02-05;3240;2588;120297;15164;4.3;0.5
27;2021-02-06;1608;672;121905;15836;4.4;0.6
27;2021-02-07;5;87;121910;15923;4.4;0.6
27;2021-02-08;2911;2686;124821;18609;4.5;0.7
27;2021-02-09;3015;3662;127836;22271;4.6;0.8
27;2021-02-10;3055;3413;130891;25684;4.7;0.9
27;2021-02-11;3316;4653;134207;30337;4.8;1.1
27;2021-02-12;2726;4464;136933;34801;4.9;1.3
27;2021-02-13;986;1467;137919;36268;5.0;1.3
27;2021-02-14;258;301;138177;36569;5.0;1.3
27;2021-02-15;1239;5759;139416;42328;5.0;1.5
27;2021-02-16;1507;7440;140923;49768;5.1;1.8
27;2021-02-17;1807;6918;142730;56686;5.1;2.0
27;2021-02-18;2147;6472;144877;63158;5.2;2.3
27;2021-02-19;1736;5673;146613;68831;5.3;2.5
27;2021-02-20;712;2180;147325;71011;5.3;2.6
27;2021-02-21;2;280;147327;71291;5.3;2.6
27;2021-02-22;978;4902;148305;76193;5.3;2.7
27;2021-02-23;1203;5449;149508;81642;5.4;2.9
27;2021-02-24;1508;4871;151016;86513;5.4;3.1
27;2021-02-25;2921;5066;153937;91579;5.5;3.3
27;2021-02-26;3684;4221;157621;95800;5.7;3.4
27;2021-02-27;1911;1959;159532;97759;5.7;3.5
27;2021-02-28;107;282;159639;98041;5.7;3.5
27;2021-03-01;3669;3513;163308;101554;5.9;3.6
27;2021-03-02;5410;4344;168718;105898;6.1;3.8
27;2021-03-03;5962;3575;174680;109473;6.3;3.9
27;2021-03-04;7707;3573;182387;113046;6.6;4.1
27;2021-03-05;9699;3200;192086;116246;6.9;4.2
27;2021-03-06;6227;1086;198313;117332;7.1;4.2
27;2021-03-07;872;187;199185;117519;7.2;4.2
27;2021-03-08;4542;3426;203727;120945;7.3;4.3
27;2021-03-09;8421;3402;212148;124347;7.6;4.5
27;2021-03-10;8719;2817;220867;127164;7.9;4.6
27;2021-03-11;10266;3209;231133;130373;8.3;4.7
27;2021-03-12;11893;2475;243026;132848;8.7;4.8
27;2021-03-13;7049;699;250075;133547;9.0;4.8
27;2021-03-14;213;60;250288;133607;9.0;4.8
27;2021-03-15;7321;1384;257609;134991;9.3;4.9
27;2021-03-16;8247;1091;265856;136082;9.6;4.9
27;2021-03-17;8536;1182;274392;137264;9.9;4.9
27;2021-03-18;8626;1420;283018;138684;10.2;5.0
27;2021-03-19;9443;1098;292461;139782;10.5;5.0
27;2021-03-20;5670;399;298131;140181;10.7;5.0
27;2021-03-21;238;11;298369;140192;10.7;5.0
27;2021-03-22;9335;962;307704;141154;11.1;5.1
27;2021-03-23;14721;1199;322425;142353;11.6;5.1
27;2021-03-24;15185;1254;337610;143607;12.1;5.2
27;2021-03-25;18383;1468;355993;145075;12.8;5.2
27;2021-03-26;18392;1270;374385;146345;13.5;5.3
27;2021-03-27;7684;412;382069;146757;13.7;5.3
27;2021-03-28;492;124;382561;146881;13.7;5.3
27;2021-03-29;10030;3404;392591;150285;14.1;5.4
27;2021-03-30;12969;4013;405560;154298;14.6;5.5
27;2021-03-31;12835;4213;418395;158511;15.0;5.7
27;2021-04-01;14551;4149;432946;162660;15.6;5.8
27;2021-04-02;12953;4054;445899;166714;16.0;6.0
27;2021-04-03;4478;1137;450377;167851;16.2;6.0
27;2021-04-04;69;35;450446;167886;16.2;6.0
27;2021-04-05;345;7;450791;167893;16.2;6.0
27;2021-04-06;9560;6184;460351;174077;16.5;6.3
27;2021-04-07;10193;6470;470544;180547;16.9;6.5
27;2021-04-08;15726;6155;486270;186702;17.5;6.7
27;2021-04-09;17836;6005;504106;192707;18.1;6.9
27;2021-04-10;6068;1950;510174;194657;18.3;7.0
27;2021-04-11;420;83;510594;194740;18.3;7.0
27;2021-04-12;9062;6800;519656;201540;18.7;7.2
27;2021-04-13;11742;8511;531398;210051;19.1;7.5
27;2021-04-14;10289;7840;541687;217891;19.5;7.8
27;2021-04-15;12958;7669;554645;225560;19.9;8.1
27;2021-04-16;12753;6448;567398;232008;20.4;8.3
27;2021-04-17;5920;3037;573318;235045;20.6;8.4
27;2021-04-18;354;189;573672;235234;20.6;8.5
27;2021-04-19;6969;8859;580641;244093;20.9;8.8
27;2021-04-20;8476;10535;589117;254628;21.2;9.1
27;2021-04-21;8338;10143;597455;264771;21.5;9.5
27;2021-04-22;9854;11532;607309;276303;21.8;9.9
27;2021-04-23;11333;10300;618642;286603;22.2;10.3
27;2021-04-24;5165;3958;623807;290561;22.4;10.4
27;2021-04-25;440;294;624247;290855;22.4;10.5
27;2021-04-26;9539;8751;633786;299606;22.8;10.8
27;2021-04-27;13457;10249;647243;309855;23.3;11.1
27;2021-04-28;14189;10356;661432;320211;23.8;11.5
27;2021-04-29;17871;11524;679303;331735;24.4;11.9
27;2021-04-30;18721;9488;698024;341223;25.1;12.3
27;2021-05-01;5426;1544;703450;342767;25.3;12.3
27;2021-05-02;602;73;704052;342840;25.3;12.3
27;2021-05-03;14900;6321;718952;349161;25.8;12.5
27;2021-05-04;13939;10792;732891;359953;26.3;12.9
27;2021-05-05;15555;10016;748446;369969;26.9;13.3
27;2021-05-06;18271;12329;766717;382298;27.5;13.7
27;2021-05-07;17217;11750;783934;394048;28.2;14.2
27;2021-05-08;5947;1507;789881;395555;28.4;14.2
27;2021-05-09;533;439;790414;395994;28.4;14.2
27;2021-05-10;15267;9873;805681;405867;28.9;14.6
27;2021-05-11;20747;12887;826428;418754;29.7;15.0
27;2021-05-12;19658;11742;846086;430496;30.4;15.5
27;2021-05-13;12292;2036;858378;432532;30.8;15.5
27;2021-05-14;22922;8383;881300;440915;31.7;15.8
27;2021-05-15;15411;3398;896711;444313;32.2;16.0
27;2021-05-16;1888;235;898599;444548;32.3;16.0
27;2021-05-17;18940;6784;917539;451332;33.0;16.2
27;2021-05-18;20551;9280;938090;460612;33.7;16.6
27;2021-05-19;22212;7282;960302;467894;34.5;16.8
27;2021-05-20;23179;8191;983481;476085;35.3;17.1
27;2021-05-21;21073;10037;1004554;486122;36.1;17.5
27;2021-05-22;8261;3598;1012815;489720;36.4;17.6
27;2021-05-23;903;305;1013718;490025;36.4;17.6
27;2021-05-24;4227;1081;1017945;491106;36.6;17.6
27;2021-05-25;14853;11615;1032798;502721;37.1;18.1
27;2021-05-26;15351;10638;1048149;513359;37.7;18.4
27;2021-05-27;18378;11801;1066527;525160;38.3;18.9
27;2021-05-28;16063;14115;1082590;539275;38.9;19.4
27;2021-05-29;6810;5153;1089400;544428;39.1;19.6
27;2021-05-30;391;255;1089791;544683;39.2;19.6
27;2021-05-31;13304;10927;1103095;555610;39.6;20.0
27;2021-06-01;16507;13430;1119602;569040;40.2;20.4
27;2021-06-02;16148;11442;1135750;580482;40.8;20.9
27;2021-06-03;17728;11856;1153478;592338;41.4;21.3
27;2021-06-04;16158;14614;1169636;606952;42.0;21.8
27;2021-06-05;8338;6756;1177974;613708;42.3;22.1
27;2021-06-06;1716;645;1179690;614353;42.4;22.1
27;2021-06-07;17423;13086;1197113;627439;43.0;22.5
27;2021-06-08;19644;15317;1216757;642756;43.7;23.1
27;2021-06-09;19027;12486;1235784;655242;44.4;23.5
27;2021-06-10;18985;13890;1254769;669132;45.1;24.0
27;2021-06-11;18098;17077;1272867;686209;45.7;24.7
27;2021-06-12;9468;7837;1282335;694046;46.1;24.9
27;2021-06-13;942;947;1283277;694993;46.1;25.0
27;2021-06-14;11052;17037;1294329;712030;46.5;25.6
27;2021-06-15;14125;17619;1308454;729649;47.0;26.2
27;2021-06-16;14673;15599;1323127;745248;47.5;26.8
27;2021-06-17;15148;17240;1338275;762488;48.1;27.4
27;2021-06-18;14765;20170;1353040;782658;48.6;28.1
27;2021-06-19;7652;8651;1360692;791309;48.9;28.4
27;2021-06-20;170;457;1360862;791766;48.9;28.4
27;2021-06-21;7748;19014;1368610;810780;49.2;29.1
27;2021-06-22;9549;24239;1378159;835019;49.5;30.0
27;2021-06-23;11238;19284;1389397;854303;49.9;30.7
27;2021-06-24;10443;17949;1399840;872252;50.3;31.3
27;2021-06-25;9252;26956;1409092;899208;50.6;32.3
27;2021-06-26;5047;15781;1414139;914989;50.8;32.9
27;2021-06-27;663;1882;1414802;916871;50.8;32.9
28;2020-12-27;0;0;0;0;0.0;0.0
28;2020-12-28;1;0;1;0;0.0;0.0
28;2020-12-29;2;0;3;0;0.0;0.0
28;2020-12-30;0;0;3;0;0.0;0.0
28;2020-12-31;1;0;4;0;0.0;0.0
28;2021-01-01;2;0;6;0;0.0;0.0
28;2021-01-02;1;0;7;0;0.0;0.0
28;2021-01-03;1;0;8;0;0.0;0.0
28;2021-01-04;16;0;24;0;0.0;0.0
28;2021-01-05;169;0;193;0;0.0;0.0
28;2021-01-06;1393;2;1586;2;0.0;0.0
28;2021-01-07;2599;9;4185;11;0.1;0.0
28;2021-01-08;3428;3;7613;14;0.2;0.0
28;2021-01-09;1331;3;8944;17;0.3;0.0
28;2021-01-10;705;1;9649;18;0.3;0.0
28;2021-01-11;3179;4;12828;22;0.4;0.0
28;2021-01-12;3978;3;16806;25;0.5;0.0
28;2021-01-13;4302;7;21108;32;0.6;0.0
28;2021-01-14;8097;73;29205;105;0.9;0.0
28;2021-01-15;6219;25;35424;130;1.1;0.0
28;2021-01-16;2086;9;37510;139;1.1;0.0
28;2021-01-17;4071;24;41581;163;1.3;0.0
28;2021-01-18;8783;13;50364;176;1.5;0.0
28;2021-01-19;7142;13;57506;189;1.7;0.0
28;2021-01-20;6506;11;64012;200;1.9;0.0
28;2021-01-21;5992;9;70004;209;2.1;0.0
28;2021-01-22;5440;12;75444;221;2.3;0.0
28;2021-01-23;2020;8;77464;229;2.3;0.0
28;2021-01-24;1447;11;78911;240;2.4;0.0
28;2021-01-25;6239;179;85150;419;2.6;0.0
28;2021-01-26;4575;394;89725;813;2.7;0.0
28;2021-01-27;4034;765;93759;1578;2.8;0.0
28;2021-01-28;3755;1049;97514;2627;3.0;0.1
28;2021-01-29;3488;1306;101002;3933;3.1;0.1
28;2021-01-30;1386;517;102388;4450;3.1;0.1
28;2021-01-31;195;126;102583;4576;3.1;0.1
28;2021-02-01;2781;1661;105364;6237;3.2;0.2
28;2021-02-02;2985;2392;108349;8629;3.3;0.3
28;2021-02-03;2947;2671;111296;11300;3.4;0.3
28;2021-02-04;3726;5209;115022;16509;3.5;0.5
28;2021-02-05;3885;4393;118907;20902;3.6;0.6
28;2021-02-06;1140;1549;120047;22451;3.6;0.7
28;2021-02-07;715;1975;120762;24426;3.7;0.7
28;2021-02-08;3800;6863;124562;31289;3.8;0.9
28;2021-02-09;3459;6034;128021;37323;3.9;1.1
28;2021-02-10;3455;5077;131476;42400;4.0;1.3
28;2021-02-11;4208;4900;135684;47300;4.1;1.4
28;2021-02-12;4043;4616;139727;51916;4.2;1.6
28;2021-02-13;1124;1585;140851;53501;4.3;1.6
28;2021-02-14;285;1388;141136;54889;4.3;1.7
28;2021-02-15;2213;6287;143349;61176;4.3;1.9
28;2021-02-16;2654;5670;146003;66846;4.4;2.0
28;2021-02-17;1951;4557;147954;71403;4.5;2.2
28;2021-02-18;2569;4314;150523;75717;4.6;2.3
28;2021-02-19;2547;3723;153070;79440;4.6;2.4
28;2021-02-20;945;1260;154015;80700;4.7;2.4
28;2021-02-21;103;416;154118;81116;4.7;2.5
28;2021-02-22;1669;4234;155787;85350;4.7;2.6
28;2021-02-23;2173;3842;157960;89192;4.8;2.7
28;2021-02-24;2372;3899;160332;93091;4.9;2.8
28;2021-02-25;4771;4202;165103;97293;5.0;2.9
28;2021-02-26;5959;3744;171062;101037;5.2;3.1
28;2021-02-27;3008;1032;174070;102069;5.3;3.1
28;2021-02-28;340;387;174410;102456;5.3;3.1
28;2021-03-01;2524;4662;176934;107118;5.4;3.2
28;2021-03-02;3900;4104;180834;111222;5.5;3.4
28;2021-03-03;4789;3487;185623;114709;5.6;3.5
28;2021-03-04;7304;2863;192927;117572;5.8;3.6
28;2021-03-05;10145;2498;203072;120070;6.1;3.6
28;2021-03-06;9807;795;212879;120865;6.4;3.7
28;2021-03-07;3771;127;216650;120992;6.6;3.7
28;2021-03-08;5865;3278;222515;124270;6.7;3.8
28;2021-03-09;9283;2823;231798;127093;7.0;3.8
28;2021-03-10;9803;2444;241601;129537;7.3;3.9
28;2021-03-11;13960;2018;255561;131555;7.7;4.0
28;2021-03-12;17984;1556;273545;133111;8.3;4.0
28;2021-03-13;11147;526;284692;133637;8.6;4.0
28;2021-03-14;2259;99;286951;133736;8.7;4.0
28;2021-03-15;8644;869;295595;134605;8.9;4.1
28;2021-03-16;7488;1188;303083;135793;9.2;4.1
28;2021-03-17;7716;1189;310799;136982;9.4;4.1
28;2021-03-18;8163;1372;318962;138354;9.7;4.2
28;2021-03-19;11565;1460;330527;139814;10.0;4.2
28;2021-03-20;9667;539;340194;140353;10.3;4.2
28;2021-03-21;2409;22;342603;140375;10.4;4.2
28;2021-03-22;9385;1637;351988;142012;10.7;4.3
28;2021-03-23;12483;1513;364471;143525;11.0;4.3
28;2021-03-24;13251;1596;377722;145121;11.4;4.4
28;2021-03-25;17617;1814;395339;146935;12.0;4.4
28;2021-03-26;20826;1880;416165;148815;12.6;4.5
28;2021-03-27;11496;1126;427661;149941;12.9;4.5
28;2021-03-28;2966;91;430627;150032;13.0;4.5
28;2021-03-29;11765;2959;442392;152991;13.4;4.6
28;2021-03-30;14417;3072;456809;156063;13.8;4.7
28;2021-03-31;14391;3566;471200;159629;14.3;4.8
28;2021-04-01;18031;5552;489231;165181;14.8;5.0
28;2021-04-02;16806;6387;506037;171568;15.3;5.2
28;2021-04-03;6999;3965;513036;175533;15.5;5.3
28;2021-04-04;1776;801;514812;176334;15.6;5.3
28;2021-04-05;3288;737;518100;177071;15.7;5.4
28;2021-04-06;10807;7382;528907;184453;16.0;5.6
28;2021-04-07;12693;6957;541600;191410;16.4;5.8
28;2021-04-08;17660;7550;559260;198960;16.9;6.0
28;2021-04-09;23806;7842;583066;206802;17.6;6.3
28;2021-04-10;13827;4124;596893;210926;18.1;6.4
28;2021-04-11;3028;1194;599921;212120;18.2;6.4
28;2021-04-12;13770;8036;613691;220156;18.6;6.7
28;2021-04-13;16175;8053;629866;228209;19.1;6.9
28;2021-04-14;14308;8034;644174;236243;19.5;7.2
28;2021-04-15;17215;8403;661389;244646;20.0;7.4
28;2021-04-16;20266;7840;681655;252486;20.6;7.6
28;2021-04-17;12743;5030;694398;257516;21.0;7.8
28;2021-04-18;2287;1242;696685;258758;21.1;7.8
28;2021-04-19;10865;8872;707550;267630;21.4;8.1
28;2021-04-20;13901;9774;721451;277404;21.8;8.4
28;2021-04-21;13281;9998;734732;287402;22.2;8.7
28;2021-04-22;15286;11905;750018;299307;22.7;9.1
28;2021-04-23;16421;12321;766439;311628;23.2;9.4
28;2021-04-24;12580;7268;779019;318896;23.6;9.7
28;2021-04-25;3293;1915;782312;320811;23.7;9.7
28;2021-04-26;12534;10188;794846;330999;24.1;10.0
28;2021-04-27;14855;11739;809701;342738;24.5;10.4
28;2021-04-28;15042;10709;824743;353447;25.0;10.7
28;2021-04-29;18450;11766;843193;365213;25.5;11.1
28;2021-04-30;20369;11898;863562;377111;26.1;11.4
28;2021-05-01;12805;2973;876367;380084;26.5;11.5
28;2021-05-02;5985;1838;882352;381922;26.7;11.6
28;2021-05-03;12851;10004;895203;391926;27.1;11.9
28;2021-05-04;13810;13134;909013;405060;27.5;12.3
28;2021-05-05;13942;14470;922955;419530;27.9;12.7
28;2021-05-06;18302;15096;941257;434626;28.5;13.2
28;2021-05-07;17825;17378;959082;452004;29.0;13.7
28;2021-05-08;12623;4699;971705;456703;29.4;13.8
28;2021-05-09;7146;1825;978851;458528;29.6;13.9
28;2021-05-10;14196;14799;993047;473327;30.1;14.3
28;2021-05-11;18106;15341;1011153;488668;30.6;14.8
28;2021-05-12;18782;13974;1029935;502642;31.2;15.2
28;2021-05-13;19676;3735;1049611;506377;31.8;15.3
28;2021-05-14;26347;12523;1075958;518900;32.6;15.7
28;2021-05-15;26925;7102;1102883;526002;33.4;15.9
28;2021-05-16;14138;1575;1117021;527577;33.8;16.0
28;2021-05-17;16187;9433;1133208;537010;34.3;16.3
28;2021-05-18;21018;8759;1154226;545769;34.9;16.5
28;2021-05-19;20861;8475;1175087;554244;35.6;16.8
28;2021-05-20;23085;9655;1198172;563899;36.3;17.1
28;2021-05-21;21416;12069;1219588;575968;36.9;17.4
28;2021-05-22;17557;5983;1237145;581951;37.4;17.6
28;2021-05-23;9112;933;1246257;582884;37.7;17.6
28;2021-05-24;13395;3166;1259652;586050;38.1;17.7
28;2021-05-25;19129;11589;1278781;597639;38.7;18.1
28;2021-05-26;19255;10008;1298036;607647;39.3;18.4
28;2021-05-27;21696;12369;1319732;620016;39.9;18.8
28;2021-05-28;21590;16511;1341322;636527;40.6;19.3
28;2021-05-29;17546;10162;1358868;646689;41.1;19.6
28;2021-05-30;6266;1271;1365134;647960;41.3;19.6
28;2021-05-31;19852;11933;1384986;659893;41.9;20.0
28;2021-06-01;23693;13846;1408679;673739;42.6;20.4
28;2021-06-02;20792;12321;1429471;686060;43.3;20.8
28;2021-06-03;26449;14655;1455920;700715;44.1;21.2
28;2021-06-04;24560;18926;1480480;719641;44.8;21.8
28;2021-06-05;18351;12077;1498831;731718;45.4;22.1
28;2021-06-06;7663;2406;1506494;734124;45.6;22.2
28;2021-06-07;19213;14160;1525707;748284;46.2;22.7
28;2021-06-08;22611;15538;1548318;763822;46.9;23.1
28;2021-06-09;19728;14679;1568046;778501;47.5;23.6
28;2021-06-10;21187;14772;1589233;793273;48.1;24.0
28;2021-06-11;21010;21129;1610243;814402;48.7;24.7
28;2021-06-12;17910;17126;1628153;831528;49.3;25.2
28;2021-06-13;6337;5881;1634490;837409;49.5;25.3
28;2021-06-14;13879;17720;1648369;855129;49.9;25.9
28;2021-06-15;16202;18711;1664571;873840;50.4;26.5
28;2021-06-16;16666;18563;1681237;892403;50.9;27.0
28;2021-06-17;17227;20492;1698464;912895;51.4;27.6
28;2021-06-18;18488;24407;1716952;937302;52.0;28.4
28;2021-06-19;14788;15794;1731740;953096;52.4;28.9
28;2021-06-20;4980;5126;1736720;958222;52.6;29.0
28;2021-06-21;11314;20721;1748034;978943;52.9;29.6
28;2021-06-22;12723;23853;1760757;1002796;53.3;30.4
28;2021-06-23;11861;23571;1772618;1026367;53.7;31.1
28;2021-06-24;12598;24445;1785216;1050812;54.0;31.8
28;2021-06-25;12290;29392;1797506;1080204;54.4;32.7
28;2021-06-26;9175;23385;1806681;1103589;54.7;33.4
28;2021-06-27;2900;10100;1809581;1113689;54.8;33.7
32;2020-12-27;1;0;1;0;0.0;0.0
32;2020-12-28;26;0;27;0;0.0;0.0
32;2020-12-29;12;0;39;0;0.0;0.0
32;2020-12-30;0;0;39;0;0.0;0.0
32;2020-12-31;0;0;39;0;0.0;0.0
32;2021-01-01;1;0;40;0;0.0;0.0
32;2021-01-02;6;0;46;0;0.0;0.0
32;2021-01-03;4;0;50;0;0.0;0.0
32;2021-01-04;82;0;132;0;0.0;0.0
32;2021-01-05;300;0;432;0;0.0;0.0
32;2021-01-06;787;2;1219;2;0.0;0.0
32;2021-01-07;2431;4;3650;6;0.1;0.0
32;2021-01-08;3165;9;6815;15;0.1;0.0
32;2021-01-09;957;3;7772;18;0.1;0.0
32;2021-01-10;640;0;8412;18;0.1;0.0
32;2021-01-11;3269;6;11681;24;0.2;0.0
32;2021-01-12;5018;7;16699;31;0.3;0.0
32;2021-01-13;4942;11;21641;42;0.4;0.0
32;2021-01-14;5724;44;27365;86;0.5;0.0
32;2021-01-15;5224;26;32589;112;0.5;0.0
32;2021-01-16;1636;11;34225;123;0.6;0.0
32;2021-01-17;860;3;35085;126;0.6;0.0
32;2021-01-18;7233;21;42318;147;0.7;0.0
32;2021-01-19;9899;37;52217;184;0.9;0.0
32;2021-01-20;10353;30;62570;214;1.0;0.0
32;2021-01-21;12705;46;75275;260;1.3;0.0
32;2021-01-22;9878;28;85153;288;1.4;0.0
32;2021-01-23;3411;4;88564;292;1.5;0.0
32;2021-01-24;1119;3;89683;295;1.5;0.0
32;2021-01-25;6865;85;96548;380;1.6;0.0
32;2021-01-26;7447;182;103995;562;1.7;0.0
32;2021-01-27;4837;512;108832;1074;1.8;0.0
32;2021-01-28;8597;1691;117429;2765;2.0;0.0
32;2021-01-29;5383;1860;122812;4625;2.1;0.1
32;2021-01-30;534;413;123346;5038;2.1;0.1
32;2021-01-31;67;74;123413;5112;2.1;0.1
32;2021-02-01;191;1816;123604;6928;2.1;0.1
32;2021-02-02;786;3170;124390;10098;2.1;0.2
32;2021-02-03;4074;3190;128464;13288;2.2;0.2
32;2021-02-04;3683;3621;132147;16909;2.2;0.3
32;2021-02-05;1962;3279;134109;20188;2.2;0.3
32;2021-02-06;517;875;134626;21063;2.3;0.4
32;2021-02-07;539;100;135165;21163;2.3;0.4
32;2021-02-08;1865;3684;137030;24847;2.3;0.4
32;2021-02-09;2550;4369;139580;29216;2.3;0.5
32;2021-02-10;2984;5345;142564;34561;2.4;0.6
32;2021-02-11;4778;6199;147342;40760;2.5;0.7
32;2021-02-12;5092;4673;152434;45433;2.6;0.8
32;2021-02-13;939;1894;153373;47327;2.6;0.8
32;2021-02-14;116;711;153489;48038;2.6;0.8
32;2021-02-15;3613;6934;157102;54972;2.6;0.9
32;2021-02-16;4029;8243;161131;63215;2.7;1.1
32;2021-02-17;4303;8697;165434;71912;2.8;1.2
32;2021-02-18;7037;11447;172471;83359;2.9;1.4
32;2021-02-19;7083;8318;179554;91677;3.0;1.5
32;2021-02-20;2517;3017;182071;94694;3.1;1.6
32;2021-02-21;434;489;182505;95183;3.1;1.6
32;2021-02-22;3260;5336;185765;100519;3.1;1.7
32;2021-02-23;5504;5925;191269;106444;3.2;1.8
32;2021-02-24;7443;6069;198712;112513;3.3;1.9
32;2021-02-25;12832;5037;211544;117550;3.5;2.0
32;2021-02-26;12536;2895;224080;120445;3.8;2.0
32;2021-02-27;6486;319;230566;120764;3.9;2.0
32;2021-02-28;364;134;230930;120898;3.9;2.0
32;2021-03-01;7243;863;238173;121761;4.0;2.0
32;2021-03-02;10958;995;249131;122756;4.2;2.1
32;2021-03-03;11989;1744;261120;124500;4.4;2.1
32;2021-03-04;15096;2452;276216;126952;4.6;2.1
32;2021-03-05;17123;2116;293339;129068;4.9;2.2
32;2021-03-06;28092;1061;321431;130129;5.4;2.2
32;2021-03-07;19862;498;341293;130627;5.7;2.2
32;2021-03-08;8915;2570;350208;133197;5.9;2.2
32;2021-03-09;14284;3323;364492;136520;6.1;2.3
32;2021-03-10;15763;3234;380255;139754;6.4;2.3
32;2021-03-11;20923;4727;401178;144481;6.7;2.4
32;2021-03-12;26063;4257;427241;148738;7.2;2.5
32;2021-03-13;41590;2034;468831;150772;7.9;2.5
32;2021-03-14;20100;589;488931;151361;8.2;2.5
32;2021-03-15;13048;3601;501979;154962;8.4;2.6
32;2021-03-16;9791;3484;511770;158446;8.6;2.7
32;2021-03-17;9712;4137;521482;162583;8.7;2.7
32;2021-03-18;10013;5046;531495;167629;8.9;2.8
32;2021-03-19;17941;3822;549436;171451;9.2;2.9
32;2021-03-20;36493;1977;585929;173428;9.8;2.9
32;2021-03-21;19837;789;605766;174217;10.2;2.9
32;2021-03-22;12149;4293;617915;178510;10.4;3.0
32;2021-03-23;18911;5937;636826;184447;10.7;3.1
32;2021-03-24;17909;6162;654735;190609;11.0;3.2
32;2021-03-25;25285;5719;680020;196328;11.4;3.3
32;2021-03-26;28987;5914;709007;202242;11.9;3.4
32;2021-03-27;36662;2165;745669;204407;12.5;3.4
32;2021-03-28;18642;622;764311;205029;12.8;3.4
32;2021-03-29;14577;7045;778888;212074;13.1;3.6
32;2021-03-30;18861;8664;797749;220738;13.4;3.7
32;2021-03-31;15788;9314;813537;230052;13.6;3.9
32;2021-04-01;18211;11048;831748;241100;13.9;4.0
32;2021-04-02;19962;12574;851710;253674;14.3;4.3
32;2021-04-03;30026;10178;881736;263852;14.8;4.4
32;2021-04-04;11655;4733;893391;268585;15.0;4.5
32;2021-04-05;9589;2332;902980;270917;15.1;4.5
32;2021-04-06;14263;10885;917243;281802;15.4;4.7
32;2021-04-07;18073;12568;935316;294370;15.7;4.9
32;2021-04-08;23491;12966;958807;307336;16.1;5.2
32;2021-04-09;29908;13142;988715;320478;16.6;5.4
32;2021-04-10;26116;18810;1014831;339288;17.0;5.7
32;2021-04-11;9137;12011;1023968;351299;17.2;5.9
32;2021-04-12;15407;9507;1039375;360806;17.4;6.1
32;2021-04-13;21781;11579;1061156;372385;17.8;6.2
32;2021-04-14;22465;11127;1083621;383512;18.2;6.4
32;2021-04-15;25709;11129;1109330;394641;18.6;6.6
32;2021-04-16;25287;12446;1134617;407087;19.0;6.8
32;2021-04-17;17957;22987;1152574;430074;19.3;7.2
32;2021-04-18;6388;14043;1158962;444117;19.4;7.4
32;2021-04-19;11649;9809;1170611;453926;19.6;7.6
32;2021-04-20;16402;12277;1187013;466203;19.9;7.8
32;2021-04-21;15781;12569;1202794;478772;20.2;8.0
32;2021-04-22;19027;15000;1221821;493772;20.5;8.3
32;2021-04-23;19638;15968;1241459;509740;20.8;8.5
32;2021-04-24;15438;21026;1256897;530766;21.1;8.9
32;2021-04-25;6960;12289;1263857;543055;21.2;9.1
32;2021-04-26;13206;10725;1277063;553780;21.4;9.3
32;2021-04-27;18673;14109;1295736;567889;21.7;9.5
32;2021-04-28;20164;16025;1315900;583914;22.1;9.8
32;2021-04-29;22389;19932;1338289;603846;22.4;10.1
32;2021-04-30;24999;21567;1363288;625413;22.9;10.5
32;2021-05-01;23027;13938;1386315;639351;23.2;10.7
32;2021-05-02;20942;10339;1407257;649690;23.6;10.9
32;2021-05-03;21930;11294;1429187;660984;24.0;11.1
32;2021-05-04;23833;16275;1453020;677259;24.4;11.4
32;2021-05-05;23930;17415;1476950;694674;24.8;11.7
32;2021-05-06;25718;19877;1502668;714551;25.2;12.0
32;2021-05-07;30731;21498;1533399;736049;25.7;12.3
32;2021-05-08;34562;9054;1567961;745103;26.3;12.5
32;2021-05-09;26797;6506;1594758;751609;26.7;12.6
32;2021-05-10;24209;16121;1618967;767730;27.2;12.9
32;2021-05-11;31289;19032;1650256;786762;27.7;13.2
32;2021-05-12;37276;18815;1687532;805577;28.3;13.5
32;2021-05-13;40523;7339;1728055;812916;29.0;13.6
32;2021-05-14;41773;14617;1769828;827533;29.7;13.9
32;2021-05-15;59633;12192;1829461;839725;30.7;14.1
32;2021-05-16;47867;4873;1877328;844598;31.5;14.2
32;2021-05-17;31422;10944;1908750;855542;32.0;14.3
32;2021-05-18;36581;12452;1945331;867994;32.6;14.6
32;2021-05-19;38743;11536;1984074;879530;33.3;14.8
32;2021-05-20;39701;14901;2023775;894431;33.9;15.0
32;2021-05-21;42287;16963;2066062;911394;34.6;15.3
32;2021-05-22;57709;13063;2123771;924457;35.6;15.5
32;2021-05-23;38887;4389;2162658;928846;36.3;15.6
32;2021-05-24;28440;3827;2191098;932673;36.7;15.6
32;2021-05-25;31060;14876;2222158;947549;37.3;15.9
32;2021-05-26;34001;16759;2256159;964308;37.8;16.2
32;2021-05-27;34613;20671;2290772;984979;38.4;16.5
32;2021-05-28;34270;25154;2325042;1010133;39.0;16.9
32;2021-05-29;37392;19642;2362434;1029775;39.6;17.3
32;2021-05-30;16094;3515;2378528;1033290;39.9;17.3
32;2021-05-31;27878;16527;2406406;1049817;40.4;17.6
32;2021-06-01;32735;24019;2439141;1073836;40.9;18.0
32;2021-06-02;32200;21683;2471341;1095519;41.4;18.4
32;2021-06-03;34278;25062;2505619;1120581;42.0;18.8
32;2021-06-04;35839;27700;2541458;1148281;42.6;19.3
32;2021-06-05;34358;22771;2575816;1171052;43.2;19.6
32;2021-06-06;16514;5718;2592330;1176770;43.5;19.7
32;2021-06-07;21165;19354;2613495;1196124;43.8;20.1
32;2021-06-08;26254;24335;2639749;1220459;44.3;20.5
32;2021-06-09;24352;24380;2664101;1244839;44.7;20.9
32;2021-06-10;24940;26448;2689041;1271287;45.1;21.3
32;2021-06-11;26318;36052;2715359;1307339;45.5;21.9
32;2021-06-12;25954;31510;2741313;1338849;46.0;22.5
32;2021-06-13;11802;14806;2753115;1353655;46.2;22.7
32;2021-06-14;13214;28041;2766329;1381696;46.4;23.2
32;2021-06-15;19587;34592;2785916;1416288;46.7;23.8
32;2021-06-16;20470;32435;2806386;1448723;47.1;24.3
32;2021-06-17;21379;34937;2827765;1483660;47.4;24.9
32;2021-06-18;21533;42583;2849298;1526243;47.8;25.6
32;2021-06-19;22548;43809;2871846;1570052;48.2;26.3
32;2021-06-20;9213;19106;2881059;1589158;48.3;26.7
32;2021-06-21;11344;34842;2892403;1624000;48.5;27.2
32;2021-06-22;13646;41755;2906049;1665755;48.7;27.9
32;2021-06-23;14232;43502;2920281;1709257;49.0;28.7
32;2021-06-24;15275;45710;2935556;1754967;49.2;29.4
32;2021-06-25;14571;53317;2950127;1808284;49.5;30.3
32;2021-06-26;14785;59473;2964912;1867757;49.7;31.3
32;2021-06-27;7424;33843;2972336;1901600;49.8;31.9
44;2020-12-27;0;0;0;0;0.0;0.0
44;2020-12-28;0;0;0;0;0.0;0.0
44;2020-12-29;0;0;0;0;0.0;0.0
44;2020-12-30;0;0;0;0;0.0;0.0
44;2020-12-31;11;0;11;0;0.0;0.0
44;2021-01-01;1;0;12;0;0.0;0.0
44;2021-01-02;3;0;15;0;0.0;0.0
44;2021-01-03;3;0;18;0;0.0;0.0
44;2021-01-04;243;0;261;0;0.0;0.0
44;2021-01-05;770;0;1031;0;0.0;0.0
44;2021-01-06;1245;2;2276;2;0.0;0.0
44;2021-01-07;2425;4;4701;6;0.1;0.0
44;2021-01-08;3131;8;7832;14;0.1;0.0
44;2021-01-09;943;1;8775;15;0.2;0.0
44;2021-01-10;238;0;9013;15;0.2;0.0
44;2021-01-11;2983;8;11996;23;0.2;0.0
44;2021-01-12;5280;9;17276;32;0.3;0.0
44;2021-01-13;7663;18;24939;50;0.5;0.0
44;2021-01-14;9550;82;34489;132;0.6;0.0
44;2021-01-15;6698;27;41187;159;0.7;0.0
44;2021-01-16;1917;10;43104;169;0.8;0.0
44;2021-01-17;902;1;44006;170;0.8;0.0
44;2021-01-18;8717;26;52723;196;1.0;0.0
44;2021-01-19;10663;17;63386;213;1.2;0.0
44;2021-01-20;11028;45;74414;258;1.4;0.0
44;2021-01-21;11728;27;86142;285;1.6;0.0
44;2021-01-22;9631;30;95773;315;1.7;0.0
44;2021-01-23;3286;20;99059;335;1.8;0.0
44;2021-01-24;1568;5;100627;340;1.8;0.0
44;2021-01-25;6627;304;107254;644;1.9;0.0
44;2021-01-26;5643;435;112897;1079;2.0;0.0
44;2021-01-27;7374;602;120271;1681;2.2;0.0
44;2021-01-28;8820;1252;129091;2933;2.3;0.1
44;2021-01-29;6757;1802;135848;4735;2.5;0.1
44;2021-01-30;2549;496;138397;5231;2.5;0.1
44;2021-01-31;1252;55;139649;5286;2.5;0.1
44;2021-02-01;6382;2382;146031;7668;2.6;0.1
44;2021-02-02;6214;3812;152245;11480;2.8;0.2
44;2021-02-03;5596;4555;157841;16035;2.9;0.3
44;2021-02-04;6441;6970;164282;23005;3.0;0.4
44;2021-02-05;6389;5240;170671;28245;3.1;0.5
44;2021-02-06;1973;1207;172644;29452;3.1;0.5
44;2021-02-07;406;595;173050;30047;3.1;0.5
44;2021-02-08;3822;4471;176872;34518;3.2;0.6
44;2021-02-09;5718;5848;182590;40366;3.3;0.7
44;2021-02-10;6251;6049;188841;46415;3.4;0.8
44;2021-02-11;7061;6572;195902;52987;3.6;1.0
44;2021-02-12;7279;5556;203181;58543;3.7;1.1
44;2021-02-13;2545;1258;205726;59801;3.7;1.1
44;2021-02-14;1612;826;207338;60627;3.8;1.1
44;2021-02-15;3996;7218;211334;67845;3.8;1.2
44;2021-02-16;4564;7987;215898;75832;3.9;1.4
44;2021-02-17;4707;8554;220605;84386;4.0;1.5
44;2021-02-18;6029;9287;226634;93673;4.1;1.7
44;2021-02-19;5543;7516;232177;101189;4.2;1.8
44;2021-02-20;2339;2844;234516;104033;4.3;1.9
44;2021-02-21;541;1401;235057;105434;4.3;1.9
44;2021-02-22;4486;7034;239543;112468;4.3;2.0
44;2021-02-23;6027;7278;245570;119746;4.5;2.2
44;2021-02-24;6602;5950;252172;125696;4.6;2.3
44;2021-02-25;10529;7571;262701;133267;4.8;2.4
44;2021-02-26;12371;6377;275072;139644;5.0;2.5
44;2021-02-27;7888;2163;282960;141807;5.1;2.6
44;2021-02-28;2118;519;285078;142326;5.2;2.6
44;2021-03-01;6079;4676;291157;147002;5.3;2.7
44;2021-03-02;9389;5669;300546;152671;5.5;2.8
44;2021-03-03;11269;5596;311815;158267;5.7;2.9
44;2021-03-04;13263;5789;325078;164056;5.9;3.0
44;2021-03-05;17877;5695;342955;169751;6.2;3.1
44;2021-03-06;21348;2173;364303;171924;6.6;3.1
44;2021-03-07;12201;746;376504;172670;6.8;3.1
44;2021-03-08;9403;4262;385907;176932;7.0;3.2
44;2021-03-09;15191;4979;401098;181911;7.3;3.3
44;2021-03-10;16602;5190;417700;187101;7.6;3.4
44;2021-03-11;20344;5666;438044;192767;7.9;3.5
44;2021-03-12;26801;5526;464845;198293;8.4;3.6
44;2021-03-13;24213;2413;489058;200706;8.9;3.6
44;2021-03-14;6766;880;495824;201586;9.0;3.7
44;2021-03-15;12956;3475;508780;205061;9.2;3.7
44;2021-03-16;12834;3985;521614;209046;9.5;3.8
44;2021-03-17;14191;3640;535805;212686;9.7;3.9
44;2021-03-18;15408;3770;551213;216456;10.0;3.9
44;2021-03-19;21408;3897;572621;220353;10.4;4.0
44;2021-03-20;15560;1956;588181;222309;10.7;4.0
44;2021-03-21;4618;287;592799;222596;10.8;4.0
44;2021-03-22;12519;3918;605318;226514;11.0;4.1
44;2021-03-23;19436;5078;624754;231592;11.3;4.2
44;2021-03-24;22044;5193;646798;236785;11.7;4.3
44;2021-03-25;28186;5773;674984;242558;12.2;4.4
44;2021-03-26;30340;5488;705324;248046;12.8;4.5
44;2021-03-27;16226;4698;721550;252744;13.1;4.6
44;2021-03-28;4078;1976;725628;254720;13.2;4.6
44;2021-03-29;14307;6123;739935;260843;13.4;4.7
44;2021-03-30;21398;7830;761333;268673;13.8;4.9
44;2021-03-31;20112;8010;781445;276683;14.2;5.0
44;2021-04-01;23539;9341;804984;286024;14.6;5.2
44;2021-04-02;16233;6900;821217;292924;14.9;5.3
44;2021-04-03;10188;5765;831405;298689;15.1;5.4
44;2021-04-04;3133;1652;834538;300341;15.1;5.4
44;2021-04-05;4424;1415;838962;301756;15.2;5.5
44;2021-04-06;13408;10555;852370;312311;15.5;5.7
44;2021-04-07;17645;12109;870015;324420;15.8;5.9
44;2021-04-08;26009;12404;896024;336824;16.3;6.1
44;2021-04-09;32222;12747;928246;349571;16.8;6.3
44;2021-04-10;18245;10057;946491;359628;17.2;6.5
44;2021-04-11;3028;5967;949519;365595;17.2;6.6
44;2021-04-12;16951;11240;966470;376835;17.5;6.8
44;2021-04-13;21971;13772;988441;390607;17.9;7.1
44;2021-04-14;23098;14055;1011539;404662;18.4;7.3
44;2021-04-15;26263;15358;1037802;420020;18.8;7.6
44;2021-04-16;28085;15204;1065887;435224;19.3;7.9
44;2021-04-17;19815;9036;1085702;444260;19.7;8.1
44;2021-04-18;5049;4629;1090751;448889;19.8;8.1
44;2021-04-19;16925;11747;1107676;460636;20.1;8.4
44;2021-04-20;19103;14297;1126779;474933;20.4;8.6
44;2021-04-21;21122;14949;1147901;489882;20.8;8.9
44;2021-04-22;23690;15870;1171591;505752;21.3;9.2
44;2021-04-23;27795;16562;1199386;522314;21.8;9.5
44;2021-04-24;16970;9150;1216356;531464;22.1;9.6
44;2021-04-25;4821;3560;1221177;535024;22.2;9.7
44;2021-04-26;16695;12010;1237872;547034;22.5;9.9
44;2021-04-27;21146;14616;1259018;561650;22.8;10.2
44;2021-04-28;23772;14793;1282790;576443;23.3;10.5
44;2021-04-29;28118;16931;1310908;593374;23.8;10.8
44;2021-04-30;33100;15997;1344008;609371;24.4;11.1
44;2021-05-01;14844;7011;1358852;616382;24.7;11.2
44;2021-05-02;7897;3989;1366749;620371;24.8;11.3
44;2021-05-03;23996;12357;1390745;632728;25.2;11.5
44;2021-05-04;26957;17251;1417702;649979;25.7;11.8
44;2021-05-05;30792;19127;1448494;669106;26.3;12.1
44;2021-05-06;37972;21061;1486466;690167;27.0;12.5
44;2021-05-07;36114;24771;1522580;714938;27.6;13.0
44;2021-05-08;19551;6689;1542131;721627;28.0;13.1
44;2021-05-09;11300;2900;1553431;724527;28.2;13.1
44;2021-05-10;24475;20748;1577906;745275;28.6;13.5
44;2021-05-11;34407;22890;1612313;768165;29.3;13.9
44;2021-05-12;37092;23978;1649405;792143;29.9;14.4
44;2021-05-13;27868;6357;1677273;798500;30.4;14.5
44;2021-05-14;44176;18868;1721449;817368;31.2;14.8
44;2021-05-15;34015;14077;1755464;831445;31.8;15.1
44;2021-05-16;15593;3503;1771057;834948;32.1;15.1
44;2021-05-17;27146;14495;1798203;849443;32.6;15.4
44;2021-05-18;35082;15229;1833285;864672;33.3;15.7
44;2021-05-19;36807;16317;1870092;880989;33.9;16.0
44;2021-05-20;40757;16402;1910849;897391;34.7;16.3
44;2021-05-21;42730;20857;1953579;918248;35.4;16.7
44;2021-05-22;27651;11543;1981230;929791;35.9;16.9
44;2021-05-23;8659;1713;1989889;931504;36.1;16.9
44;2021-05-24;17882;4647;2007771;936151;36.4;17.0
44;2021-05-25;30183;17582;2037954;953733;37.0;17.3
44;2021-05-26;32325;19473;2070279;973206;37.6;17.7
44;2021-05-27;34498;20786;2104777;993992;38.2;18.0
44;2021-05-28;37450;27783;2142227;1021775;38.9;18.5
44;2021-05-29;26750;20110;2168977;1041885;39.4;18.9
44;2021-05-30;6118;4208;2175095;1046093;39.5;19.0
44;2021-05-31;26966;19674;2202061;1065767;40.0;19.3
44;2021-06-01;31479;22862;2233540;1088629;40.5;19.8
44;2021-06-02;33506;22890;2267046;1111519;41.1;20.2
44;2021-06-03;34518;25257;2301564;1136776;41.8;20.6
44;2021-06-04;39909;32155;2341473;1168931;42.5;21.2
44;2021-06-05;23034;20085;2364507;1189016;42.9;21.6
44;2021-06-06;8302;4449;2372809;1193465;43.1;21.7
44;2021-06-07;28075;22049;2400884;1215514;43.6;22.1
44;2021-06-08;32982;26636;2433866;1242150;44.2;22.5
44;2021-06-09;35589;24847;2469455;1266997;44.8;23.0
44;2021-06-10;34517;25568;2503972;1292565;45.4;23.5
44;2021-06-11;32312;35356;2536284;1327921;46.0;24.1
44;2021-06-12;25668;23424;2561952;1351345;46.5;24.5
44;2021-06-13;6763;6056;2568715;1357401;46.6;24.6
44;2021-06-14;17589;29544;2586304;1386945;46.9;25.2
44;2021-06-15;23545;34927;2609849;1421872;47.4;25.8
44;2021-06-16;24246;36550;2634095;1458422;47.8;26.5
44;2021-06-17;23698;39163;2657793;1497585;48.2;27.2
44;2021-06-18;26391;42918;2684184;1540503;48.7;27.9
44;2021-06-19;20990;28167;2705174;1568670;49.1;28.5
44;2021-06-20;3669;6644;2708843;1575314;49.1;28.6
44;2021-06-21;14765;34015;2723608;1609329;49.4;29.2
44;2021-06-22;15351;41523;2738959;1650852;49.7;30.0
44;2021-06-23;19930;41275;2758889;1692127;50.1;30.7
44;2021-06-24;16433;34173;2775322;1726300;50.4;31.3
44;2021-06-25;18669;49349;2793991;1775649;50.7;32.2
44;2021-06-26;13908;37252;2807899;1812901;50.9;32.9
44;2021-06-27;3303;11521;2811202;1824422;51.0;33.1
52;2020-12-27;0;0;0;0;0.0;0.0
52;2020-12-28;1;0;1;0;0.0;0.0
52;2020-12-29;0;0;1;0;0.0;0.0
52;2020-12-30;0;0;1;0;0.0;0.0
52;2020-12-31;0;0;1;0;0.0;0.0
52;2021-01-01;5;0;6;0;0.0;0.0
52;2021-01-02;1;0;7;0;0.0;0.0
52;2021-01-03;1;0;8;0;0.0;0.0
52;2021-01-04;34;0;42;0;0.0;0.0
52;2021-01-05;168;0;210;0;0.0;0.0
52;2021-01-06;384;1;594;1;0.0;0.0
52;2021-01-07;963;0;1557;1;0.0;0.0
52;2021-01-08;1664;3;3221;4;0.1;0.0
52;2021-01-09;1049;2;4270;6;0.1;0.0
52;2021-01-10;643;1;4913;7;0.1;0.0
52;2021-01-11;2197;0;7110;7;0.2;0.0
52;2021-01-12;3169;4;10279;11;0.3;0.0
52;2021-01-13;2983;4;13262;15;0.3;0.0
52;2021-01-14;3303;25;16565;40;0.4;0.0
52;2021-01-15;3015;9;19580;49;0.5;0.0
52;2021-01-16;894;7;20474;56;0.5;0.0
52;2021-01-17;499;3;20973;59;0.6;0.0
52;2021-01-18;3200;6;24173;65;0.6;0.0
52;2021-01-19;6553;9;30726;74;0.8;0.0
52;2021-01-20;8332;12;39058;86;1.0;0.0
52;2021-01-21;12168;11;51226;97;1.3;0.0
52;2021-01-22;7273;30;58499;127;1.5;0.0
52;2021-01-23;1677;5;60176;132;1.6;0.0
52;2021-01-24;174;0;60350;132;1.6;0.0
52;2021-01-25;3006;13;63356;145;1.7;0.0
52;2021-01-26;6737;154;70093;299;1.8;0.0
52;2021-01-27;7284;151;77377;450;2.0;0.0
52;2021-01-28;9728;469;87105;919;2.3;0.0
52;2021-01-29;5957;911;93062;1830;2.4;0.0
52;2021-01-30;1258;271;94320;2101;2.5;0.1
52;2021-01-31;79;314;94399;2415;2.5;0.1
52;2021-02-01;2521;1191;96920;3606;2.5;0.1
52;2021-02-02;2970;1859;99890;5465;2.6;0.1
52;2021-02-03;2686;2161;102576;7626;2.7;0.2
52;2021-02-04;2962;2117;105538;9743;2.8;0.3
52;2021-02-05;2965;2206;108503;11949;2.9;0.3
52;2021-02-06;1075;662;109578;12611;2.9;0.3
52;2021-02-07;151;297;109729;12908;2.9;0.3
52;2021-02-08;1929;2119;111658;15027;2.9;0.4
52;2021-02-09;3174;3720;114832;18747;3.0;0.5
52;2021-02-10;3318;4763;118150;23510;3.1;0.6
52;2021-02-11;6099;9306;124249;32816;3.3;0.9
52;2021-02-12;4705;5148;128954;37964;3.4;1.0
52;2021-02-13;1150;1243;130104;39207;3.4;1.0
52;2021-02-14;22;541;130126;39748;3.4;1.0
52;2021-02-15;2030;3536;132156;43284;3.5;1.1
52;2021-02-16;4111;6759;136267;50043;3.6;1.3
52;2021-02-17;3874;6952;140141;56995;3.7;1.5
52;2021-02-18;6138;9295;146279;66290;3.8;1.7
52;2021-02-19;5330;5834;151609;72124;4.0;1.9
52;2021-02-20;1028;1476;152637;73600;4.0;1.9
52;2021-02-21;7;274;152644;73874;4.0;1.9
52;2021-02-22;2645;3494;155289;77368;4.1;2.0
52;2021-02-23;3424;3702;158713;81070;4.2;2.1
52;2021-02-24;3304;3040;162017;84110;4.3;2.2
52;2021-02-25;6344;3218;168361;87328;4.4;2.3
52;2021-02-26;6213;2931;174574;90259;4.6;2.4
52;2021-02-27;2216;1047;176790;91306;4.7;2.4
52;2021-02-28;76;88;176866;91394;4.7;2.4
52;2021-03-01;3113;2334;179979;93728;4.7;2.5
52;2021-03-02;4723;3440;184702;97168;4.9;2.6
52;2021-03-03;5278;3415;189980;100583;5.0;2.6
52;2021-03-04;7788;4780;197768;105363;5.2;2.8
52;2021-03-05;9005;3937;206773;109300;5.4;2.9
52;2021-03-06;5636;1156;212409;110456;5.6;2.9
52;2021-03-07;2661;136;215070;110592;5.7;2.9
52;2021-03-08;5841;2426;220911;113018;5.8;3.0
52;2021-03-09;9545;3338;230456;116356;6.1;3.1
52;2021-03-10;9390;3404;239846;119760;6.3;3.2
52;2021-03-11;13572;5058;253418;124818;6.7;3.3
52;2021-03-12;15328;3753;268746;128571;7.1;3.4
52;2021-03-13;8286;765;277032;129336;7.3;3.4
52;2021-03-14;624;72;277656;129408;7.3;3.4
52;2021-03-15;8834;1915;286490;131323;7.5;3.5
52;2021-03-16;7573;2621;294063;133944;7.7;3.5
52;2021-03-17;6457;2385;300520;136329;7.9;3.6
52;2021-03-18;8300;2516;308820;138845;8.1;3.7
52;2021-03-19;11886;2134;320706;140979;8.4;3.7
52;2021-03-20;7085;763;327791;141742;8.6;3.7
52;2021-03-21;1689;47;329480;141789;8.7;3.7
52;2021-03-22;9013;2009;338493;143798;8.9;3.8
52;2021-03-23;13179;2600;351672;146398;9.3;3.9
52;2021-03-24;13256;2044;364928;148442;9.6;3.9
52;2021-03-25;18191;2815;383119;151257;10.1;4.0
52;2021-03-26;18927;2379;402046;153636;10.6;4.0
52;2021-03-27;7553;653;409599;154289;10.8;4.1
52;2021-03-28;2193;67;411792;154356;10.8;4.1
52;2021-03-29;10965;2724;422757;157080;11.1;4.1
52;2021-03-30;15673;3606;438430;160686;11.5;4.2
52;2021-03-31;13687;3287;452117;163973;11.9;4.3
52;2021-04-01;18869;3695;470986;167668;12.4;4.4
52;2021-04-02;17079;3515;488065;171183;12.8;4.5
52;2021-04-03;5515;1194;493580;172377;13.0;4.5
52;2021-04-04;1324;51;494904;172428;13.0;4.5
52;2021-04-05;1781;538;496685;172966;13.1;4.5
52;2021-04-06;11783;5256;508468;178222;13.4;4.7
52;2021-04-07;15186;5701;523654;183923;13.8;4.8
52;2021-04-08;21214;6391;544868;190314;14.3;5.0
52;2021-04-09;26624;5307;571492;195621;15.0;5.1
52;2021-04-10;10114;2364;581606;197985;15.3;5.2
52;2021-04-11;2567;434;584173;198419;15.4;5.2
52;2021-04-12;16329;6585;600502;205004;15.8;5.4
52;2021-04-13;20728;8172;621230;213176;16.3;5.6
52;2021-04-14;17650;6923;638880;220099;16.8;5.8
52;2021-04-15;21147;8032;660027;228131;17.4;6.0
52;2021-04-16;22588;7471;682615;235602;18.0;6.2
52;2021-04-17;9969;3033;692584;238635;18.2;6.3
52;2021-04-18;3036;1307;695620;239942;18.3;6.3
52;2021-04-19;14170;7817;709790;247759;18.7;6.5
52;2021-04-20;18260;9393;728050;257152;19.2;6.8
52;2021-04-21;15972;9163;744022;266315;19.6;7.0
52;2021-04-22;19409;10162;763431;276477;20.1;7.3
52;2021-04-23;20507;9974;783938;286451;20.6;7.5
52;2021-04-24;10011;4979;793949;291430;20.9;7.7
52;2021-04-25;3980;1951;797929;293381;21.0;7.7
52;2021-04-26;16818;9904;814747;303285;21.4;8.0
52;2021-04-27;21063;12558;835810;315843;22.0;8.3
52;2021-04-28;22753;10661;858563;326504;22.6;8.6
52;2021-04-29;25000;12674;883563;339178;23.2;8.9
52;2021-04-30;25633;12487;909196;351665;23.9;9.2
52;2021-05-01;8614;2475;917810;354140;24.1;9.3
52;2021-05-02;4298;1271;922108;355411;24.3;9.3
52;2021-05-03;19059;10622;941167;366033;24.8;9.6
52;2021-05-04;20064;14383;961231;380416;25.3;10.0
52;2021-05-05;20853;12764;982084;393180;25.8;10.3
52;2021-05-06;22466;13836;1004550;407016;26.4;10.7
52;2021-05-07;20685;18025;1025235;425041;27.0;11.2
52;2021-05-08;11223;2085;1036458;427126;27.3;11.2
52;2021-05-09;5395;2227;1041853;429353;27.4;11.3
52;2021-05-10;20769;17285;1062622;446638;28.0;11.7
52;2021-05-11;24845;19550;1087467;466188;28.6;12.3
52;2021-05-12;24776;17106;1112243;483294;29.3;12.7
52;2021-05-13;18575;2740;1130818;486034;29.7;12.8
52;2021-05-14;22743;12424;1153561;498458;30.3;13.1
52;2021-05-15;15645;5212;1169206;503670;30.8;13.2
52;2021-05-16;10287;1160;1179493;504830;31.0;13.3
52;2021-05-17;21108;14656;1200601;519486;31.6;13.7
52;2021-05-18;24744;14984;1225345;534470;32.2;14.1
52;2021-05-19;26714;11427;1252059;545897;32.9;14.4
52;2021-05-20;29260;12001;1281319;557898;33.7;14.7
52;2021-05-21;27324;13836;1308643;571734;34.4;15.0
52;2021-05-22;15410;4706;1324053;576440;34.8;15.2
52;2021-05-23;4471;1142;1328524;577582;34.9;15.2
52;2021-05-24;15996;2757;1344520;580339;35.4;15.3
52;2021-05-25;24421;14529;1368941;594868;36.0;15.6
52;2021-05-26;25144;12652;1394085;607520;36.7;16.0
52;2021-05-27;29063;14814;1423148;622334;37.4;16.4
52;2021-05-28;27901;17859;1451049;640193;38.2;16.8
52;2021-05-29;18322;7772;1469371;647965;38.6;17.0
52;2021-05-30;4228;1718;1473599;649683;38.8;17.1
52;2021-05-31;24406;15870;1498005;665553;39.4;17.5
52;2021-06-01;28803;17807;1526808;683360;40.2;18.0
52;2021-06-02;27424;15214;1554232;698574;40.9;18.4
52;2021-06-03;31708;16273;1585940;714847;41.7;18.8
52;2021-06-04;29207;20727;1615147;735574;42.5;19.3
52;2021-06-05;14535;11797;1629682;747371;42.9;19.7
52;2021-06-06;4776;3531;1634458;750902;43.0;19.8
52;2021-06-07;21695;20874;1656153;771776;43.6;20.3
52;2021-06-08;26424;22028;1682577;793804;44.3;20.9
52;2021-06-09;25643;18612;1708220;812416;44.9;21.4
52;2021-06-10;28706;17587;1736926;830003;45.7;21.8
52;2021-06-11;26956;24314;1763882;854317;46.4;22.5
52;2021-06-12;14590;11845;1778472;866162;46.8;22.8
52;2021-06-13;4379;4517;1782851;870679;46.9;22.9
52;2021-06-14;17596;25386;1800447;896065;47.4;23.6
52;2021-06-15;23685;25325;1824132;921390;48.0;24.2
52;2021-06-16;23273;22465;1847405;943855;48.6;24.8
52;2021-06-17;25907;23077;1873312;966932;49.3;25.4
52;2021-06-18;23230;28712;1896542;995644;49.9;26.2
52;2021-06-19;12432;14243;1908974;1009887;50.2;26.6
52;2021-06-20;3013;4418;1911987;1014305;50.3;26.7
52;2021-06-21;14809;28874;1926796;1043179;50.7;27.4
52;2021-06-22;17370;31770;1944166;1074949;51.1;28.3
52;2021-06-23;18397;26986;1962563;1101935;51.6;29.0
52;2021-06-24;20951;24051;1983514;1125986;52.2;29.6
52;2021-06-25;16463;31239;1999977;1157225;52.6;30.4
52;2021-06-26;8403;18072;2008380;1175297;52.8;30.9
52;2021-06-27;1305;7437;2009685;1182734;52.9;31.1
53;2020-12-27;0;0;0;0;0.0;0.0
53;2020-12-28;0;0;0;0;0.0;0.0
53;2020-12-29;0;0;0;0;0.0;0.0
53;2020-12-30;0;0;0;0;0.0;0.0
53;2020-12-31;0;0;0;0;0.0;0.0
53;2021-01-01;3;0;3;0;0.0;0.0
53;2021-01-02;4;0;7;0;0.0;0.0
53;2021-01-03;0;0;7;0;0.0;0.0
53;2021-01-04;43;0;50;0;0.0;0.0
53;2021-01-05;200;0;250;0;0.0;0.0
53;2021-01-06;331;1;581;1;0.0;0.0
53;2021-01-07;835;1;1416;2;0.0;0.0
53;2021-01-08;1213;0;2629;2;0.1;0.0
53;2021-01-09;34;0;2663;2;0.1;0.0
53;2021-01-10;4;0;2667;2;0.1;0.0
53;2021-01-11;1661;3;4328;5;0.1;0.0
53;2021-01-12;3380;1;7708;6;0.2;0.0
53;2021-01-13;3355;4;11063;10;0.3;0.0
53;2021-01-14;3813;30;14876;40;0.4;0.0
53;2021-01-15;3297;17;18173;57;0.5;0.0
53;2021-01-16;684;4;18857;61;0.6;0.0
53;2021-01-17;180;1;19037;62;0.6;0.0
53;2021-01-18;3361;7;22398;69;0.7;0.0
53;2021-01-19;8176;5;30574;74;0.9;0.0
53;2021-01-20;7059;4;37633;78;1.1;0.0
53;2021-01-21;11478;7;49111;85;1.5;0.0
53;2021-01-22;7812;13;56923;98;1.7;0.0
53;2021-01-23;1492;2;58415;100;1.7;0.0
53;2021-01-24;255;1;58670;101;1.8;0.0
53;2021-01-25;3056;35;61726;136;1.8;0.0
53;2021-01-26;4111;233;65837;369;2.0;0.0
53;2021-01-27;7238;326;73075;695;2.2;0.0
53;2021-01-28;7134;641;80209;1336;2.4;0.0
53;2021-01-29;4230;730;84439;2066;2.5;0.1
53;2021-01-30;844;43;85283;2109;2.6;0.1
53;2021-01-31;79;3;85362;2112;2.6;0.1
53;2021-02-01;2210;1027;87572;3139;2.6;0.1
53;2021-02-02;3438;2017;91010;5156;2.7;0.2
53;2021-02-03;3175;2184;94185;7340;2.8;0.2
53;2021-02-04;7095;2270;101280;9610;3.0;0.3
53;2021-02-05;5585;2136;106865;11746;3.2;0.4
53;2021-02-06;1201;277;108066;12023;3.2;0.4
53;2021-02-07;214;132;108280;12155;3.2;0.4
53;2021-02-08;1651;1532;109931;13687;3.3;0.4
53;2021-02-09;3976;5259;113907;18946;3.4;0.6
53;2021-02-10;3791;4650;117698;23596;3.5;0.7
53;2021-02-11;5733;8795;123431;32391;3.7;1.0
53;2021-02-12;5662;5254;129093;37645;3.9;1.1
53;2021-02-13;1232;852;130325;38497;3.9;1.2
53;2021-02-14;25;348;130350;38845;3.9;1.2
53;2021-02-15;2325;3585;132675;42430;4.0;1.3
53;2021-02-16;4053;3545;136728;45975;4.1;1.4
53;2021-02-17;4073;5375;140801;51350;4.2;1.5
53;2021-02-18;5949;5746;146750;57096;4.4;1.7
53;2021-02-19;5355;4854;152105;61950;4.6;1.9
53;2021-02-20;1189;893;153294;62843;4.6;1.9
53;2021-02-21;166;218;153460;63061;4.6;1.9
53;2021-02-22;2318;2834;155778;65895;4.7;2.0
53;2021-02-23;3947;3674;159725;69569;4.8;2.1
53;2021-02-24;4469;3786;164194;73355;4.9;2.2
53;2021-02-25;7947;7145;172141;80500;5.2;2.4
53;2021-02-26;8677;4414;180818;84914;5.4;2.5
53;2021-02-27;3448;1106;184266;86020;5.5;2.6
53;2021-02-28;228;194;184494;86214;5.5;2.6
53;2021-03-01;3479;2267;187973;88481;5.6;2.6
53;2021-03-02;5617;4463;193590;92944;5.8;2.8
53;2021-03-03;6443;3794;200033;96738;6.0;2.9
53;2021-03-04;9284;4926;209317;101664;6.3;3.0
53;2021-03-05;11912;5219;221229;106883;6.6;3.2
53;2021-03-06;5635;1021;226864;107904;6.8;3.2
53;2021-03-07;913;146;227777;108050;6.8;3.2
53;2021-03-08;5163;2214;232940;110264;7.0;3.3
53;2021-03-09;9663;2937;242603;113201;7.3;3.4
53;2021-03-10;9276;3377;251879;116578;7.5;3.5
53;2021-03-11;14302;4051;266181;120629;8.0;3.6
53;2021-03-12;18600;3259;284781;123888;8.5;3.7
53;2021-03-13;8810;949;293591;124837;8.8;3.7
53;2021-03-14;812;50;294403;124887;8.8;3.7
53;2021-03-15;6892;2032;301295;126919;9.0;3.8
53;2021-03-16;6984;3409;308279;130328;9.2;3.9
53;2021-03-17;8226;2829;316505;133157;9.5;4.0
53;2021-03-18;8715;4657;325220;137814;9.7;4.1
53;2021-03-19;12991;3649;338211;141463;10.1;4.2
53;2021-03-20;7129;817;345340;142280;10.3;4.3
53;2021-03-21;383;32;345723;142312;10.3;4.3
53;2021-03-22;7345;2165;353068;144477;10.6;4.3
53;2021-03-23;12991;3666;366059;148143;11.0;4.4
53;2021-03-24;14400;3240;380459;151383;11.4;4.5
53;2021-03-25;18279;3371;398738;154754;11.9;4.6
53;2021-03-26;20313;3205;419051;157959;12.5;4.7
53;2021-03-27;7404;1014;426455;158973;12.8;4.8
53;2021-03-28;527;86;426982;159059;12.8;4.8
53;2021-03-29;9797;3167;436779;162226;13.1;4.9
53;2021-03-30;15306;4598;452085;166824;13.5;5.0
53;2021-03-31;14142;4265;466227;171089;14.0;5.1
53;2021-04-01;18191;4273;484418;175362;14.5;5.2
53;2021-04-02;17889;4353;502307;179715;15.0;5.4
53;2021-04-03;6431;1427;508738;181142;15.2;5.4
53;2021-04-04;413;33;509151;181175;15.2;5.4
53;2021-04-05;1231;336;510382;181511;15.3;5.4
53;2021-04-06;12523;5675;522905;187186;15.7;5.6
53;2021-04-07;15012;5335;537917;192521;16.1;5.8
53;2021-04-08;20672;6102;558589;198623;16.7;5.9
53;2021-04-09;26642;5571;585231;204194;17.5;6.1
53;2021-04-10;10333;1724;595564;205918;17.8;6.2
53;2021-04-11;816;213;596380;206131;17.9;6.2
53;2021-04-12;15826;4912;612206;211043;18.3;6.3
53;2021-04-13;22691;7256;634897;218299;19.0;6.5
53;2021-04-14;19342;7928;654239;226227;19.6;6.8
53;2021-04-15;25345;8061;679584;234288;20.3;7.0
53;2021-04-16;26171;7544;705755;241832;21.1;7.2
53;2021-04-17;10391;3581;716146;245413;21.4;7.3
53;2021-04-18;1033;148;717179;245561;21.5;7.4
53;2021-04-19;15399;6535;732578;252096;21.9;7.5
53;2021-04-20;16919;9515;749497;261611;22.4;7.8
53;2021-04-21;16741;9442;766238;271053;22.9;8.1
53;2021-04-22;21744;10184;787982;281237;23.6;8.4
53;2021-04-23;21648;10083;809630;291320;24.2;8.7
53;2021-04-24;9983;4167;819613;295487;24.5;8.8
53;2021-04-25;905;334;820518;295821;24.6;8.9
53;2021-04-26;18219;8479;838737;304300;25.1;9.1
53;2021-04-27;19852;12065;858589;316365;25.7;9.5
53;2021-04-28;19941;10814;878530;327179;26.3;9.8
53;2021-04-29;23541;12281;902071;339460;27.0;10.2
53;2021-04-30;23897;12441;925968;351901;27.7;10.5
53;2021-05-01;5122;1633;931090;353534;27.9;10.6
53;2021-05-02;2793;520;933883;354054;28.0;10.6
53;2021-05-03;15710;9380;949593;363434;28.4;10.9
53;2021-05-04;15688;15793;965281;379227;28.9;11.4
53;2021-05-05;14936;14693;980217;393920;29.3;11.8
53;2021-05-06;19253;17846;999470;411766;29.9;12.3
53;2021-05-07;18637;18221;1018107;429987;30.5;12.9
53;2021-05-08;5485;1120;1023592;431107;30.6;12.9
53;2021-05-09;3511;860;1027103;431967;30.7;12.9
53;2021-05-10;16677;15223;1043780;447190;31.2;13.4
53;2021-05-11;18662;18738;1062442;465928;31.8;13.9
53;2021-05-12;21189;15640;1083631;481568;32.4;14.4
53;2021-05-13;9024;3956;1092655;485524;32.7;14.5
53;2021-05-14;21712;13739;1114367;499263;33.4;14.9
53;2021-05-15;13423;5339;1127790;504602;33.8;15.1
53;2021-05-16;3222;877;1131012;505479;33.9;15.1
53;2021-05-17;18151;11174;1149163;516653;34.4;15.5
53;2021-05-18;20926;12403;1170089;529056;35.0;15.8
53;2021-05-19;21555;10632;1191644;539688;35.7;16.2
53;2021-05-20;23821;14722;1215465;554410;36.4;16.6
53;2021-05-21;22828;15236;1238293;569646;37.1;17.1
53;2021-05-22;13140;5840;1251433;575486;37.5;17.2
53;2021-05-23;2977;310;1254410;575796;37.6;17.2
53;2021-05-24;13938;2501;1268348;578297;38.0;17.3
53;2021-05-25;19925;12824;1288273;591121;38.6;17.7
53;2021-05-26;19254;13794;1307527;604915;39.1;18.1
53;2021-05-27;22041;17414;1329568;622329;39.8;18.6
53;2021-05-28;21748;20406;1351316;642735;40.5;19.2
53;2021-05-29;12137;7337;1363453;650072;40.8;19.5
53;2021-05-30;2306;472;1365759;650544;40.9;19.5
53;2021-05-31;20674;14091;1386433;664635;41.5;19.9
53;2021-06-01;22918;16483;1409351;681118;42.2;20.4
53;2021-06-02;21763;14230;1431114;695348;42.8;20.8
53;2021-06-03;25028;16856;1456142;712204;43.6;21.3
53;2021-06-04;23062;22569;1479204;734773;44.3;22.0
53;2021-06-05;17303;9004;1496507;743777;44.8;22.3
53;2021-06-06;4997;1325;1501504;745102;45.0;22.3
53;2021-06-07;18372;17790;1519876;762892;45.5;22.8
53;2021-06-08;23341;18043;1543217;780935;46.2;23.4
53;2021-06-09;23604;15872;1566821;796807;46.9;23.9
53;2021-06-10;26769;16869;1593590;813676;47.7;24.4
53;2021-06-11;26181;21428;1619771;835104;48.5;25.0
53;2021-06-12;18596;7510;1638367;842614;49.0;25.2
53;2021-06-13;7794;3119;1646161;845733;49.3;25.3
53;2021-06-14;16024;19800;1662185;865533;49.8;25.9
53;2021-06-15;20047;20949;1682232;886482;50.4;26.5
53;2021-06-16;21166;18533;1703398;905015;51.0;27.1
53;2021-06-17;21875;20091;1725273;925106;51.6;27.7
53;2021-06-18;22219;25646;1747492;950752;52.3;28.5
53;2021-06-19;12829;9606;1760321;960358;52.7;28.7
53;2021-06-20;5452;2679;1765773;963037;52.9;28.8
53;2021-06-21;14582;22350;1780355;985387;53.3;29.5
53;2021-06-22;16964;24912;1797319;1010299;53.8;30.2
53;2021-06-23;16630;23511;1813949;1033810;54.3;30.9
53;2021-06-24;18993;21827;1832942;1055637;54.9;31.6
53;2021-06-25;15414;29011;1848356;1084648;55.3;32.5
53;2021-06-26;7106;13955;1855462;1098603;55.5;32.9
53;2021-06-27;3877;3301;1859339;1101904;55.7;33.0
75;2020-12-27;1;0;1;0;0.0;0.0
75;2020-12-28;2;0;3;0;0.0;0.0
75;2020-12-29;3;0;6;0;0.0;0.0
75;2020-12-30;2;0;8;0;0.0;0.0
75;2020-12-31;0;0;8;0;0.0;0.0
75;2021-01-01;4;0;12;0;0.0;0.0
75;2021-01-02;2;0;14;0;0.0;0.0
75;2021-01-03;0;0;14;0;0.0;0.0
75;2021-01-04;90;0;104;0;0.0;0.0
75;2021-01-05;124;0;228;0;0.0;0.0
75;2021-01-06;736;1;964;1;0.0;0.0
75;2021-01-07;4923;2;5887;3;0.1;0.0
75;2021-01-08;5468;5;11355;8;0.2;0.0
75;2021-01-09;845;1;12200;9;0.2;0.0
75;2021-01-10;479;0;12679;9;0.2;0.0
75;2021-01-11;3585;1;16264;10;0.3;0.0
75;2021-01-12;5949;6;22213;16;0.4;0.0
75;2021-01-13;6551;15;28764;31;0.5;0.0
75;2021-01-14;8123;63;36887;94;0.6;0.0
75;2021-01-15;7629;32;44516;126;0.7;0.0
75;2021-01-16;1607;14;46123;140;0.8;0.0
75;2021-01-17;425;5;46548;145;0.8;0.0
75;2021-01-18;6888;31;53436;176;0.9;0.0
75;2021-01-19;14049;14;67485;190;1.1;0.0
75;2021-01-20;15535;26;83020;216;1.4;0.0
75;2021-01-21;16964;19;99984;235;1.7;0.0
75;2021-01-22;12971;23;112955;258;1.9;0.0
75;2021-01-23;4421;3;117376;261;2.0;0.0
75;2021-01-24;700;1;118076;262;2.0;0.0
75;2021-01-25;8871;219;126947;481;2.1;0.0
75;2021-01-26;11721;454;138668;935;2.3;0.0
75;2021-01-27;12279;770;150947;1705;2.5;0.0
75;2021-01-28;12940;2659;163887;4364;2.7;0.1
75;2021-01-29;10000;2986;173887;7350;2.9;0.1
75;2021-01-30;3379;516;177266;7866;3.0;0.1
75;2021-01-31;646;420;177912;8286;3.0;0.1
75;2021-02-01;5716;2640;183628;10926;3.1;0.2
75;2021-02-02;9610;4357;193238;15283;3.2;0.3
75;2021-02-03;9595;4373;202833;19656;3.4;0.3
75;2021-02-04;10762;5683;213595;25339;3.6;0.4
75;2021-02-05;7489;5638;221084;30977;3.7;0.5
75;2021-02-06;2378;1106;223462;32083;3.7;0.5
75;2021-02-07;673;252;224135;32335;3.7;0.5
75;2021-02-08;5136;3653;229271;35988;3.8;0.6
75;2021-02-09;7315;8081;236586;44069;3.9;0.7
75;2021-02-10;7542;8741;244128;52810;4.1;0.9
75;2021-02-11;8858;10273;252986;63083;4.2;1.1
75;2021-02-12;7406;8837;260392;71920;4.3;1.2
75;2021-02-13;1953;1761;262345;73681;4.4;1.2
75;2021-02-14;274;364;262619;74045;4.4;1.2
75;2021-02-15;3152;7840;265771;81885;4.4;1.4
75;2021-02-16;4609;10533;270380;92418;4.5;1.5
75;2021-02-17;4758;11305;275138;103723;4.6;1.7
75;2021-02-18;5452;12844;280590;116567;4.7;1.9
75;2021-02-19;5419;9637;286009;126204;4.8;2.1
75;2021-02-20;989;2633;286998;128837;4.8;2.1
75;2021-02-21;187;667;287185;129504;4.8;2.2
75;2021-02-22;3649;8517;290834;138021;4.8;2.3
75;2021-02-23;5354;10956;296188;148977;4.9;2.5
75;2021-02-24;6129;10290;302317;159267;5.0;2.7
75;2021-02-25;10045;11723;312362;170990;5.2;2.8
75;2021-02-26;12267;8873;324629;179863;5.4;3.0
75;2021-02-27;5784;2490;330413;182353;5.5;3.0
75;2021-02-28;312;694;330725;183047;5.5;3.1
75;2021-03-01;5091;7018;335816;190065;5.6;3.2
75;2021-03-02;9350;8175;345166;198240;5.8;3.3
75;2021-03-03;10821;7773;355987;206013;5.9;3.4
75;2021-03-04;16736;8179;372723;214192;6.2;3.6
75;2021-03-05;20803;7482;393526;221674;6.6;3.7
75;2021-03-06;13409;2238;406935;223912;6.8;3.7
75;2021-03-07;3721;468;410656;224380;6.8;3.7
75;2021-03-08;9994;5392;420650;229772;7.0;3.8
75;2021-03-09;16853;6493;437503;236265;7.3;3.9
75;2021-03-10;18256;6317;455759;242582;7.6;4.0
75;2021-03-11;26435;6689;482194;249271;8.0;4.2
75;2021-03-12;31301;5271;513495;254542;8.6;4.2
75;2021-03-13;17859;1204;531354;255746;8.9;4.3
75;2021-03-14;1713;251;533067;255997;8.9;4.3
75;2021-03-15;14077;3428;547144;259425;9.1;4.3
75;2021-03-16;13686;3713;560830;263138;9.3;4.4
75;2021-03-17;14747;3884;575577;267022;9.6;4.5
75;2021-03-18;16381;4690;591958;271712;9.9;4.5
75;2021-03-19;22436;4297;614394;276009;10.2;4.6
75;2021-03-20;14032;823;628426;276832;10.5;4.6
75;2021-03-21;2473;107;630899;276939;10.5;4.6
75;2021-03-22;16795;3464;647694;280403;10.8;4.7
75;2021-03-23;25271;3897;672965;284300;11.2;4.7
75;2021-03-24;27150;4317;700115;288617;11.7;4.8
75;2021-03-25;35655;4645;735770;293262;12.3;4.9
75;2021-03-26;38620;4194;774390;297456;12.9;5.0
75;2021-03-27;15715;1285;790105;298741;13.2;5.0
75;2021-03-28;2726;394;792831;299135;13.2;5.0
75;2021-03-29;22839;4152;815670;303287;13.6;5.1
75;2021-03-30;31650;5983;847320;309270;14.1;5.2
75;2021-03-31;29750;5955;877070;315225;14.6;5.3
75;2021-04-01;35016;6961;912086;322186;15.2;5.4
75;2021-04-02;32351;6876;944437;329062;15.7;5.5
75;2021-04-03;12843;2640;957280;331702;16.0;5.5
75;2021-04-04;2137;340;959417;332042;16.0;5.5
75;2021-04-05;6369;604;965786;332646;16.1;5.5
75;2021-04-06;26385;10840;992171;343486;16.5;5.7
75;2021-04-07;32367;11031;1024538;354517;17.1;5.9
75;2021-04-08;39603;12375;1064141;366892;17.7;6.1
75;2021-04-09;49252;10999;1113393;377891;18.6;6.3
75;2021-04-10;24453;4979;1137846;382870;19.0;6.4
75;2021-04-11;4969;720;1142815;383590;19.0;6.4
75;2021-04-12;27379;11859;1170194;395449;19.5;6.6
75;2021-04-13;35722;14355;1205916;409804;20.1;6.8
75;2021-04-14;35439;14503;1241355;424307;20.7;7.1
75;2021-04-15;37687;15088;1279042;439395;21.3;7.3
75;2021-04-16;37145;15138;1316187;454533;21.9;7.6
75;2021-04-17;19574;7386;1335761;461919;22.3;7.7
75;2021-04-18;4073;2056;1339834;463975;22.3;7.7
75;2021-04-19;20892;14966;1360726;478941;22.7;8.0
75;2021-04-20;28486;19126;1389212;498067;23.2;8.3
75;2021-04-21;27835;18099;1417047;516166;23.6;8.6
75;2021-04-22;30371;19696;1447418;535862;24.1;8.9
75;2021-04-23;29071;20265;1476489;556127;24.6;9.3
75;2021-04-24;17007;9146;1493496;565273;24.9;9.4
75;2021-04-25;4597;1499;1498093;566772;25.0;9.4
75;2021-04-26;22314;19307;1520407;586079;25.3;9.8
75;2021-04-27;29189;24332;1549596;610411;25.8;10.2
75;2021-04-28;31138;24029;1580734;634440;26.3;10.6
75;2021-04-29;37266;26652;1618000;661092;27.0;11.0
75;2021-04-30;37748;25889;1655748;686981;27.6;11.4
75;2021-05-01;15680;5754;1671428;692735;27.9;11.5
75;2021-05-02;7257;2599;1678685;695334;28.0;11.6
75;2021-05-03;27255;21187;1705940;716521;28.4;11.9
75;2021-05-04;30355;29307;1736295;745828;28.9;12.4
75;2021-05-05;31493;31010;1767788;776838;29.5;12.9
75;2021-05-06;35950;32410;1803738;809248;30.1;13.5
75;2021-05-07;37432;34380;1841170;843628;30.7;14.1
75;2021-05-08;17708;8097;1858878;851725;31.0;14.2
75;2021-05-09;7313;4155;1866191;855880;31.1;14.3
75;2021-05-10;25215;29030;1891406;884910;31.5;14.7
75;2021-05-11;35595;32984;1927001;917894;32.1;15.3
75;2021-05-12;35615;30165;1962616;948059;32.7;15.8
75;2021-05-13;22696;7549;1985312;955608;33.1;15.9
75;2021-05-14;33897;20886;2019209;976494;33.7;16.3
75;2021-05-15;22949;11112;2042158;987606;34.0;16.5
75;2021-05-16;7413;2064;2049571;989670;34.2;16.5
75;2021-05-17;33871;19246;2083442;1008916;34.7;16.8
75;2021-05-18;42699;19950;2126141;1028866;35.4;17.1
75;2021-05-19;42665;17630;2168806;1046496;36.1;17.4
75;2021-05-20;45886;20363;2214692;1066859;36.9;17.8
75;2021-05-21;42838;21397;2257530;1088256;37.6;18.1
75;2021-05-22;23243;9809;2280773;1098065;38.0;18.3
75;2021-05-23;7807;1422;2288580;1099487;38.1;18.3
75;2021-05-24;18842;4072;2307422;1103559;38.5;18.4
75;2021-05-25;36820;20968;2344242;1124527;39.1;18.7
75;2021-05-26;38284;21492;2382526;1146019;39.7;19.1
75;2021-05-27;42908;27098;2425434;1173117;40.4;19.6
75;2021-05-28;38846;32298;2464280;1205415;41.1;20.1
75;2021-05-29;19645;18103;2483925;1223518;41.4;20.4
75;2021-05-30;5773;2288;2489698;1225806;41.5;20.4
75;2021-05-31;31621;23131;2521319;1248937;42.0;20.8
75;2021-06-01;40985;29626;2562304;1278563;42.7;21.3
75;2021-06-02;41340;28244;2603644;1306807;43.4;21.8
75;2021-06-03;47592;31219;2651236;1338026;44.2;22.3
75;2021-06-04;44375;36975;2695611;1375001;44.9;22.9
75;2021-06-05;24401;18533;2720012;1393534;45.3;23.2
75;2021-06-06;8730;4321;2728742;1397855;45.5;23.3
75;2021-06-07;31378;31545;2760120;1429400;46.0;23.8
75;2021-06-08;38411;35955;2798531;1465355;46.6;24.4
75;2021-06-09;39306;32938;2837837;1498293;47.3;25.0
75;2021-06-10;42918;31817;2880755;1530110;48.0;25.5
75;2021-06-11;40248;40325;2921003;1570435;48.7;26.2
75;2021-06-12;23191;21534;2944194;1591969;49.1;26.5
75;2021-06-13;8100;5656;2952294;1597625;49.2;26.6
75;2021-06-14;23958;37944;2976252;1635569;49.6;27.3
75;2021-06-15;33127;41685;3009379;1677254;50.2;28.0
75;2021-06-16;34628;37291;3044007;1714545;50.7;28.6
75;2021-06-17;36060;38578;3080067;1753123;51.3;29.2
75;2021-06-18;34673;45308;3114740;1798431;51.9;30.0
75;2021-06-19;20139;23250;3134879;1821681;52.2;30.4
75;2021-06-20;6211;5731;3141090;1827412;52.4;30.5
75;2021-06-21;21400;37331;3162490;1864743;52.7;31.1
75;2021-06-22;25201;43596;3187691;1908339;53.1;31.8
75;2021-06-23;26135;40790;3213826;1949129;53.6;32.5
75;2021-06-24;27763;35577;3241589;1984706;54.0;33.1
75;2021-06-25;23779;48586;3265368;2033292;54.4;33.9
75;2021-06-26;13558;26763;3278926;2060055;54.6;34.3
75;2021-06-27;4550;8571;3283476;2068626;54.7;34.5
76;2020-12-27;0;0;0;0;0.0;0.0
76;2020-12-28;4;0;4;0;0.0;0.0
76;2020-12-29;0;0;4;0;0.0;0.0
76;2020-12-30;0;0;4;0;0.0;0.0
76;2020-12-31;1;0;5;0;0.0;0.0
76;2021-01-01;3;0;8;0;0.0;0.0
76;2021-01-02;2;0;10;0;0.0;0.0
76;2021-01-03;2;0;12;0;0.0;0.0
76;2021-01-04;59;1;71;1;0.0;0.0
76;2021-01-05;473;1;544;2;0.0;0.0
76;2021-01-06;784;2;1328;4;0.0;0.0
76;2021-01-07;2538;3;3866;7;0.1;0.0
76;2021-01-08;3214;2;7080;9;0.1;0.0
76;2021-01-09;1538;1;8618;10;0.1;0.0
76;2021-01-10;517;0;9135;10;0.2;0.0
76;2021-01-11;3525;9;12660;19;0.2;0.0
76;2021-01-12;5745;10;18405;29;0.3;0.0
76;2021-01-13;6475;14;24880;43;0.4;0.0
76;2021-01-14;8997;86;33877;129;0.6;0.0
76;2021-01-15;7253;33;41130;162;0.7;0.0
76;2021-01-16;1954;21;43084;183;0.7;0.0
76;2021-01-17;710;3;43794;186;0.7;0.0
76;2021-01-18;7703;21;51497;207;0.9;0.0
76;2021-01-19;11201;31;62698;238;1.1;0.0
76;2021-01-20;13708;25;76406;263;1.3;0.0
76;2021-01-21;16703;21;93109;284;1.6;0.0
76;2021-01-22;11908;32;105017;316;1.8;0.0
76;2021-01-23;3896;9;108913;325;1.8;0.0
76;2021-01-24;768;12;109681;337;1.9;0.0
76;2021-01-25;7829;98;117510;435;2.0;0.0
76;2021-01-26;10345;283;127855;718;2.2;0.0
76;2021-01-27;10848;482;138703;1200;2.3;0.0
76;2021-01-28;10137;1696;148840;2896;2.5;0.0
76;2021-01-29;8087;1989;156927;4885;2.6;0.1
76;2021-01-30;3185;772;160112;5657;2.7;0.1
76;2021-01-31;521;267;160633;5924;2.7;0.1
76;2021-02-01;5855;2605;166488;8529;2.8;0.1
76;2021-02-02;10058;4001;176546;12530;3.0;0.2
76;2021-02-03;9518;4070;186064;16600;3.1;0.3
76;2021-02-04;10100;5960;196164;22560;3.3;0.4
76;2021-02-05;7774;5027;203938;27587;3.4;0.5
76;2021-02-06;2695;1051;206633;28638;3.5;0.5
76;2021-02-07;542;498;207175;29136;3.5;0.5
76;2021-02-08;4840;4530;212015;33666;3.6;0.6
76;2021-02-09;6319;6821;218334;40487;3.7;0.7
76;2021-02-10;7175;9241;225509;49728;3.8;0.8
76;2021-02-11;9131;10739;234640;60467;4.0;1.0
76;2021-02-12;8046;7691;242686;68158;4.1;1.2
76;2021-02-13;2646;2272;245332;70430;4.1;1.2
76;2021-02-14;357;994;245689;71424;4.1;1.2
76;2021-02-15;3380;6470;249069;77894;4.2;1.3
76;2021-02-16;4242;8697;253311;86591;4.3;1.5
76;2021-02-17;4375;9657;257686;96248;4.3;1.6
76;2021-02-18;5870;9990;263556;106238;4.4;1.8
76;2021-02-19;4840;8131;268396;114369;4.5;1.9
76;2021-02-20;1529;3041;269925;117410;4.6;2.0
76;2021-02-21;264;595;270189;118005;4.6;2.0
76;2021-02-22;3279;7666;273468;125671;4.6;2.1
76;2021-02-23;4918;10245;278386;135916;4.7;2.3
76;2021-02-24;4644;10428;283030;146344;4.8;2.5
76;2021-02-25;8313;9915;291343;156259;4.9;2.6
76;2021-02-26;9636;8404;300979;164663;5.1;2.8
76;2021-02-27;3732;3098;304711;167761;5.1;2.8
76;2021-02-28;432;453;305143;168214;5.2;2.8
76;2021-03-01;5305;6148;310448;174362;5.2;2.9
76;2021-03-02;8214;7571;318662;181933;5.4;3.1
76;2021-03-03;9248;7498;327910;189431;5.5;3.2
76;2021-03-04;14317;7897;342227;197328;5.8;3.3
76;2021-03-05;16870;7120;359097;204448;6.1;3.5
76;2021-03-06;15885;2163;374982;206611;6.3;3.5
76;2021-03-07;11377;470;386359;207081;6.5;3.5
76;2021-03-08;9977;5525;396336;212606;6.7;3.6
76;2021-03-09;16227;6478;412563;219084;7.0;3.7
76;2021-03-10;16411;6498;428974;225582;7.2;3.8
76;2021-03-11;22596;6405;451570;231987;7.6;3.9
76;2021-03-12;26420;5269;477990;237256;8.1;4.0
76;2021-03-13;14923;2163;492913;239419;8.3;4.0
76;2021-03-14;2323;355;495236;239774;8.4;4.0
76;2021-03-15;13515;3299;508751;243073;8.6;4.1
76;2021-03-16;11758;4529;520509;247602;8.8;4.2
76;2021-03-17;12839;3974;533348;251576;9.0;4.2
76;2021-03-18;13701;4989;547049;256565;9.2;4.3
76;2021-03-19;18653;4011;565702;260576;9.5;4.4
76;2021-03-20;10659;1132;576361;261708;9.7;4.4
76;2021-03-21;3195;224;579556;261932;9.8;4.4
76;2021-03-22;14675;3584;594231;265516;10.0;4.5
76;2021-03-23;22240;4325;616471;269841;10.4;4.6
76;2021-03-24;23600;4199;640071;274040;10.8;4.6
76;2021-03-25;32014;4615;672085;278655;11.3;4.7
76;2021-03-26;30839;4078;702924;282733;11.9;4.8
76;2021-03-27;16239;1413;719163;284146;12.1;4.8
76;2021-03-28;4868;194;724031;284340;12.2;4.8
76;2021-03-29;22295;4893;746326;289233;12.6;4.9
76;2021-03-30;29707;5725;776033;294958;13.1;5.0
76;2021-03-31;26885;5597;802918;300555;13.6;5.1
76;2021-04-01;34447;5904;837365;306459;14.1;5.2
76;2021-04-02;29339;5772;866704;312231;14.6;5.3
76;2021-04-03;12151;2852;878855;315083;14.8;5.3
76;2021-04-04;4352;660;883207;315743;14.9;5.3
76;2021-04-05;4288;675;887495;316418;15.0;5.3
76;2021-04-06;22836;9745;910331;326163;15.4;5.5
76;2021-04-07;25255;9869;935586;336032;15.8;5.7
76;2021-04-08;33100;10248;968686;346280;16.3;5.8
76;2021-04-09;38882;9629;1007568;355909;17.0;6.0
76;2021-04-10;22692;5159;1030260;361068;17.4;6.1
76;2021-04-11;8859;1432;1039119;362500;17.5;6.1
76;2021-04-12;26024;10524;1065143;373024;18.0;6.3
76;2021-04-13;35756;12859;1100899;385883;18.6;6.5
76;2021-04-14;32853;13252;1133752;399135;19.1;6.7
76;2021-04-15;37436;13850;1171188;412985;19.8;7.0
76;2021-04-16;34411;13147;1205599;426132;20.3;7.2
76;2021-04-17;21378;6660;1226977;432792;20.7;7.3
76;2021-04-18;7709;2689;1234686;435481;20.8;7.4
76;2021-04-19;22043;12920;1256729;448401;21.2;7.6
76;2021-04-20;27960;16742;1284689;465143;21.7;7.9
76;2021-04-21;27017;16933;1311706;482076;22.1;8.1
76;2021-04-22;30341;17948;1342047;500024;22.7;8.4
76;2021-04-23;28679;16409;1370726;516433;23.1;8.7
76;2021-04-24;18462;10408;1389188;526841;23.4;8.9
76;2021-04-25;6909;4198;1396097;531039;23.6;9.0
76;2021-04-26;19925;18399;1416022;549438;23.9;9.3
76;2021-04-27;26716;21403;1442738;570841;24.4;9.6
76;2021-04-28;25881;20975;1468619;591816;24.8;10.0
76;2021-04-29;29715;23207;1498334;615023;25.3;10.4
76;2021-04-30;30765;20147;1529099;635170;25.8;10.7
76;2021-05-01;17416;7028;1546515;642198;26.1;10.8
76;2021-05-02;9481;4785;1555996;646983;26.3;10.9
76;2021-05-03;26516;16778;1582512;663761;26.7;11.2
76;2021-05-04;29989;25829;1612501;689590;27.2;11.6
76;2021-05-05;28169;26410;1640670;716000;27.7;12.1
76;2021-05-06;31008;30875;1671678;746875;28.2;12.6
76;2021-05-07;31609;30793;1703287;777668;28.7;13.1
76;2021-05-08;17339;10562;1720626;788230;29.0;13.3
76;2021-05-09;9709;8680;1730335;796910;29.2;13.5
76;2021-05-10;24073;28054;1754408;824964;29.6;13.9
76;2021-05-11;31633;33074;1786041;858038;30.1;14.5
76;2021-05-12;33309;29407;1819350;887445;30.7;15.0
76;2021-05-13;25941;9730;1845291;897175;31.1;15.1
76;2021-05-14;34525;21329;1879816;918504;31.7;15.5
76;2021-05-15;24478;12194;1904294;930698;32.1;15.7
76;2021-05-16;15450;3795;1919744;934493;32.4;15.8
76;2021-05-17;27797;19246;1947541;953739;32.9;16.1
76;2021-05-18;35119;19478;1982660;973217;33.5;16.4
76;2021-05-19;36720;16824;2019380;990041;34.1;16.7
76;2021-05-20;40847;18640;2060227;1008681;34.8;17.0
76;2021-05-21;37631;19952;2097858;1028633;35.4;17.4
76;2021-05-22;26918;9254;2124776;1037887;35.9;17.5
76;2021-05-23;13268;1806;2138044;1039693;36.1;17.5
76;2021-05-24;15372;4112;2153416;1043805;36.3;17.6
76;2021-05-25;31511;20749;2184927;1064554;36.9;18.0
76;2021-05-26;33297;19201;2218224;1083755;37.4;18.3
76;2021-05-27;36230;24411;2254454;1108166;38.1;18.7
76;2021-05-28;32386;28264;2286840;1136430;38.6;19.2
76;2021-05-29;19500;16749;2306340;1153179;38.9;19.5
76;2021-05-30;6169;6313;2312509;1159492;39.0;19.6
76;2021-05-31;25702;22880;2338211;1182372;39.5;20.0
76;2021-06-01;31122;29830;2369333;1212202;40.0;20.5
76;2021-06-02;30683;28066;2400016;1240268;40.5;20.9
76;2021-06-03;34128;33103;2434144;1273371;41.1;21.5
76;2021-06-04;35005;34235;2469149;1307606;41.7;22.1
76;2021-06-05;25964;19722;2495113;1327328;42.1;22.4
76;2021-06-06;14069;6464;2509182;1333792;42.4;22.5
76;2021-06-07;25697;27663;2534879;1361455;42.8;23.0
76;2021-06-08;32339;31573;2567218;1393028;43.3;23.5
76;2021-06-09;32226;29076;2599444;1422104;43.9;24.0
76;2021-06-10;31882;29456;2631326;1451560;44.4;24.5
76;2021-06-11;33497;36114;2664823;1487674;45.0;25.1
76;2021-06-12;23171;21893;2687994;1509567;45.4;25.5
76;2021-06-13;12022;7133;2700016;1516700;45.6;25.6
76;2021-06-14;21520;33606;2721536;1550306;45.9;26.2
76;2021-06-15;28694;39693;2750230;1589999;46.4;26.8
76;2021-06-16;26973;36336;2777203;1626335;46.9;27.4
76;2021-06-17;26736;34157;2803939;1660492;47.3;28.0
76;2021-06-18;27352;41106;2831291;1701598;47.8;28.7
76;2021-06-19;20782;23112;2852073;1724710;48.1;29.1
76;2021-06-20;8906;10337;2860979;1735047;48.3;29.3
76;2021-06-21;15023;35198;2876002;1770245;48.5;29.9
76;2021-06-22;18171;40444;2894173;1810689;48.8;30.6
76;2021-06-23;18876;37939;2913049;1848628;49.2;31.2
76;2021-06-24;17366;35317;2930415;1883945;49.5;31.8
76;2021-06-25;18100;44706;2948515;1928651;49.8;32.6
76;2021-06-26;12169;28839;2960684;1957490;50.0;33.0
76;2021-06-27;5688;14592;2966372;1972082;50.1;33.3
84;2020-12-27;1;0;1;0;0.0;0.0
84;2020-12-28;7;0;8;0;0.0;0.0
84;2020-12-29;5;0;13;0;0.0;0.0
84;2020-12-30;6;0;19;0;0.0;0.0
84;2020-12-31;15;0;34;0;0.0;0.0
84;2021-01-01;10;0;44;0;0.0;0.0
84;2021-01-02;2;1;46;1;0.0;0.0
84;2021-01-03;0;0;46;1;0.0;0.0
84;2021-01-04;174;0;220;1;0.0;0.0
84;2021-01-05;468;1;688;2;0.0;0.0
84;2021-01-06;1135;1;1823;3;0.0;0.0
84;2021-01-07;2887;3;4710;6;0.1;0.0
84;2021-01-08;3078;3;7788;9;0.1;0.0
84;2021-01-09;513;1;8301;10;0.1;0.0
84;2021-01-10;161;0;8462;10;0.1;0.0
84;2021-01-11;4295;9;12757;19;0.2;0.0
84;2021-01-12;6363;17;19120;36;0.2;0.0
84;2021-01-13;6843;15;25963;51;0.3;0.0
84;2021-01-14;9071;57;35034;108;0.4;0.0
84;2021-01-15;7765;32;42799;140;0.5;0.0
84;2021-01-16;2953;7;45752;147;0.6;0.0
84;2021-01-17;920;2;46672;149;0.6;0.0
84;2021-01-18;8965;35;55637;184;0.7;0.0
84;2021-01-19;15048;84;70685;268;0.9;0.0
84;2021-01-20;15492;37;86177;305;1.1;0.0
84;2021-01-21;14579;51;100756;356;1.3;0.0
84;2021-01-22;12414;43;113170;399;1.4;0.0
84;2021-01-23;4761;3;117931;402;1.5;0.0
84;2021-01-24;810;1;118741;403;1.5;0.0
84;2021-01-25;8765;152;127506;555;1.6;0.0
84;2021-01-26;11898;320;139404;875;1.7;0.0
84;2021-01-27;12080;619;151484;1494;1.9;0.0
84;2021-01-28;13825;1540;165309;3034;2.1;0.0
84;2021-01-29;10793;1312;176102;4346;2.2;0.1
84;2021-01-30;4141;147;180243;4493;2.2;0.1
84;2021-01-31;499;1;180742;4494;2.3;0.1
84;2021-02-01;6533;1887;187275;6381;2.3;0.1
84;2021-02-02;10591;3518;197866;9899;2.5;0.1
84;2021-02-03;11529;3930;209395;13829;2.6;0.2
84;2021-02-04;12557;5548;221952;19377;2.8;0.2
84;2021-02-05;8612;4701;230564;24078;2.9;0.3
84;2021-02-06;2653;960;233217;25038;2.9;0.3
84;2021-02-07;451;441;233668;25479;2.9;0.3
84;2021-02-08;6223;4971;239891;30450;3.0;0.4
84;2021-02-09;9339;8274;249230;38724;3.1;0.5
84;2021-02-10;9677;8620;258907;47344;3.2;0.6
84;2021-02-11;10696;9926;269603;57270;3.4;0.7
84;2021-02-12;9720;7950;279323;65220;3.5;0.8
84;2021-02-13;3497;2352;282820;67572;3.5;0.8
84;2021-02-14;623;458;283443;68030;3.5;0.8
84;2021-02-15;4871;8373;288314;76403;3.6;1.0
84;2021-02-16;6097;10786;294411;87189;3.7;1.1
84;2021-02-17;6064;11583;300475;98772;3.7;1.2
84;2021-02-18;7103;11774;307578;110546;3.8;1.4
84;2021-02-19;6646;9362;314224;119908;3.9;1.5
84;2021-02-20;1837;3272;316061;123180;3.9;1.5
84;2021-02-21;180;504;316241;123684;3.9;1.5
84;2021-02-22;4290;8859;320531;132543;4.0;1.7
84;2021-02-23;7280;11438;327811;143981;4.1;1.8
84;2021-02-24;7792;12038;335603;156019;4.2;1.9
84;2021-02-25;12729;13827;348332;169846;4.3;2.1
84;2021-02-26;14874;10367;363206;180213;4.5;2.2
84;2021-02-27;5561;2925;368767;183138;4.6;2.3
84;2021-02-28;500;514;369267;183652;4.6;2.3
84;2021-03-01;9289;6431;378556;190083;4.7;2.4
84;2021-03-02;14960;8828;393516;198911;4.9;2.5
84;2021-03-03;14801;8687;408317;207598;5.1;2.6
84;2021-03-04;21025;8477;429342;216075;5.3;2.7
84;2021-03-05;25778;7748;455120;223823;5.7;2.8
84;2021-03-06;19494;2401;474614;226224;5.9;2.8
84;2021-03-07;8415;479;483029;226703;6.0;2.8
84;2021-03-08;12215;6826;495244;233529;6.2;2.9
84;2021-03-09;20678;7718;515922;241247;6.4;3.0
84;2021-03-10;20232;7556;536154;248803;6.7;3.1
84;2021-03-11;29460;8182;565614;256985;7.0;3.2
84;2021-03-12;36177;7728;601791;264713;7.5;3.3
84;2021-03-13;21427;1889;623218;266602;7.8;3.3
84;2021-03-14;4684;481;627902;267083;7.8;3.3
84;2021-03-15;18869;4814;646771;271897;8.1;3.4
84;2021-03-16;17052;6121;663823;278018;8.3;3.5
84;2021-03-17;17578;6477;681401;284495;8.5;3.5
84;2021-03-18;21502;6967;702903;291462;8.8;3.6
84;2021-03-19;28976;5529;731879;296991;9.1;3.7
84;2021-03-20;14538;1416;746417;298407;9.3;3.7
84;2021-03-21;3239;278;749656;298685;9.3;3.7
84;2021-03-22;19735;5146;769391;303831;9.6;3.8
84;2021-03-23;30787;5982;800178;309813;10.0;3.9
84;2021-03-24;29957;5900;830135;315713;10.3;3.9
84;2021-03-25;41550;6522;871685;322235;10.9;4.0
84;2021-03-26;42973;6799;914658;329034;11.4;4.1
84;2021-03-27;18212;2940;932870;331974;11.6;4.1
84;2021-03-28;6505;601;939375;332575;11.7;4.1
84;2021-03-29;22942;7952;962317;340527;12.0;4.2
84;2021-03-30;34954;10244;997271;350771;12.4;4.4
84;2021-03-31;29581;11066;1026852;361837;12.8;4.5
84;2021-04-01;37255;11483;1064107;373320;13.2;4.6
84;2021-04-02;34879;11400;1098986;384720;13.7;4.8
84;2021-04-03;14795;6237;1113781;390957;13.9;4.9
84;2021-04-04;9928;2005;1123709;392962;14.0;4.9
84;2021-04-05;13532;1679;1137241;394641;14.2;4.9
84;2021-04-06;26284;13262;1163525;407903;14.5;5.1
84;2021-04-07;29486;14712;1193011;422615;14.9;5.3
84;2021-04-08;39672;15509;1232683;438124;15.3;5.5
84;2021-04-09;49410;15134;1282093;453258;16.0;5.6
84;2021-04-10;20454;8161;1302547;461419;16.2;5.7
84;2021-04-11;7228;2703;1309775;464122;16.3;5.8
84;2021-04-12;27293;15609;1337068;479731;16.6;6.0
84;2021-04-13;36124;19418;1373192;499149;17.1;6.2
84;2021-04-14;34619;18312;1407811;517461;17.5;6.4
84;2021-04-15;40107;19741;1447918;537202;18.0;6.7
84;2021-04-16;38199;20141;1486117;557343;18.5;6.9
84;2021-04-17;20467;9045;1506584;566388;18.8;7.1
84;2021-04-18;6838;2714;1513422;569102;18.8;7.1
84;2021-04-19;26221;18614;1539643;587716;19.2;7.3
84;2021-04-20;31196;22549;1570839;610265;19.6;7.6
84;2021-04-21;28026;21509;1598865;631774;19.9;7.9
84;2021-04-22;32235;22670;1631100;654444;20.3;8.1
84;2021-04-23;32682;23150;1663782;677594;20.7;8.4
84;2021-04-24;17855;11917;1681637;689511;20.9;8.6
84;2021-04-25;7131;4294;1688768;693805;21.0;8.6
84;2021-04-26;23705;20066;1712473;713871;21.3;8.9
84;2021-04-27;31751;25298;1744224;739169;21.7;9.2
84;2021-04-28;32472;24863;1776696;764032;22.1;9.5
84;2021-04-29;39633;26589;1816329;790621;22.6;9.8
84;2021-04-30;38134;27895;1854463;818516;23.1;10.2
84;2021-05-01;17158;5391;1871621;823907;23.3;10.3
84;2021-05-02;7975;8582;1879596;832489;23.4;10.4
84;2021-05-03;30354;27524;1909950;860013;23.8;10.7
84;2021-05-04;37137;33786;1947087;893799;24.2;11.1
84;2021-05-05;40226;30203;1987313;924002;24.7;11.5
84;2021-05-06;46586;32682;2033899;956684;25.3;11.9
84;2021-05-07;46983;36837;2080882;993521;25.9;12.4
84;2021-05-08;22337;7667;2103219;1001188;26.2;12.5
84;2021-05-09;15910;8913;2119129;1010101;26.4;12.6
84;2021-05-10;36072;32030;2155201;1042131;26.8;13.0
84;2021-05-11;52623;36319;2207824;1078450;27.5;13.4
84;2021-05-12;56895;31915;2264719;1110365;28.2;13.8
84;2021-05-13;47401;10534;2312120;1120899;28.8;14.0
84;2021-05-14;57462;25029;2369582;1145928;29.5;14.3
84;2021-05-15;44184;13649;2413766;1159577;30.1;14.4
84;2021-05-16;30598;5142;2444364;1164719;30.4;14.5
84;2021-05-17;48355;24970;2492719;1189689;31.0;14.8
84;2021-05-18;59033;27392;2551752;1217081;31.8;15.2
84;2021-05-19;58321;23562;2610073;1240643;32.5;15.4
84;2021-05-20;61586;27043;2671659;1267686;33.3;15.8
84;2021-05-21;60896;29400;2732555;1297086;34.0;16.1
84;2021-05-22;40414;12918;2772969;1310004;34.5;16.3
84;2021-05-23;21365;3983;2794334;1313987;34.8;16.4
84;2021-05-24;39853;8554;2834187;1322541;35.3;16.5
84;2021-05-25;50230;31687;2884417;1354228;35.9;16.9
84;2021-05-26;49706;28941;2934123;1383169;36.5;17.2
84;2021-05-27;55636;31850;2989759;1415019;37.2;17.6
84;2021-05-28;54736;40518;3044495;1455537;37.9;18.1
84;2021-05-29;37593;22380;3082088;1477917;38.4;18.4
84;2021-05-30;16112;7263;3098200;1485180;38.6;18.5
84;2021-05-31;44270;29428;3142470;1514608;39.1;18.9
84;2021-06-01;48282;36660;3190752;1551268;39.7;19.3
84;2021-06-02;47701;31234;3238453;1582502;40.3;19.7
84;2021-06-03;56012;36580;3294465;1619082;41.0;20.2
84;2021-06-04;54565;42382;3349030;1661464;41.7;20.7
84;2021-06-05;38047;21685;3387077;1683149;42.2;21.0
84;2021-06-06;15899;6290;3402976;1689439;42.4;21.0
84;2021-06-07;41298;35170;3444274;1724609;42.9;21.5
84;2021-06-08;44977;37919;3489251;1762528;43.4;21.9
84;2021-06-09;40502;33935;3529753;1796463;43.9;22.4
84;2021-06-10;41141;33852;3570894;1830315;44.5;22.8
84;2021-06-11;43238;46353;3614132;1876668;45.0;23.4
84;2021-06-12;28116;22939;3642248;1899607;45.3;23.6
84;2021-06-13;8602;7130;3650850;1906737;45.5;23.7
84;2021-06-14;25512;44548;3676362;1951285;45.8;24.3
84;2021-06-15;31561;49291;3707923;2000576;46.2;24.9
84;2021-06-16;33272;45432;3741195;2046008;46.6;25.5
84;2021-06-17;30471;46942;3771666;2092950;47.0;26.1
84;2021-06-18;34842;59902;3806508;2152852;47.4;26.8
84;2021-06-19;22738;35715;3829246;2188567;47.7;27.2
84;2021-06-20;8658;14400;3837904;2202967;47.8;27.4
84;2021-06-21;19914;56134;3857818;2259101;48.0;28.1
84;2021-06-22;20960;62724;3878778;2321825;48.3;28.9
84;2021-06-23;22214;57573;3900992;2379398;48.6;29.6
84;2021-06-24;23063;55050;3924055;2434448;48.9;30.3
84;2021-06-25;23305;70250;3947360;2504698;49.1;31.2
84;2021-06-26;13906;46167;3961266;2550865;49.3;31.8
84;2021-06-27;6829;23484;3968095;2574349;49.4;32.0
93;2020-12-27;0;0;0;0;0.0;0.0
93;2020-12-28;2;0;2;0;0.0;0.0
93;2020-12-29;1;0;3;0;0.0;0.0
93;2020-12-30;3;0;6;0;0.0;0.0
93;2020-12-31;19;0;25;0;0.0;0.0
93;2021-01-01;13;0;38;0;0.0;0.0
93;2021-01-02;2;0;40;0;0.0;0.0
93;2021-01-03;2;0;42;0;0.0;0.0
93;2021-01-04;133;1;175;1;0.0;0.0
93;2021-01-05;251;1;426;2;0.0;0.0
93;2021-01-06;410;0;836;2;0.0;0.0
93;2021-01-07;1245;2;2081;4;0.0;0.0
93;2021-01-08;1563;2;3644;6;0.1;0.0
93;2021-01-09;540;1;4184;7;0.1;0.0
93;2021-01-10;74;0;4258;7;0.1;0.0
93;2021-01-11;2412;1;6670;8;0.1;0.0
93;2021-01-12;5092;7;11762;15;0.2;0.0
93;2021-01-13;4454;15;16216;30;0.3;0.0
93;2021-01-14;5580;51;21796;81;0.4;0.0
93;2021-01-15;4930;15;26726;96;0.5;0.0
93;2021-01-16;1678;5;28404;101;0.6;0.0
93;2021-01-17;300;1;28704;102;0.6;0.0
93;2021-01-18;7158;30;35862;132;0.7;0.0
93;2021-01-19;13528;35;49390;167;1.0;0.0
93;2021-01-20;12255;35;61645;202;1.2;0.0
93;2021-01-21;12309;49;73954;251;1.5;0.0
93;2021-01-22;10200;28;84154;279;1.7;0.0
93;2021-01-23;3327;6;87481;285;1.7;0.0
93;2021-01-24;537;4;88018;289;1.7;0.0
93;2021-01-25;7251;41;95269;330;1.9;0.0
93;2021-01-26;10068;137;105337;467;2.1;0.0
93;2021-01-27;9692;291;115029;758;2.3;0.0
93;2021-01-28;13667;833;128696;1591;2.5;0.0
93;2021-01-29;9847;982;138543;2573;2.7;0.1
93;2021-01-30;2240;159;140783;2732;2.8;0.1
93;2021-01-31;303;5;141086;2737;2.8;0.1
93;2021-02-01;5162;1518;146248;4255;2.9;0.1
93;2021-02-02;6646;2380;152894;6635;3.0;0.1
93;2021-02-03;5024;1822;157918;8457;3.1;0.2
93;2021-02-04;5532;3161;163450;11618;3.2;0.2
93;2021-02-05;6107;4129;169557;15747;3.4;0.3
93;2021-02-06;1246;973;170803;16720;3.4;0.3
93;2021-02-07;280;81;171083;16801;3.4;0.3
93;2021-02-08;4302;3748;175385;20549;3.5;0.4
93;2021-02-09;5890;7104;181275;27653;3.6;0.5
93;2021-02-10;5955;5886;187230;33539;3.7;0.7
93;2021-02-11;6599;6720;193829;40259;3.8;0.8
93;2021-02-12;5720;6477;199549;46736;3.9;0.9
93;2021-02-13;1128;1450;200677;48186;4.0;1.0
93;2021-02-14;73;384;200750;48570;4.0;1.0
93;2021-02-15;2413;5639;203163;54209;4.0;1.1
93;2021-02-16;3190;7709;206353;61918;4.1;1.2
93;2021-02-17;3604;8528;209957;70446;4.2;1.4
93;2021-02-18;6007;11425;215964;81871;4.3;1.6
93;2021-02-19;5641;8677;221605;90548;4.4;1.8
93;2021-02-20;879;1801;222484;92349;4.4;1.8
93;2021-02-21;70;417;222554;92766;4.4;1.8
93;2021-02-22;3029;6998;225583;99764;4.5;2.0
93;2021-02-23;3964;7246;229547;107010;4.5;2.1
93;2021-02-24;4749;6799;234296;113809;4.6;2.3
93;2021-02-25;8248;6669;242544;120478;4.8;2.4
93;2021-02-26;8274;6185;250818;126663;5.0;2.5
93;2021-02-27;3290;1490;254108;128153;5.0;2.5
93;2021-02-28;304;238;254412;128391;5.0;2.5
93;2021-03-01;5651;4490;260063;132881;5.1;2.6
93;2021-03-02;7215;5932;267278;138813;5.3;2.7
93;2021-03-03;8986;6557;276264;145370;5.5;2.9
93;2021-03-04;12065;6460;288329;151830;5.7;3.0
93;2021-03-05;12201;6102;300530;157932;5.9;3.1
93;2021-03-06;22871;1314;323401;159246;6.4;3.1
93;2021-03-07;17988;611;341389;159857;6.8;3.2
93;2021-03-08;10240;5277;351629;165134;7.0;3.3
93;2021-03-09;13957;5567;365586;170701;7.2;3.4
93;2021-03-10;14492;5284;380078;175985;7.5;3.5
93;2021-03-11;20392;6165;400470;182150;7.9;3.6
93;2021-03-12;21917;5317;422387;187467;8.4;3.7
93;2021-03-13;24598;1230;446985;188697;8.8;3.7
93;2021-03-14;6472;264;453457;188961;9.0;3.7
93;2021-03-15;15943;3109;469400;192070;9.3;3.8
93;2021-03-16;12719;3644;482119;195714;9.5;3.9
93;2021-03-17;15997;4649;498116;200363;9.9;4.0
93;2021-03-18;17034;4898;515150;205261;10.2;4.1
93;2021-03-19;21022;4698;536172;209959;10.6;4.2
93;2021-03-20;10991;1321;547163;211280;10.8;4.2
93;2021-03-21;3258;130;550421;211410;10.9;4.2
93;2021-03-22;17101;3558;567522;214968;11.2;4.3
93;2021-03-23;22657;3880;590179;218848;11.7;4.3
93;2021-03-24;21978;6636;612157;225484;12.1;4.5
93;2021-03-25;29020;6521;641177;232005;12.7;4.6
93;2021-03-26;29917;5036;671094;237041;13.3;4.7
93;2021-03-27;12453;1637;683547;238678;13.5;4.7
93;2021-03-28;3576;100;687123;238778;13.6;4.7
93;2021-03-29;18525;5336;705648;244114;14.0;4.8
93;2021-03-30;28505;6690;734153;250804;14.5;5.0
93;2021-03-31;28780;6640;762933;257444;15.1;5.1
93;2021-04-01;30745;7495;793678;264939;15.7;5.2
93;2021-04-02;26929;8491;820607;273430;16.2;5.4
93;2021-04-03;9764;4979;830371;278409;16.4;5.5
93;2021-04-04;2121;1252;832492;279661;16.5;5.5
93;2021-04-05;6059;1564;838551;281225;16.6;5.6
93;2021-04-06;23415;10026;861966;291251;17.0;5.8
93;2021-04-07;26075;11675;888041;302926;17.6;6.0
93;2021-04-08;28853;14975;916894;317901;18.1;6.3
93;2021-04-09;33602;14624;950496;332525;18.8;6.6
93;2021-04-10;14819;8173;965315;340698;19.1;6.7
93;2021-04-11;3634;2963;968949;343661;19.2;6.8
93;2021-04-12;20599;12211;989548;355872;19.6;7.0
93;2021-04-13;25582;15235;1015130;371107;20.1;7.3
93;2021-04-14;25184;15251;1040314;386358;20.6;7.6
93;2021-04-15;26991;15657;1067305;402015;21.1;8.0
93;2021-04-16;27897;16453;1095202;418468;21.7;8.3
93;2021-04-17;12829;7735;1108031;426203;21.9;8.4
93;2021-04-18;5252;2959;1113283;429162;22.0;8.5
93;2021-04-19;19082;15963;1132365;445125;22.4;8.8
93;2021-04-20;21340;18749;1153705;463874;22.8;9.2
93;2021-04-21;23901;18322;1177606;482196;23.3;9.5
93;2021-04-22;25836;19245;1203442;501441;23.8;9.9
93;2021-04-23;25365;18173;1228807;519614;24.3;10.3
93;2021-04-24;11543;8698;1240350;528312;24.5;10.4
93;2021-04-25;3208;2141;1243558;530453;24.6;10.5
93;2021-04-26;16449;15864;1260007;546317;24.9;10.8
93;2021-04-27;19452;20168;1279459;566485;25.3;11.2
93;2021-04-28;21493;20104;1300952;586589;25.7;11.6
93;2021-04-29;27889;21777;1328841;608366;26.3;12.0
93;2021-04-30;27289;20606;1356130;628972;26.8;12.4
93;2021-05-01;11711;5293;1367841;634265;27.1;12.5
93;2021-05-02;4062;1884;1371903;636149;27.1;12.6
93;2021-05-03;20446;18180;1392349;654329;27.5;12.9
93;2021-05-04;20776;22730;1413125;677059;28.0;13.4
93;2021-05-05;19475;21512;1432600;698571;28.3;13.8
93;2021-05-06;24782;21643;1457382;720214;28.8;14.2
93;2021-05-07;22411;25007;1479793;745221;29.3;14.7
93;2021-05-08;13520;6886;1493313;752107;29.5;14.9
93;2021-05-09;3464;2318;1496777;754425;29.6;14.9
93;2021-05-10;18652;22586;1515429;777011;30.0;15.4
93;2021-05-11;25353;25647;1540782;802658;30.5;15.9
93;2021-05-12;32477;22544;1573259;825202;31.1;16.3
93;2021-05-13;27950;7890;1601209;833092;31.7;16.5
93;2021-05-14;35383;16433;1636592;849525;32.4;16.8
93;2021-05-15;29663;10269;1666255;859794;33.0;17.0
93;2021-05-16;12779;2534;1679034;862328;33.2;17.1
93;2021-05-17;25705;17476;1704739;879804;33.7;17.4
93;2021-05-18;30252;16734;1734991;896538;34.3;17.7
93;2021-05-19;30069;15180;1765060;911718;34.9;18.0
93;2021-05-20;32680;16704;1797740;928422;35.6;18.4
93;2021-05-21;33676;17861;1831416;946283;36.2;18.7
93;2021-05-22;18571;7676;1849987;953959;36.6;18.9
93;2021-05-23;5915;2020;1855902;955979;36.7;18.9
93;2021-05-24;17481;4988;1873383;960967;37.1;19.0
93;2021-05-25;23525;20449;1896908;981416;37.5;19.4
93;2021-05-26;24550;21902;1921458;1003318;38.0;19.8
93;2021-05-27;26370;23309;1947828;1026627;38.5;20.3
93;2021-05-28;22778;26623;1970606;1053250;39.0;20.8
93;2021-05-29;13139;14362;1983745;1067612;39.2;21.1
93;2021-05-30;2587;3181;1986332;1070793;39.3;21.2
93;2021-05-31;20814;21298;2007146;1092091;39.7;21.6
93;2021-06-01;24364;26160;2031510;1118251;40.2;22.1
93;2021-06-02;22158;26097;2053668;1144348;40.6;22.6
93;2021-06-03;27566;27277;2081234;1171625;41.2;23.2
93;2021-06-04;27927;28331;2109161;1199956;41.7;23.7
93;2021-06-05;16266;14235;2125427;1214191;42.0;24.0
93;2021-06-06;4885;2795;2130312;1216986;42.1;24.1
93;2021-06-07;17596;24391;2147908;1241377;42.5;24.6
93;2021-06-08;20970;24085;2168878;1265462;42.9;25.0
93;2021-06-09;20631;25743;2189509;1291205;43.3;25.5
93;2021-06-10;21574;24673;2211083;1315878;43.7;26.0
93;2021-06-11;19672;30783;2230755;1346661;44.1;26.6
93;2021-06-12;12888;15301;2243643;1361962;44.4;26.9
93;2021-06-13;2548;3320;2246191;1365282;44.4;27.0
93;2021-06-14;13000;29356;2259191;1394638;44.7;27.6
93;2021-06-15;16306;30973;2275497;1425611;45.0;28.2
93;2021-06-16;16880;25624;2292377;1451235;45.3;28.7
93;2021-06-17;17065;28131;2309442;1479366;45.7;29.3
93;2021-06-18;16218;27981;2325660;1507347;46.0;29.8
93;2021-06-19;9660;15309;2335320;1522656;46.2;30.1
93;2021-06-20;2388;3699;2337708;1526355;46.2;30.2
93;2021-06-21;9832;30422;2347540;1556777;46.4;30.8
93;2021-06-22;11479;34419;2359019;1591196;46.7;31.5
93;2021-06-23;11353;32228;2370372;1623424;46.9;32.1
93;2021-06-24;11993;34036;2382365;1657460;47.1;32.8
93;2021-06-25;10807;37766;2393172;1695226;47.3;33.5
93;2021-06-26;6432;21629;2399604;1716855;47.5;34.0
93;2021-06-27;1972;5776;2401576;1722631;47.5;34.1
94;2020-12-27;0;0;0;0;0.0;0.0
94;2020-12-28;0;0;0;0;0.0;0.0
94;2020-12-29;0;0;0;0;0.0;0.0
94;2020-12-30;0;0;0;0;0.0;0.0
94;2020-12-31;0;0;0;0;0.0;0.0
94;2021-01-01;0;0;0;0;0.0;0.0
94;2021-01-02;0;0;0;0;0.0;0.0
94;2021-01-03;0;0;0;0;0.0;0.0
94;2021-01-04;2;0;2;0;0.0;0.0
94;2021-01-05;0;0;2;0;0.0;0.0
94;2021-01-06;53;1;55;1;0.0;0.0
94;2021-01-07;333;1;388;2;0.1;0.0
94;2021-01-08;310;0;698;2;0.2;0.0
94;2021-01-09;78;0;776;2;0.2;0.0
94;2021-01-10;34;0;810;2;0.2;0.0
94;2021-01-11;152;2;962;4;0.3;0.0
94;2021-01-12;209;1;1171;5;0.3;0.0
94;2021-01-13;203;0;1374;5;0.4;0.0
94;2021-01-14;264;1;1638;6;0.5;0.0
94;2021-01-15;404;0;2042;6;0.6;0.0
94;2021-01-16;200;1;2242;7;0.7;0.0
94;2021-01-17;91;1;2333;8;0.7;0.0
94;2021-01-18;471;2;2804;10;0.8;0.0
94;2021-01-19;982;0;3786;10;1.1;0.0
94;2021-01-20;808;0;4594;10;1.3;0.0
94;2021-01-21;808;1;5402;11;1.6;0.0
94;2021-01-22;726;0;6128;11;1.8;0.0
94;2021-01-23;243;0;6371;11;1.8;0.0
94;2021-01-24;147;0;6518;11;1.9;0.0
94;2021-01-25;422;2;6940;13;2.0;0.0
94;2021-01-26;790;7;7730;20;2.2;0.0
94;2021-01-27;663;55;8393;75;2.4;0.0
94;2021-01-28;699;230;9092;305;2.6;0.1
94;2021-01-29;626;229;9718;534;2.8;0.2
94;2021-01-30;204;74;9922;608;2.9;0.2
94;2021-01-31;150;12;10072;620;2.9;0.2
94;2021-02-01;458;147;10530;767;3.1;0.2
94;2021-02-02;643;196;11173;963;3.2;0.3
94;2021-02-03;783;167;11956;1130;3.5;0.3
94;2021-02-04;714;298;12670;1428;3.7;0.4
94;2021-02-05;659;201;13329;1629;3.9;0.5
94;2021-02-06;207;75;13536;1704;3.9;0.5
94;2021-02-07;126;58;13662;1762;4.0;0.5
94;2021-02-08;322;366;13984;2128;4.1;0.6
94;2021-02-09;713;616;14697;2744;4.3;0.8
94;2021-02-10;643;430;15340;3174;4.5;0.9
94;2021-02-11;678;497;16018;3671;4.6;1.1
94;2021-02-12;641;428;16659;4099;4.8;1.2
94;2021-02-13;301;72;16960;4171;4.9;1.2
94;2021-02-14;195;78;17155;4249;5.0;1.2
94;2021-02-15;380;310;17535;4559;5.1;1.3
94;2021-02-16;634;604;18169;5163;5.3;1.5
94;2021-02-17;592;482;18761;5645;5.4;1.6
94;2021-02-18;550;545;19311;6190;5.6;1.8
94;2021-02-19;309;610;19620;6800;5.7;2.0
94;2021-02-20;275;200;19895;7000;5.8;2.0
94;2021-02-21;84;84;19979;7084;5.8;2.1
94;2021-02-22;211;406;20190;7490;5.9;2.2
94;2021-02-23;352;648;20542;8138;6.0;2.4
94;2021-02-24;298;609;20840;8747;6.0;2.5
94;2021-02-25;348;608;21188;9355;6.1;2.7
94;2021-02-26;420;555;21608;9910;6.3;2.9
94;2021-02-27;368;152;21976;10062;6.4;2.9
94;2021-02-28;70;123;22046;10185;6.4;3.0
94;2021-03-01;360;413;22406;10598;6.5;3.1
94;2021-03-02;549;655;22955;11253;6.7;3.3
94;2021-03-03;531;692;23486;11945;6.8;3.5
94;2021-03-04;950;635;24436;12580;7.1;3.6
94;2021-03-05;1584;674;26020;13254;7.5;3.8
94;2021-03-06;1843;164;27863;13418;8.1;3.9
94;2021-03-07;1381;100;29244;13518;8.5;3.9
94;2021-03-08;1228;324;30472;13842;8.8;4.0
94;2021-03-09;1313;656;31785;14498;9.2;4.2
94;2021-03-10;1259;578;33044;15076;9.6;4.4
94;2021-03-11;1307;635;34351;15711;10.0;4.6
94;2021-03-12;1516;540;35867;16251;10.4;4.7
94;2021-03-13;1118;303;36985;16554;10.7;4.8
94;2021-03-14;537;185;37522;16739;10.9;4.9
94;2021-03-15;886;400;38408;17139;11.1;5.0
94;2021-03-16;1065;641;39473;17780;11.5;5.2
94;2021-03-17;1225;530;40698;18310;11.8;5.3
94;2021-03-18;995;530;41693;18840;12.1;5.5
94;2021-03-19;1285;342;42978;19182;12.5;5.6
94;2021-03-20;1732;289;44710;19471;13.0;5.6
94;2021-03-21;1126;83;45836;19554;13.3;5.7
94;2021-03-22;889;187;46725;19741;13.6;5.7
94;2021-03-23;1302;319;48027;20060;13.9;5.8
94;2021-03-24;1687;305;49714;20365;14.4;5.9
94;2021-03-25;1753;296;51467;20661;14.9;6.0
94;2021-03-26;2031;345;53498;21006;15.5;6.1
94;2021-03-27;2271;228;55769;21234;16.2;6.2
94;2021-03-28;1070;217;56839;21451;16.5;6.2
94;2021-03-29;1023;312;57862;21763;16.8;6.3
94;2021-03-30;1352;556;59214;22319;17.2;6.5
94;2021-03-31;1428;488;60642;22807;17.6;6.6
94;2021-04-01;1639;679;62281;23486;18.1;6.8
94;2021-04-02;1862;1191;64143;24677;18.6;7.2
94;2021-04-03;1891;1128;66034;25805;19.2;7.5
94;2021-04-04;770;843;66804;26648;19.4;7.7
94;2021-04-05;629;806;67433;27454;19.6;8.0
94;2021-04-06;1580;913;69013;28367;20.0;8.2
94;2021-04-07;2008;849;71021;29216;20.6;8.5
94;2021-04-08;2174;756;73195;29972;21.2;8.7
94;2021-04-09;2099;948;75294;30920;21.8;9.0
94;2021-04-10;2402;625;77696;31545;22.5;9.2
94;2021-04-11;1173;315;78869;31860;22.9;9.2
94;2021-04-12;1517;896;80386;32756;23.3;9.5
94;2021-04-13;1384;1007;81770;33763;23.7;9.8
94;2021-04-14;2088;1075;83858;34838;24.3;10.1
94;2021-04-15;1921;1027;85779;35865;24.9;10.4
94;2021-04-16;1777;1038;87556;36903;25.4;10.7
94;2021-04-17;1750;1373;89306;38276;25.9;11.1
94;2021-04-18;1233;1279;90539;39555;26.3;11.5
94;2021-04-19;1089;772;91628;40327;26.6;11.7
94;2021-04-20;1249;1192;92877;41519;26.9;12.0
94;2021-04-21;1781;1333;94658;42852;27.5;12.4
94;2021-04-22;1821;1374;96479;44226;28.0;12.8
94;2021-04-23;1646;1403;98125;45629;28.5;13.2
94;2021-04-24;2031;1743;100156;47372;29.1;13.7
94;2021-04-25;1260;776;101416;48148;29.4;14.0
94;2021-04-26;1015;1145;102431;49293;29.7;14.3
94;2021-04-27;1308;1217;103739;50510;30.1;14.7
94;2021-04-28;2587;1273;106326;51783;30.8;15.0
94;2021-04-29;1968;1222;108294;53005;31.4;15.4
94;2021-04-30;2261;1878;110555;54883;32.1;15.9
94;2021-05-01;1423;1687;111978;56570;32.5;16.4
94;2021-05-02;1005;947;112983;57517;32.8;16.7
94;2021-05-03;1598;1066;114581;58583;33.2;17.0
94;2021-05-04;1557;1684;116138;60267;33.7;17.5
94;2021-05-05;1807;2357;117945;62624;34.2;18.2
94;2021-05-06;2187;1811;120132;64435;34.9;18.7
94;2021-05-07;2212;1817;122344;66252;35.5;19.2
94;2021-05-08;873;1353;123217;67605;35.7;19.6
94;2021-05-09;1174;1318;124391;68923;36.1;20.0
94;2021-05-10;1372;1536;125763;70459;36.5;20.4
94;2021-05-11;1578;1572;127341;72031;36.9;20.9
94;2021-05-12;1766;1376;129107;73407;37.5;21.3
94;2021-05-13;1940;514;131047;73921;38.0;21.4
94;2021-05-14;1512;1258;132559;75179;38.5;21.8
94;2021-05-15;1478;997;134037;76176;38.9;22.1
94;2021-05-16;1027;668;135064;76844;39.2;22.3
94;2021-05-17;1579;966;136643;77810;39.6;22.6
94;2021-05-18;1570;856;138213;78666;40.1;22.8
94;2021-05-19;1536;896;139749;79562;40.5;23.1
94;2021-05-20;1345;892;141094;80454;40.9;23.3
94;2021-05-21;1214;980;142308;81434;41.3;23.6
94;2021-05-22;1001;696;143309;82130;41.6;23.8
94;2021-05-23;683;328;143992;82458;41.8;23.9
94;2021-05-24;162;146;144154;82604;41.8;24.0
94;2021-05-25;947;856;145101;83460;42.1;24.2
94;2021-05-26;946;1953;146047;85413;42.4;24.8
94;2021-05-27;825;2244;146872;87657;42.6;25.4
94;2021-05-28;817;1821;147689;89478;42.8;26.0
94;2021-05-29;639;1252;148328;90730;43.0;26.3
94;2021-05-30;224;549;148552;91279;43.1;26.5
94;2021-05-31;548;1241;149100;92520;43.3;26.8
94;2021-06-01;731;1770;149831;94290;43.5;27.4
94;2021-06-02;609;1927;150440;96217;43.6;27.9
94;2021-06-03;780;1647;151220;97864;43.9;28.4
94;2021-06-04;603;2344;151823;100208;44.0;29.1
94;2021-06-05;553;1934;152376;102142;44.2;29.6
94;2021-06-06;213;1040;152589;103182;44.3;29.9
94;2021-06-07;436;1608;153025;104790;44.4;30.4
94;2021-06-08;690;1869;153715;106659;44.6;30.9
94;2021-06-09;795;2491;154510;109150;44.8;31.7
94;2021-06-10;669;1792;155179;110942;45.0;32.2
94;2021-06-11;689;2295;155868;113237;45.2;32.9
94;2021-06-12;352;1207;156220;114444;45.3;33.2
94;2021-06-13;202;854;156422;115298;45.4;33.5
94;2021-06-14;421;2037;156843;117335;45.5;34.0
94;2021-06-15;547;1724;157390;119059;45.7;34.5
94;2021-06-16;573;1711;157963;120770;45.8;35.0
94;2021-06-17;612;1637;158575;122407;46.0;35.5
94;2021-06-18;575;1876;159150;124283;46.2;36.1
94;2021-06-19;342;1014;159492;125297;46.3;36.4
94;2021-06-20;188;888;159680;126185;46.3;36.6
94;2021-06-21;435;1756;160115;127941;46.5;37.1
94;2021-06-22;536;1953;160651;129894;46.6;37.7
94;2021-06-23;401;1439;161052;131333;46.7;38.1
94;2021-06-24;463;1124;161515;132457;46.9;38.4
94;2021-06-25;349;1543;161864;134000;47.0;38.9
94;2021-06-26;298;1422;162162;135422;47.0;39.3
94;2021-06-27;199;1004;162361;136426;47.1;39.6
